LAUS_Code,State_FIPS_Code,Area_FIPS_Code,Area,Year,Month,Civilian_Labor_Force,Employment,Unemployment,Unemployment_Rate
MT0111500000000,1,11500,"Anniston-Oxford, AL MSA",2021,1,50135,47876,2259,4.5
MT0112220000000,1,12220,"Auburn-Opelika, AL MSA",2021,1,90278,87009,3269,3.6
MT0113820000000,1,13820,"Birmingham, AL MSA",2021,1,552681,531274,21407,3.9
MT0119300000000,1,19300,"Daphne-Fairhope-Foley, AL MSA",2021,1,106653,103138,3515,3.3
MT0119460000000,1,19460,"Decatur, AL MSA",2021,1,71743,69453,2290,3.2
MT0120020000000,1,20020,"Dothan, AL MSA",2021,1,66001,63489,2512,3.8
MT0122520000000,1,22520,"Florence-Muscle Shoals, AL MSA",2021,1,66826,64302,2524,3.8
MT0123460000000,1,23460,"Gadsden, AL MSA",2021,1,42266,40339,1927,4.6
MT0126620000000,1,26620,"Huntsville, AL MSA",2021,1,246692,239253,7439,3
MT0133660000000,1,33660,"Mobile, AL MSA",2021,1,183963,172846,11117,6
MT0133860000000,1,33860,"Montgomery, AL MSA",2021,1,173376,164368,9008,5.2
MT0146220000000,1,46220,"Tuscaloosa, AL MSA",2021,1,120058,114475,5583,4.7
MT0211260000000,2,11260,"Anchorage, AK MSA",2021,1,194064,180627,13437,6.9
MT0221820000000,2,21820,"Fairbanks-College, AK MSA",2021,1,44144,41733,2411,5.5
MT0422380000000,4,22380,"Flagstaff, AZ MSA",2021,1,69625,64083,5542,8
MT0429420000000,4,29420,"Lake Havasu City-Kingman, AZ MSA",2021,1,84089,78115,5974,7.1
MT0438060000000,4,38060,"Phoenix-Mesa-Chandler, AZ MSA",2021,1,2509034,2359729,149305,6
MT0439150000000,4,39150,"Prescott Valley-Prescott, AZ MSA",2021,1,100446,94637,5809,5.8
MT0443420000000,4,43420,"Sierra Vista-Douglas, AZ MSA",2021,1,48922,46093,2829,5.8
MT0446060000000,4,46060,"Tucson, AZ MSA",2021,1,481982,450665,31317,6.5
MT0449740000000,4,49740,"Yuma, AZ MSA",2021,1,93015,80791,12224,13.1
MT0522220000000,5,22220,"Fayetteville-Springdale-Rogers, AR MSA",2021,1,271007,261155,9852,3.6
MT0522900000000,5,22900,"Fort Smith, AR-OK MSA",2021,1,99063,94644,4419,4.5
MT0526300000000,5,26300,"Hot Springs, AR MSA",2021,1,42881,40372,2509,5.9
MT0527860000000,5,27860,"Jonesboro, AR MSA",2021,1,62944,60258,2686,4.3
MT0530780000000,5,30780,"Little Rock-North Little Rock-Conway, AR MSA",2021,1,351180,333380,17800,5.1
MT0612540000000,6,12540,"Bakersfield-Delano, CA MSA",2021,1,385756,344007,41749,10.8
MT0617020000000,6,17020,"Chico, CA MSA",2021,1,89735,82571,7164,8
MT0620940000000,6,20940,"El Centro, CA MSA",2021,1,65999,53639,12360,18.7
MT0623420000000,6,23420,"Fresno, CA MSA",2021,1,496801,446499,50302,10.1
MT0625260000000,6,25260,"Hanford-Corcoran, CA MSA",2021,1,53844,48123,5721,10.6
MT0631080000000,6,31080,"Los Angeles-Long Beach-Anaheim, CA MSA",2021,1,6454041,5812520,641521,9.9
MT0632900000000,6,32900,"Merced, CA MSA",2021,1,113673,100984,12689,11.2
MT0633700000000,6,33700,"Modesto, CA MSA",2021,1,242079,219732,22347,9.2
MT0634900000000,6,34900,"Napa, CA MSA",2021,1,68202,62584,5618,8.2
MT0637100000000,6,37100,"Oxnard-Thousand Oaks-Ventura, CA MSA",2021,1,402430,372916,29514,7.3
MT0639820000000,6,39820,"Redding, CA MSA",2021,1,76392,70827,5565,7.3
MT0640140000000,6,40140,"Riverside-San Bernardino-Ontario, CA MSA",2021,1,2088587,1902756,185831,8.9
MT0640900000000,6,40900,"Sacramento-Roseville-Folsom, CA MSA",2021,1,1114843,1032090,82753,7.4
MT0641500000000,6,41500,"Salinas, CA MSA",2021,1,206683,188058,18625,9
MT0641740000000,6,41740,"San Diego-Chula Vista-Carlsbad, CA MSA",2021,1,1548623,1425208,123415,8
MT0641860000000,6,41860,"San Francisco-Oakland-Fremont, CA MSA",2021,1,2411623,2243323,168300,7
MT0641940000000,6,41940,"San Jose-Sunnyvale-Santa Clara, CA MSA",2021,1,1012152,950442,61710,6.1
MT0642020000000,6,42020,"San Luis Obispo-Paso Robles, CA MSA",2021,1,128633,119789,8844,6.9
MT0642100000000,6,42100,"Santa Cruz-Watsonville, CA MSA",2021,1,132399,122413,9986,7.5
MT0642200000000,6,42200,"Santa Maria-Santa Barbara, CA MSA",2021,1,212062,197373,14689,6.9
MT0642220000000,6,42220,"Santa Rosa-Petaluma, CA MSA",2021,1,237944,221893,16051,6.7
MT0644700000000,6,44700,"Stockton-Lodi, CA MSA",2021,1,346987,314263,32724,9.4
MT0646700000000,6,46700,"Vallejo, CA MSA",2021,1,206563,189063,17500,8.5
MT0647300000000,6,47300,"Visalia, CA MSA",2021,1,200504,178011,22493,11.2
MT0649700000000,6,49700,"Yuba City, CA MSA",2021,1,75762,68628,7134,9.4
MT0814500000000,8,14500,"Boulder, CO MSA",2021,1,185231,175216,10015,5.4
MT0817820000000,8,17820,"Colorado Springs, CO MSA",2021,1,371540,347931,23609,6.4
MT0819740000000,8,19740,"Denver-Aurora-Centennial, CO MSA",2021,1,1683993,1579219,104774,6.2
MT0822660000000,8,22660,"Fort Collins-Loveland, CO MSA",2021,1,196028,184383,11645,5.9
MT0824300000000,8,24300,"Grand Junction, CO MSA",2021,1,77692,72703,4989,6.4
MT0824540000000,8,24540,"Greeley, CO MSA",2021,1,166045,155192,10853,6.5
MT0839380000000,8,39380,"Pueblo, CO MSA",2021,1,74835,68230,6605,8.8
MT0914860000000,9,14860,"Bridgeport-Stamford-Danbury, CT MSA",2021,1,469455,436731,32724,7
MT0925540000000,9,25540,"Hartford-West Hartford-East Hartford, CT MSA",2021,1,582434,539864,42570,7.3
MT0935300000000,9,35300,"New Haven, CT MSA",2021,1,293743,272002,21741,7.4
MT0935980000000,9,35980,"Norwich-New London-Willimantic, CT MSA",2021,1,133542,122508,11034,8.3
MT0947930000000,9,47930,"Waterbury-Shelton, CT MSA",2021,1,227702,209868,17834,7.8
MT1020100000000,10,20100,"Dover, DE MSA",2021,1,84013,78850,5163,6.1
MT1147900000000,11,47900,"Washington-Arlington-Alexandria, DC-VA-MD-WV MSA",2021,1,3363102,3177415,185687,5.5
MT1215980000000,12,15980,"Cape Coral-Fort Myers, FL MSA",2021,1,339302,321419,17883,5.3
MT1218880000000,12,18880,"Crestview-Fort Walton Beach-Destin, FL MSA",2021,1,133183,127808,5375,4
MT1219660000000,12,19660,"Deltona-Daytona Beach-Ormond Beach, FL MSA",2021,1,292360,275656,16704,5.7
MT1223540000000,12,23540,"Gainesville, FL MSA",2021,1,160594,153001,7593,4.7
MT1226140000000,12,26140,"Homosassa Springs, FL MSA",2021,1,50259,47073,3186,6.3
MT1227260000000,12,27260,"Jacksonville, FL MSA",2021,1,790581,751730,38851,4.9
MT1229460000000,12,29460,"Lakeland-Winter Haven, FL MSA",2021,1,330928,309765,21163,6.4
MT1233100000000,12,33100,"Miami-Fort Lauderdale-West Palm Beach, FL MSA",2021,1,3006845,2804208,202637,6.7
MT1234940000000,12,34940,"Naples-Marco Island, FL MSA",2021,1,163011,154947,8064,4.9
MT1235840000000,12,35840,"North Port-Bradenton-Sarasota, FL MSA",2021,1,353621,336319,17302,4.9
MT1236100000000,12,36100,"Ocala, FL MSA",2021,1,145770,137530,8240,5.7
MT1236740000000,12,36740,"Orlando-Kissimmee-Sanford, FL MSA",2021,1,1327523,1242433,85090,6.4
MT1237340000000,12,37340,"Palm Bay-Melbourne-Titusville, FL MSA",2021,1,285251,271042,14209,5
MT1237460000000,12,37460,"Panama City-Panama City Beach, FL MSA",2021,1,94819,90318,4501,4.7
MT1237860000000,12,37860,"Pensacola-Ferry Pass-Brent, FL MSA",2021,1,228291,216845,11446,5
MT1238940000000,12,38940,"Port St. Lucie, FL MSA",2021,1,218945,207199,11746,5.4
MT1239460000000,12,39460,"Punta Gorda, FL MSA",2021,1,68052,64305,3747,5.5
MT1242680000000,12,42680,"Sebastian-Vero Beach-West Vero Corridor, FL MSA",2021,1,61994,58329,3665,5.9
MT1242700000000,12,42700,"Sebring, FL MSA",2021,1,33927,31576,2351,6.9
MT1245220000000,12,45220,"Tallahassee, FL MSA",2021,1,192316,182412,9904,5.1
MT1245300000000,12,45300,"Tampa-St. Petersburg-Clearwater, FL MSA",2021,1,1553654,1473726,79928,5.1
MT1248680000000,12,48680,"Wildwood-The Villages, FL MSA",2021,1,28767,26653,2114,7.3
MT1310500000000,13,10500,"Albany, GA MSA",2021,1,64821,60542,4279,6.6
MT1312020000000,13,12020,"Athens-Clarke County, GA MSA",2021,1,103108,99048,4060,3.9
MT1312060000000,13,12060,"Atlanta-Sandy Springs-Roswell, GA MSA",2021,1,3120006,2964224,155782,5
MT1312260000000,13,12260,"Augusta-Richmond County, GA-SC MSA",2021,1,266556,254184,12372,4.6
MT1315260000000,13,15260,"Brunswick-St. Simons, GA MSA",2021,1,51389,49042,2347,4.6
MT1317980000000,13,17980,"Columbus, GA-AL MSA",2021,1,132777,125908,6869,5.2
MT1319140000000,13,19140,"Dalton, GA MSA",2021,1,66378,63613,2765,4.2
MT1323580000000,13,23580,"Gainesville, GA MSA",2021,1,100746,97380,3366,3.3
MT1325980000000,13,25980,"Hinesville, GA MSA",2021,1,31014,29427,1587,5.1
MT1331420000000,13,31420,"Macon-Bibb County, GA MSA",2021,1,100748,94872,5876,5.8
MT1340660000000,13,40660,"Rome, GA MSA",2021,1,43618,41646,1972,4.5
MT1342340000000,13,42340,"Savannah, GA MSA",2021,1,199239,189431,9808,4.9
MT1346660000000,13,46660,"Valdosta, GA MSA",2021,1,63031,59861,3170,5
MT1347580000000,13,47580,"Warner Robins, GA MSA",2021,1,89538,85654,3884,4.3
MT1527980000000,15,27980,"Kahului-Wailuku, HI MSA",2021,1,82354,71567,10787,13.1
MT1546520000000,15,46520,"Urban Honolulu, HI MSA",2021,1,466404,426854,39550,8.5
MT1614260000000,16,14260,"Boise City, ID MSA",2021,1,402309,386107,16202,4
MT1617660000000,16,17660,"Coeur d'Alene, ID MSA",2021,1,83771,79604,4167,5
MT1626820000000,16,26820,"Idaho Falls, ID MSA",2021,1,76450,73948,2502,3.3
MT1630300000000,16,30300,"Lewiston, ID-WA MSA",2021,1,29917,28736,1181,3.9
MT1638540000000,16,38540,"Pocatello, ID MSA",2021,1,37971,36277,1694,4.5
MT1646300000000,16,46300,"Twin Falls, ID MSA",2021,1,57364,55179,2185,3.8
MT1714010000000,17,14010,"Bloomington, IL MSA",2021,1,87079,82606,4473,5.1
MT1716580000000,17,16580,"Champaign-Urbana, IL MSA",2021,1,121849,115073,6776,5.6
MT1716980000000,17,16980,"Chicago-Naperville-Elgin, IL-IN MSA",2021,1,4676363,4322981,353382,7.6
MT1719340000000,17,19340,"Davenport-Moline-Rock Island, IA-IL MSA",2021,1,187384,176313,11071,5.9
MT1719500000000,17,19500,"Decatur, IL MSA",2021,1,46488,42338,4150,8.9
MT1728100000000,17,28100,"Kankakee, IL MSA",2021,1,51943,48175,3768,7.3
MT1737900000000,17,37900,"Peoria, IL MSA",2021,1,174412,162712,11700,6.7
MT1740420000000,17,40420,"Rockford, IL MSA",2021,1,162889,148495,14394,8.8
MT1744100000000,17,44100,"Springfield, IL MSA",2021,1,101060,94409,6651,6.6
MT1814020000000,18,14020,"Bloomington, IN MSA",2021,1,80218,77104,3114,3.9
MT1818020000000,18,18020,"Columbus, IN MSA",2021,1,39075,37422,1653,4.2
MT1821140000000,18,21140,"Elkhart-Goshen, IN MSA",2021,1,104779,100623,4156,4
MT1821780000000,18,21780,"Evansville, IN MSA",2021,1,135038,129198,5840,4.3
MT1823060000000,18,23060,"Fort Wayne, IN MSA",2021,1,224613,214572,10041,4.5
MT1826900000000,18,26900,"Indianapolis-Carmel-Greenwood, IN MSA",2021,1,1079658,1028037,51621,4.8
MT1829020000000,18,29020,"Kokomo, IN MSA",2021,1,37343,35451,1892,5.1
MT1829200000000,18,29200,"Lafayette-West Lafayette, IN MSA",2021,1,112016,107278,4738,4.2
MT1833140000000,18,33140,"Michigan City-La Porte, IN MSA",2021,1,50573,47394,3179,6.3
MT1834620000000,18,34620,"Muncie, IN MSA",2021,1,52540,49938,2602,5
MT1843780000000,18,43780,"South Bend-Mishawaka, IN-MI MSA",2021,1,154978,146033,8945,5.8
MT1845460000000,18,45460,"Terre Haute, IN MSA",2021,1,77010,73242,3768,4.9
MT1911180000000,19,11180,"Ames, IA MSA",2021,1,66205,64056,2149,3.2
MT1916300000000,19,16300,"Cedar Rapids, IA MSA",2021,1,146327,139335,6992,4.8
MT1919780000000,19,19780,"Des Moines-West Des Moines, IA MSA",2021,1,380645,364173,16472,4.3
MT1920220000000,19,20220,"Dubuque, IA MSA",2021,1,52365,49951,2414,4.6
MT1926980000000,19,26980,"Iowa City, IA MSA",2021,1,94856,91237,3619,3.8
MT1943580000000,19,43580,"Sioux City, IA-NE-SD MSA",2021,1,74401,71366,3035,4.1
MT1947940000000,19,47940,"Waterloo-Cedar Falls, IA MSA",2021,1,87543,83800,3743,4.3
MT2029940000000,20,29940,"Lawrence, KS MSA",2021,1,66773,64164,2609,3.9
MT2031740000000,20,31740,"Manhattan, KS MSA",2021,1,61282,59126,2156,3.5
MT2045820000000,20,45820,"Topeka, KS MSA",2021,1,116407,111809,4598,3.9
MT2048620000000,20,48620,"Wichita, KS MSA",2021,1,325188,306736,18452,5.7
MT2114540000000,21,14540,"Bowling Green, KY MSA",2021,1,86235,82685,3550,4.1
MT2121060000000,21,21060,"Elizabethtown, KY MSA",2021,1,53243,50856,2387,4.5
MT2130460000000,21,30460,"Lexington-Fayette, KY MSA",2021,1,259984,249167,10817,4.2
MT2131140000000,21,31140,"Louisville/Jefferson County, KY-IN MSA",2021,1,674598,643610,30988,4.6
MT2136980000000,21,36980,"Owensboro, KY MSA",2021,1,50636,48466,2170,4.3
MT2137140000000,21,37140,"Paducah, KY-IL MSA",2021,1,44188,41864,2324,5.3
MT2210780000000,22,10780,"Alexandria, LA MSA",2021,1,65314,61936,3378,5.2
MT2212940000000,22,12940,"Baton Rouge, LA MSA",2021,1,414693,388251,26442,6.4
MT2225220000000,22,25220,"Hammond, LA MSA",2021,1,58782,54343,4439,7.6
MT2226380000000,22,26380,"Houma-Bayou Cane-Thibodaux, LA MSA",2021,1,88457,82987,5470,6.2
MT2229180000000,22,29180,"Lafayette, LA MSA",2021,1,191005,179688,11317,5.9
MT2229340000000,22,29340,"Lake Charles, LA MSA",2021,1,101433,93180,8253,8.1
MT2233740000000,22,33740,"Monroe, LA MSA",2021,1,95610,89126,6484,6.8
MT2235380000000,22,35380,"New Orleans-Metairie, LA MSA",2021,1,464159,427291,36868,7.9
MT2243340000000,22,43340,"Shreveport-Bossier City, LA MSA",2021,1,166562,155122,11440,6.9
MT2243640000000,22,43640,"Slidell-Mandeville-Covington, LA MSA",2021,1,122010,116294,5716,4.7
MT2312620000000,23,12620,"Bangor, ME MSA",2021,1,72407,69165,3242,4.5
MT2330340000000,23,30340,"Lewiston-Auburn, ME MSA",2021,1,55136,52635,2501,4.5
MT2338860000000,23,38860,"Portland-South Portland, ME MSA",2021,1,299037,285844,13193,4.4
MT2412580000000,24,12580,"Baltimore-Columbia-Towson, MD MSA",2021,1,1454860,1365076,89784,6.2
MT2425180000000,24,25180,"Hagerstown-Martinsburg, MD-WV MSA",2021,1,140179,133007,7172,5.1
MT2430500000000,24,30500,"Lexington Park, MD MSA",2021,1,104941,99977,4964,4.7
MT2441540000000,24,41540,"Salisbury, MD MSA",2021,1,60365,56476,3889,6.4
MT2511200000000,25,11200,"Amherst Town-Northampton, MA MSA",2021,1,81664,76620,5044,6.2
MT2512700000000,25,12700,"Barnstable Town, MA MSA",2021,1,112206,103873,8333,7.4
MT2514460000000,25,14460,"Boston-Cambridge-Newton, MA-NH MSA",2021,1,2705886,2534388,171498,6.3
MT2538340000000,25,38340,"Pittsfield, MA MSA",2021,1,62954,58180,4774,7.6
MT2544140000000,25,44140,"Springfield, MA MSA",2021,1,226388,207114,19274,8.5
MT2549340000000,25,49340,"Worcester, MA MSA",2021,1,448060,417529,30531,6.8
MT2611460000000,26,11460,"Ann Arbor, MI MSA",2021,1,192193,183004,9189,4.8
MT2612980000000,26,12980,"Battle Creek, MI MSA",2021,1,59421,55222,4199,7.1
MT2613020000000,26,13020,"Bay City, MI MSA",2021,1,47176,44056,3120,6.6
MT2619820000000,26,19820,"Detroit-Warren-Dearborn, MI MSA",2021,1,2088400,1942540,145860,7
MT2622420000000,26,22420,"Flint, MI MSA",2021,1,178676,165329,13347,7.5
MT2624340000000,26,24340,"Grand Rapids-Wyoming-Kentwood, MI MSA",2021,1,583962,553932,30030,5.1
MT2627100000000,26,27100,"Jackson, MI MSA",2021,1,71415,66865,4550,6.4
MT2628020000000,26,28020,"Kalamazoo-Portage, MI MSA",2021,1,130782,123729,7053,5.4
MT2629620000000,26,29620,"Lansing-East Lansing, MI MSA",2021,1,232206,219569,12637,5.4
MT2633220000000,26,33220,"Midland, MI MSA",2021,1,38261,36218,2043,5.3
MT2633780000000,26,33780,"Monroe, MI MSA",2021,1,71777,67442,4335,6
MT2634740000000,26,34740,"Muskegon-Norton Shores, MI MSA",2021,1,79542,73453,6089,7.7
MT2635660000000,26,35660,"Niles, MI MSA",2021,1,71756,67278,4478,6.2
MT2640980000000,26,40980,"Saginaw, MI MSA",2021,1,81645,75700,5945,7.3
MT2645900000000,26,45900,"Traverse City, MI MSA",2021,1,74880,70313,4567,6.1
MT2720260000000,27,20260,"Duluth, MN-WI MSA",2021,1,137606,130400,7206,5.2
MT2731860000000,27,31860,"Mankato, MN MSA",2021,1,58906,56548,2358,4
MT2733460000000,27,33460,"Minneapolis-St. Paul-Bloomington, MN-WI MSA",2021,1,2013320,1922792,90528,4.5
MT2740340000000,27,40340,"Rochester, MN MSA",2021,1,124597,119680,4917,3.9
MT2741060000000,27,41060,"St. Cloud, MN MSA",2021,1,108628,103278,5350,4.9
MT2825060000000,28,25060,"Gulfport-Biloxi, MS MSA",2021,1,182389,171138,11251,6.2
MT2825620000000,28,25620,"Hattiesburg, MS MSA",2021,1,68876,64789,4087,5.9
MT2827140000000,28,27140,"Jackson, MS MSA",2021,1,276690,260035,16655,6
MT2916020000000,29,16020,"Cape Girardeau, MO-IL MSA",2021,1,47431,45356,2075,4.4
MT2917860000000,29,17860,"Columbia, MO MSA",2021,1,110300,106374,3926,3.6
MT2927620000000,29,27620,"Jefferson City, MO MSA",2021,1,73275,70592,2683,3.7
MT2927900000000,29,27900,"Joplin, MO-KS MSA",2021,1,93451,89384,4067,4.4
MT2928140000000,29,28140,"Kansas City, MO-KS MSA",2021,1,1149946,1096724,53222,4.6
MT2941140000000,29,41140,"St. Joseph, MO-KS MSA",2021,1,56500,53956,2544,4.5
MT2941180000000,29,41180,"St. Louis, MO-IL MSA",2021,1,1446138,1370524,75614,5.2
MT2944180000000,29,44180,"Springfield, MO MSA",2021,1,230845,221512,9333,4
MT3013740000000,30,13740,"Billings, MT MSA",2021,1,94622,91054,3568,3.8
MT3014580000000,30,14580,"Bozeman, MT MSA",2021,1,69544,67374,2170,3.1
MT3024500000000,30,24500,"Great Falls, MT MSA",2021,1,38518,36995,1523,4
MT3025740000000,30,25740,"Helena, MT MSA",2021,1,44905,43235,1670,3.7
MT3033540000000,30,33540,"Missoula, MT MSA",2021,1,69220,66610,2610,3.8
MT3124260000000,31,24260,"Grand Island, NE MSA",2021,1,40810,39481,1329,3.3
MT3130700000000,31,30700,"Lincoln, NE MSA",2021,1,185929,180115,5814,3.1
MT3136540000000,31,36540,"Omaha, NE-IA MSA",2021,1,507975,490906,17069,3.4
MT3216180000000,32,16180,"Carson City, NV MSA",2021,1,28866,27426,1440,5
MT3229820000000,32,29820,"Las Vegas-Henderson-North Las Vegas, NV MSA",2021,1,1088645,975372,113273,10.4
MT3239900000000,32,39900,"Reno, NV MSA",2021,1,288083,273676,14407,5
MT3331700000000,33,31700,"Manchester-Nashua, NH MSA",2021,1,238018,227238,10780,4.5
MT3412100000000,34,12100,"Atlantic City-Hammonton, NJ MSA",2021,1,175695,158657,17038,9.7
MT3445940000000,34,45940,"Trenton-Princeton, NJ MSA",2021,1,193236,180467,12769,6.6
MT3447220000000,34,47220,"Vineland, NJ MSA",2021,1,64444,58876,5568,8.6
MT3510740000000,35,10740,"Albuquerque, NM MSA",2021,1,437320,403665,33655,7.7
MT3522140000000,35,22140,"Farmington, NM MSA",2021,1,47800,42963,4837,10.1
MT3529740000000,35,29740,"Las Cruces, NM MSA",2021,1,95224,87732,7492,7.9
MT3542140000000,35,42140,"Santa Fe, NM MSA",2021,1,70565,65108,5457,7.7
MT3610580000000,36,10580,"Albany-Schenectady-Troy, NY MSA",2021,1,450769,427258,23511,5.2
MT3613780000000,36,13780,"Binghamton, NY MSA",2021,1,107004,100763,6241,5.8
MT3615380000000,36,15380,"Buffalo-Cheektowaga, NY MSA",2021,1,554704,516901,37803,6.8
MT3621300000000,36,21300,"Elmira, NY MSA",2021,1,36417,34183,2234,6.1
MT3624020000000,36,24020,"Glens Falls, NY MSA",2021,1,59947,56814,3133,5.2
MT3627060000000,36,27060,"Ithaca, NY MSA",2021,1,49313,47092,2221,4.5
MT3628740000000,36,28740,"Kingston, NY MSA",2021,1,84739,79864,4875,5.8
MT3628880000000,36,28880,"Kiryas Joel-Poughkeepsie-Newburgh, NY MSA",2021,1,326008,307405,18603,5.7
MT3635620000000,36,35620,"New York-Newark-Jersey City, NY-NJ MSA",2021,1,9685325,8821500,863825,8.9
MT3640380000000,36,40380,"Rochester, NY MSA",2021,1,513687,482173,31514,6.1
MT3645060000000,36,45060,"Syracuse, NY MSA",2021,1,310646,292552,18094,5.8
MT3646540000000,36,46540,"Utica-Rome, NY MSA",2021,1,128788,120908,7880,6.1
MT3648060000000,36,48060,"Watertown-Fort Drum, NY MSA",2021,1,44685,42257,2428,5.4
MT3711700000000,37,11700,"Asheville, NC MSA",2021,1,193925,183819,10106,5.2
MT3715500000000,37,15500,"Burlington, NC MSA",2021,1,78854,74320,4534,5.7
MT3716740000000,37,16740,"Charlotte-Concord-Gastonia, NC-SC MSA",2021,1,1351054,1276181,74873,5.5
MT3720500000000,37,20500,"Durham-Chapel Hill, NC MSA",2021,1,291284,276825,14459,5
MT3722180000000,37,22180,"Fayetteville, NC MSA",2021,1,148076,136987,11089,7.5
MT3724140000000,37,24140,"Goldsboro, NC MSA",2021,1,48768,45936,2832,5.8
MT3724660000000,37,24660,"Greensboro-High Point, NC MSA",2021,1,359945,336989,22956,6.4
MT3724780000000,37,24780,"Greenville, NC MSA",2021,1,76718,71731,4987,6.5
MT3725860000000,37,25860,"Hickory-Lenoir-Morganton, NC MSA",2021,1,163882,154654,9228,5.6
MT3727340000000,37,27340,"Jacksonville, NC MSA",2021,1,67903,64137,3766,5.5
MT3738240000000,37,38240,"Pinehurst-Southern Pines, NC MSA",2021,1,40480,38372,2108,5.2
MT3739580000000,37,39580,"Raleigh-Cary, NC MSA",2021,1,734654,698552,36102,4.9
MT3740580000000,37,40580,"Rocky Mount, NC MSA",2021,1,62636,57791,4845,7.7
MT3748900000000,37,48900,"Wilmington, NC MSA",2021,1,196825,185876,10949,5.6
MT3749180000000,37,49180,"Winston-Salem, NC MSA",2021,1,310359,292527,17832,5.7
MT3813900000000,38,13900,"Bismarck, ND MSA",2021,1,71835,69398,2437,3.4
MT3822020000000,38,22020,"Fargo, ND-MN MSA",2021,1,145370,140747,4623,3.2
MT3824220000000,38,24220,"Grand Forks, ND-MN MSA",2021,1,54189,52131,2058,3.8
MT3833500000000,38,33500,"Minot, ND MSA",2021,1,38814,37067,1747,4.5
MT3910420000000,39,10420,"Akron, OH MSA",2021,1,353575,331715,21860,6.2
MT3915940000000,39,15940,"Canton-Massillon, OH MSA",2021,1,192311,180369,11942,6.2
MT3917140000000,39,17140,"Cincinnati, OH-KY-IN MSA",2021,1,1129292,1070053,59239,5.2
MT3917410000000,39,17410,"Cleveland, OH MSA",2021,1,1051013,979632,71381,6.8
MT3918140000000,39,18140,"Columbus, OH MSA",2021,1,1112866,1049182,63684,5.7
MT3919430000000,39,19430,"Dayton-Kettering-Beavercreek, OH MSA",2021,1,385994,362358,23636,6.1
MT3930620000000,39,30620,"Lima, OH MSA",2021,1,48181,45571,2610,5.4
MT3931900000000,39,31900,"Mansfield, OH MSA",2021,1,53101,49812,3289,6.2
MT3941780000000,39,41780,"Sandusky, OH MSA",2021,1,55981,52550,3431,6.1
MT3944220000000,39,44220,"Springfield, OH MSA",2021,1,61180,57470,3710,6.1
MT3945780000000,39,45780,"Toledo, OH MSA",2021,1,293568,274061,19507,6.6
MT3948260000000,39,48260,"Weirton-Steubenville, WV-OH MSA",2021,1,53017,49290,3727,7
MT3949660000000,39,49660,"Youngstown-Warren, OH MSA",2021,1,188950,174750,14200,7.5
MT4021420000000,40,21420,"Enid, OK MSA",2021,1,28541,27251,1290,4.5
MT4030020000000,40,30020,"Lawton, OK MSA",2021,1,50897,48694,2203,4.3
MT4036420000000,40,36420,"Oklahoma City, OK MSA",2021,1,706371,673177,33194,4.7
MT4046140000000,40,46140,"Tulsa, OK MSA",2021,1,488728,464199,24529,5
MT4110540000000,41,10540,"Albany, OR MSA",2021,1,60132,56174,3958,6.6
MT4113460000000,41,13460,"Bend, OR MSA",2021,1,125356,116707,8649,6.9
MT4118700000000,41,18700,"Corvallis, OR MSA",2021,1,46359,44054,2305,5
MT4121660000000,41,21660,"Eugene-Springfield, OR MSA",2021,1,183773,171963,11810,6.4
MT4124420000000,41,24420,"Grants Pass, OR MSA",2021,1,35743,33176,2567,7.2
MT4132780000000,41,32780,"Medford, OR MSA",2021,1,105960,99016,6944,6.6
MT4138900000000,41,38900,"Portland-Vancouver-Hillsboro, OR-WA MSA",2021,1,1344757,1260020,84737,6.3
MT4141420000000,41,41420,"Salem, OR MSA",2021,1,210565,198041,12524,5.9
MT4210900000000,42,10900,"Allentown-Bethlehem-Easton, PA-NJ MSA",2021,1,440902,409764,31138,7.1
MT4211020000000,42,11020,"Altoona, PA MSA",2021,1,58287,54358,3929,6.7
MT4216540000000,42,16540,"Chambersburg, PA MSA",2021,1,77438,73001,4437,5.7
MT4221500000000,42,21500,"Erie, PA MSA",2021,1,127711,117326,10385,8.1
MT4223900000000,42,23900,"Gettysburg, PA MSA",2021,1,52259,49418,2841,5.4
MT4225420000000,42,25420,"Harrisburg-Carlisle, PA MSA",2021,1,305417,286846,18571,6.1
MT4227780000000,42,27780,"Johnstown, PA MSA",2021,1,57637,53467,4170,7.2
MT4229540000000,42,29540,"Lancaster, PA MSA",2021,1,286814,270990,15824,5.5
MT4230140000000,42,30140,"Lebanon, PA MSA",2021,1,71357,66841,4516,6.3
MT4237980000000,42,37980,"Philadelphia-Camden-Wilmington, PA-NJ-DE-MD MSA",2021,1,3174112,2950837,223275,7
MT4238300000000,42,38300,"Pittsburgh, PA MSA",2021,1,1233694,1145066,88628,7.2
MT4239740000000,42,39740,"Reading, PA MSA",2021,1,216210,200516,15694,7.3
MT4242540000000,42,42540,"Scranton--Wilkes-Barre, PA MSA",2021,1,275445,251977,23468,8.5
MT4244300000000,42,44300,"State College, PA MSA",2021,1,73675,69772,3903,5.3
MT4248700000000,42,48700,"Williamsport, PA MSA",2021,1,53486,49466,4020,7.5
MT4249620000000,42,49620,"York-Hanover, PA MSA",2021,1,234924,220559,14365,6.1
MT4439300000000,44,39300,"Providence-Warwick, RI-MA MSA",2021,1,866161,806489,59672,6.9
MT4516700000000,45,16700,"Charleston-North Charleston, SC MSA",2021,1,393880,376453,17427,4.4
MT4517900000000,45,17900,"Columbia, SC MSA",2021,1,394594,376711,17883,4.5
MT4522500000000,45,22500,"Florence, SC MSA",2021,1,88956,84221,4735,5.3
MT4524860000000,45,24860,"Greenville-Anderson-Greer, SC MSA",2021,1,442917,424735,18182,4.1
MT4525940000000,45,25940,"Hilton Head Island-Bluffton-Port Royal, SC MSA",2021,1,91167,87657,3510,3.9
MT4534820000000,45,34820,"Myrtle Beach-Conway-North Myrtle Beach, SC MSA",2021,1,152306,143973,8333,5.5
MT4543900000000,45,43900,"Spartanburg, SC MSA",2021,1,168000,159870,8130,4.8
MT4544940000000,45,44940,"Sumter, SC MSA",2021,1,42897,40541,2356,5.5
MT4639660000000,46,39660,"Rapid City, SD MSA",2021,1,75305,73030,2275,3
MT4643620000000,46,43620,"Sioux Falls, SD-MN MSA",2021,1,163128,158775,4353,2.7
MT4716860000000,47,16860,"Chattanooga, TN-GA MSA",2021,1,272782,260391,12391,4.5
MT4717300000000,47,17300,"Clarksville, TN-KY MSA",2021,1,132474,125592,6882,5.2
MT4717420000000,47,17420,"Cleveland, TN MSA",2021,1,58062,55108,2954,5.1
MT4727180000000,47,27180,"Jackson, TN MSA",2021,1,80136,75533,4603,5.7
MT4727740000000,47,27740,"Johnson City, TN MSA",2021,1,96144,91711,4433,4.6
MT4728700000000,47,28700,"Kingsport-Bristol, TN-VA MSA",2021,1,129717,122953,6764,5.2
MT4728940000000,47,28940,"Knoxville, TN MSA",2021,1,430154,410942,19212,4.5
MT4732820000000,47,32820,"Memphis, TN-MS-AR MSA",2021,1,649044,600954,48090,7.4
MT4734100000000,47,34100,"Morristown, TN MSA",2021,1,52574,50046,2528,4.8
MT4734980000000,47,34980,"Nashville-Davidson--Murfreesboro--Franklin, TN MSA",2021,1,1084547,1033604,50943,4.7
MT4810180000000,48,10180,"Abilene, TX MSA",2021,1,80429,76293,4136,5.1
MT4811100000000,48,11100,"Amarillo, TX MSA",2021,1,130487,124455,6032,4.6
MT4812420000000,48,12420,"Austin-Round Rock-San Marcos, TX MSA",2021,1,1268659,1204916,63743,5
MT4813140000000,48,13140,"Beaumont-Port Arthur, TX MSA",2021,1,172566,155219,17347,10.1
MT4815180000000,48,15180,"Brownsville-Harlingen, TX MSA",2021,1,178817,162545,16272,9.1
MT4817780000000,48,17780,"College Station-Bryan, TX MSA",2021,1,132643,125769,6874,5.2
MT4818580000000,48,18580,"Corpus Christi, TX MSA",2021,1,200898,184005,16893,8.4
MT4819100000000,48,19100,"Dallas-Fort Worth-Arlington, TX MSA",2021,1,4023314,3779533,243781,6.1
MT4820580000000,48,20580,"Eagle Pass, TX MSA",2021,1,23901,20256,3645,15.3
MT4821340000000,48,21340,"El Paso, TX MSA",2021,1,382200,354216,27984,7.3
MT4826420000000,48,26420,"Houston-Pasadena-The Woodlands, TX MSA",2021,1,3487898,3224898,263000,7.5
MT4828660000000,48,28660,"Killeen-Temple, TX MSA",2021,1,190867,179215,11652,6.1
MT4829700000000,48,29700,"Laredo, TX MSA",2021,1,110225,101468,8757,7.9
MT4830980000000,48,30980,"Longview, TX MSA",2021,1,124988,115492,9496,7.6
MT4831180000000,48,31180,"Lubbock, TX MSA",2021,1,173340,163636,9704,5.6
MT4832580000000,48,32580,"McAllen-Edinburg-Mission, TX MSA",2021,1,369714,331001,38713,10.5
MT4833260000000,48,33260,"Midland, TX MSA",2021,1,86939,79408,7531,8.7
MT4836220000000,48,36220,"Odessa, TX MSA",2021,1,77691,68778,8913,11.5
MT4841660000000,48,41660,"San Angelo, TX MSA",2021,1,57555,54361,3194,5.5
MT4841700000000,48,41700,"San Antonio-New Braunfels, TX MSA",2021,1,1208378,1133994,74384,6.2
MT4843300000000,48,43300,"Sherman-Denison, TX MSA",2021,1,65238,61801,3437,5.3
MT4845500000000,48,45500,"Texarkana, TX-AR MSA",2021,1,60746,56871,3875,6.4
MT4846340000000,48,46340,"Tyler, TX MSA",2021,1,109443,102823,6620,6
MT4847020000000,48,47020,"Victoria, TX MSA",2021,1,44654,41285,3369,7.5
MT4847380000000,48,47380,"Waco, TX MSA",2021,1,136539,128682,7857,5.8
MT4848660000000,48,48660,"Wichita Falls, TX MSA",2021,1,65761,61730,4031,6.1
MT4930860000000,49,30860,"Logan, UT-ID MSA",2021,1,75189,73329,1860,2.5
MT4936260000000,49,36260,"Ogden, UT MSA",2021,1,324626,314239,10387,3.2
MT4939340000000,49,39340,"Provo-Orem-Lehi, UT MSA",2021,1,333985,324076,9909,3
MT4941100000000,49,41100,"St. George, UT MSA",2021,1,81632,78543,3089,3.8
MT4941620000000,49,41620,"Salt Lake City-Murray, UT MSA",2021,1,677915,653423,24492,3.6
MT5015540000000,50,15540,"Burlington-South Burlington, VT MSA",2021,1,123534,118560,4974,4
MT5113980000000,51,13980,"Blacksburg-Christiansburg-Radford, VA MSA",2021,1,85780,82361,3419,4
MT5116820000000,51,16820,"Charlottesville, VA MSA",2021,1,109466,104963,4503,4.1
MT5125500000000,51,25500,"Harrisonburg, VA MSA",2021,1,67723,65218,2505,3.7
MT5131340000000,51,31340,"Lynchburg, VA MSA",2021,1,124160,118500,5660,4.6
MT5140060000000,51,40060,"Richmond, VA MSA",2021,1,671068,638202,32866,4.9
MT5140220000000,51,40220,"Roanoke, VA MSA",2021,1,150091,143327,6764,4.5
MT5144420000000,51,44420,"Staunton-Stuarts Draft, VA MSA",2021,1,60818,58488,2330,3.8
MT5147260000000,51,47260,"Virginia Beach-Chesapeake-Norfolk, VA-NC MSA",2021,1,841182,795911,45271,5.4
MT5149020000000,51,49020,"Winchester, VA-WV MSA",2021,1,71362,68710,2652,3.7
MT5313380000000,53,13380,"Bellingham, WA MSA",2021,1,112490,104782,7708,6.9
MT5314740000000,53,14740,"Bremerton-Silverdale-Port Orchard, WA MSA",2021,1,121765,114278,7487,6.1
MT5328420000000,53,28420,"Kennewick-Richland, WA MSA",2021,1,142535,133399,9136,6.4
MT5331020000000,53,31020,"Longview-Kelso, WA MSA",2021,1,47708,44294,3414,7.2
MT5334580000000,53,34580,"Mount Vernon-Anacortes, WA MSA",2021,1,58739,54416,4323,7.4
MT5336500000000,53,36500,"Olympia-Lacey-Tumwater, WA MSA",2021,1,137693,129138,8555,6.2
MT5342660000000,53,42660,"Seattle-Tacoma-Bellevue, WA MSA",2021,1,2148186,2011322,136864,6.4
MT5344060000000,53,44060,"Spokane-Spokane Valley, WA MSA",2021,1,276297,259055,17242,6.2
MT5347460000000,53,47460,"Walla Walla, WA MSA",2021,1,29632,27966,1666,5.6
MT5348300000000,53,48300,"Wenatchee-East Wenatchee, WA MSA",2021,1,62442,58481,3961,6.3
MT5349420000000,53,49420,"Yakima, WA MSA",2021,1,128363,118908,9455,7.4
MT5413220000000,54,13220,"Beckley, WV MSA",2021,1,45248,42173,3075,6.8
MT5416620000000,54,16620,"Charleston, WV MSA",2021,1,90403,84377,6026,6.7
MT5426580000000,54,26580,"Huntington-Ashland, WV-KY-OH MSA",2021,1,152294,143284,9010,5.9
MT5434060000000,54,34060,"Morgantown, WV MSA",2021,1,68845,65493,3352,4.9
MT5437620000000,54,37620,"Parkersburg-Vienna, WV MSA",2021,1,38773,36260,2513,6.5
MT5448540000000,54,48540,"Wheeling, WV-OH MSA",2021,1,60527,56355,4172,6.9
MT5511540000000,55,11540,"Appleton, WI MSA",2021,1,134577,129654,4923,3.7
MT5520740000000,55,20740,"Eau Claire, WI MSA",2021,1,92345,88281,4064,4.4
MT5522540000000,55,22540,"Fond du Lac, WI MSA",2021,1,56271,53953,2318,4.1
MT5524580000000,55,24580,"Green Bay, WI MSA",2021,1,175321,168084,7237,4.1
MT5527500000000,55,27500,"Janesville-Beloit, WI MSA",2021,1,84138,79831,4307,5.1
MT5528450000000,55,28450,"Kenosha, WI MSA",2021,1,92556,87911,4645,5
MT5529100000000,55,29100,"La Crosse-Onalaska, WI-MN MSA",2021,1,88232,84742,3490,4
MT5531540000000,55,31540,"Madison, WI MSA",2021,1,389437,375074,14363,3.7
MT5533340000000,55,33340,"Milwaukee-Waukesha, WI MSA",2021,1,812780,768690,44090,5.4
MT5536780000000,55,36780,"Oshkosh-Neenah, WI MSA",2021,1,91902,88304,3598,3.9
MT5539540000000,55,39540,"Racine-Mount Pleasant, WI MSA",2021,1,100105,94490,5615,5.6
MT5543100000000,55,43100,"Sheboygan, WI MSA",2021,1,62748,60388,2360,3.8
MT5548140000000,55,48140,"Wausau, WI MSA",2021,1,74602,71935,2667,3.6
MT5616220000000,56,16220,"Casper, WY MSA",2021,1,41517,38504,3013,7.3
MT5616940000000,56,16940,"Cheyenne, WY MSA",2021,1,49028,46737,2291,4.7
MT7210380000000,72,10380,"Aguadilla, PR MSA",2021,1,77959,70806,7153,9.2
MT7211640000000,72,11640,"Arecibo, PR MSA",2021,1,60639,55931,4708,7.8
MT7225020000000,72,25020,"Guayama, PR MSA",2021,1,18239,16386,1853,10.2
MT7232420000000,72,32420,"Mayaguez, PR MSA",2021,1,61291,55280,6011,9.8
MT7238660000000,72,38660,"Ponce, PR MSA",2021,1,82904,74115,8789,10.6
MT7241980000000,72,41980,"San Juan-Bayamon-Caguas, PR MSA",2021,1,751771,687910,63861,8.5
MT0111500000000,1,11500,"Anniston-Oxford, AL MSA",2021,2,49978,47823,2155,4.3
MT0112220000000,1,12220,"Auburn-Opelika, AL MSA",2021,2,90073,86980,3093,3.4
MT0113820000000,1,13820,"Birmingham, AL MSA",2021,2,551839,531600,20239,3.7
MT0119300000000,1,19300,"Daphne-Fairhope-Foley, AL MSA",2021,2,106546,103194,3352,3.1
MT0119460000000,1,19460,"Decatur, AL MSA",2021,2,71554,69369,2185,3.1
MT0120020000000,1,20020,"Dothan, AL MSA",2021,2,65774,63382,2392,3.6
MT0122520000000,1,22520,"Florence-Muscle Shoals, AL MSA",2021,2,66700,64241,2459,3.7
MT0123460000000,1,23460,"Gadsden, AL MSA",2021,2,42013,40194,1819,4.3
MT0126620000000,1,26620,"Huntsville, AL MSA",2021,2,247004,239940,7064,2.9
MT0133660000000,1,33660,"Mobile, AL MSA",2021,2,183265,172790,10475,5.7
MT0133860000000,1,33860,"Montgomery, AL MSA",2021,2,172695,164215,8480,4.9
MT0146220000000,1,46220,"Tuscaloosa, AL MSA",2021,2,119798,114515,5283,4.4
MT0211260000000,2,11260,"Anchorage, AK MSA",2021,2,194815,181311,13504,6.9
MT0221820000000,2,21820,"Fairbanks-College, AK MSA",2021,2,44252,41816,2436,5.5
MT0422380000000,4,22380,"Flagstaff, AZ MSA",2021,2,69755,64284,5471,7.8
MT0429420000000,4,29420,"Lake Havasu City-Kingman, AZ MSA",2021,2,84255,78373,5882,7
MT0438060000000,4,38060,"Phoenix-Mesa-Chandler, AZ MSA",2021,2,2513112,2366564,146548,5.8
MT0439150000000,4,39150,"Prescott Valley-Prescott, AZ MSA",2021,2,100520,94873,5647,5.6
MT0443420000000,4,43420,"Sierra Vista-Douglas, AZ MSA",2021,2,48525,45737,2788,5.7
MT0446060000000,4,46060,"Tucson, AZ MSA",2021,2,481826,451039,30787,6.4
MT0449740000000,4,49740,"Yuma, AZ MSA",2021,2,93353,80887,12466,13.4
MT0522220000000,5,22220,"Fayetteville-Springdale-Rogers, AR MSA",2021,2,271813,262155,9658,3.6
MT0522900000000,5,22900,"Fort Smith, AR-OK MSA",2021,2,99050,94705,4345,4.4
MT0526300000000,5,26300,"Hot Springs, AR MSA",2021,2,42943,40465,2478,5.8
MT0527860000000,5,27860,"Jonesboro, AR MSA",2021,2,62953,60304,2649,4.2
MT0530780000000,5,30780,"Little Rock-North Little Rock-Conway, AR MSA",2021,2,351635,334120,17515,5
MT0612540000000,6,12540,"Bakersfield-Delano, CA MSA",2021,2,385550,344203,41347,10.7
MT0617020000000,6,17020,"Chico, CA MSA",2021,2,89797,82733,7064,7.9
MT0620940000000,6,20940,"El Centro, CA MSA",2021,2,66468,53854,12614,19
MT0623420000000,6,23420,"Fresno, CA MSA",2021,2,497349,447541,49808,10
MT0625260000000,6,25260,"Hanford-Corcoran, CA MSA",2021,2,53847,48136,5711,10.6
MT0631080000000,6,31080,"Los Angeles-Long Beach-Anaheim, CA MSA",2021,2,6479976,5840886,639090,9.9
MT0632900000000,6,32900,"Merced, CA MSA",2021,2,113901,101347,12554,11
MT0633700000000,6,33700,"Modesto, CA MSA",2021,2,242251,220105,22146,9.1
MT0634900000000,6,34900,"Napa, CA MSA",2021,2,68185,62960,5225,7.7
MT0637100000000,6,37100,"Oxnard-Thousand Oaks-Ventura, CA MSA",2021,2,402815,373422,29393,7.3
MT0639820000000,6,39820,"Redding, CA MSA",2021,2,76402,70860,5542,7.3
MT0640140000000,6,40140,"Riverside-San Bernardino-Ontario, CA MSA",2021,2,2091866,1908425,183441,8.8
MT0640900000000,6,40900,"Sacramento-Roseville-Folsom, CA MSA",2021,2,1116954,1035258,81696,7.3
MT0641500000000,6,41500,"Salinas, CA MSA",2021,2,207167,188629,18538,8.9
MT0641740000000,6,41740,"San Diego-Chula Vista-Carlsbad, CA MSA",2021,2,1549234,1429861,119373,7.7
MT0641860000000,6,41860,"San Francisco-Oakland-Fremont, CA MSA",2021,2,2413308,2248964,164344,6.8
MT0641940000000,6,41940,"San Jose-Sunnyvale-Santa Clara, CA MSA",2021,2,1012540,952150,60390,6
MT0642020000000,6,42020,"San Luis Obispo-Paso Robles, CA MSA",2021,2,128663,120064,8599,6.7
MT0642100000000,6,42100,"Santa Cruz-Watsonville, CA MSA",2021,2,132260,122441,9819,7.4
MT0642200000000,6,42200,"Santa Maria-Santa Barbara, CA MSA",2021,2,212310,197732,14578,6.9
MT0642220000000,6,42220,"Santa Rosa-Petaluma, CA MSA",2021,2,238466,222576,15890,6.7
MT0644700000000,6,44700,"Stockton-Lodi, CA MSA",2021,2,347004,314562,32442,9.3
MT0646700000000,6,46700,"Vallejo, CA MSA",2021,2,206896,189639,17257,8.3
MT0647300000000,6,47300,"Visalia, CA MSA",2021,2,200601,178046,22555,11.2
MT0649700000000,6,49700,"Yuba City, CA MSA",2021,2,75956,68854,7102,9.4
MT0814500000000,8,14500,"Boulder, CO MSA",2021,2,186060,176058,10002,5.4
MT0817820000000,8,17820,"Colorado Springs, CO MSA",2021,2,372316,349097,23219,6.2
MT0819740000000,8,19740,"Denver-Aurora-Centennial, CO MSA",2021,2,1690235,1585605,104630,6.2
MT0822660000000,8,22660,"Fort Collins-Loveland, CO MSA",2021,2,196406,185056,11350,5.8
MT0824300000000,8,24300,"Grand Junction, CO MSA",2021,2,78044,73007,5037,6.5
MT0824540000000,8,24540,"Greeley, CO MSA",2021,2,166172,155303,10869,6.5
MT0839380000000,8,39380,"Pueblo, CO MSA",2021,2,74993,68310,6683,8.9
MT0914860000000,9,14860,"Bridgeport-Stamford-Danbury, CT MSA",2021,2,468860,436589,32271,6.9
MT0925540000000,9,25540,"Hartford-West Hartford-East Hartford, CT MSA",2021,2,580787,538425,42362,7.3
MT0935300000000,9,35300,"New Haven, CT MSA",2021,2,293039,271460,21579,7.4
MT0935980000000,9,35980,"Norwich-New London-Willimantic, CT MSA",2021,2,133104,122152,10952,8.2
MT0947930000000,9,47930,"Waterbury-Shelton, CT MSA",2021,2,227122,209318,17804,7.8
MT1020100000000,10,20100,"Dover, DE MSA",2021,2,84337,79005,5332,6.3
MT1147900000000,11,47900,"Washington-Arlington-Alexandria, DC-VA-MD-WV MSA",2021,2,3360333,3180926,179407,5.3
MT1215980000000,12,15980,"Cape Coral-Fort Myers, FL MSA",2021,2,340766,323444,17322,5.1
MT1218880000000,12,18880,"Crestview-Fort Walton Beach-Destin, FL MSA",2021,2,133357,128108,5249,3.9
MT1219660000000,12,19660,"Deltona-Daytona Beach-Ormond Beach, FL MSA",2021,2,293219,276985,16234,5.5
MT1223540000000,12,23540,"Gainesville, FL MSA",2021,2,160950,153559,7391,4.6
MT1226140000000,12,26140,"Homosassa Springs, FL MSA",2021,2,50284,47165,3119,6.2
MT1227260000000,12,27260,"Jacksonville, FL MSA",2021,2,791011,753193,37818,4.8
MT1229460000000,12,29460,"Lakeland-Winter Haven, FL MSA",2021,2,331713,311152,20561,6.2
MT1233100000000,12,33100,"Miami-Fort Lauderdale-West Palm Beach, FL MSA",2021,2,3017052,2822712,194340,6.4
MT1234940000000,12,34940,"Naples-Marco Island, FL MSA",2021,2,163574,155752,7822,4.8
MT1235840000000,12,35840,"North Port-Bradenton-Sarasota, FL MSA",2021,2,354982,338187,16795,4.7
MT1236100000000,12,36100,"Ocala, FL MSA",2021,2,145851,137770,8081,5.5
MT1236740000000,12,36740,"Orlando-Kissimmee-Sanford, FL MSA",2021,2,1329026,1248257,80769,6.1
MT1237340000000,12,37340,"Palm Bay-Melbourne-Titusville, FL MSA",2021,2,286032,272190,13842,4.8
MT1237460000000,12,37460,"Panama City-Panama City Beach, FL MSA",2021,2,94966,90533,4433,4.7
MT1237860000000,12,37860,"Pensacola-Ferry Pass-Brent, FL MSA",2021,2,228466,217339,11127,4.9
MT1238940000000,12,38940,"Port St. Lucie, FL MSA",2021,2,219448,207927,11521,5.2
MT1239460000000,12,39460,"Punta Gorda, FL MSA",2021,2,68036,64397,3639,5.3
MT1242680000000,12,42680,"Sebastian-Vero Beach-West Vero Corridor, FL MSA",2021,2,62038,58447,3591,5.8
MT1242700000000,12,42700,"Sebring, FL MSA",2021,2,33922,31602,2320,6.8
MT1245220000000,12,45220,"Tallahassee, FL MSA",2021,2,192451,182852,9599,5
MT1245300000000,12,45300,"Tampa-St. Petersburg-Clearwater, FL MSA",2021,2,1556330,1478641,77689,5
MT1248680000000,12,48680,"Wildwood-The Villages, FL MSA",2021,2,28980,26890,2090,7.2
MT1310500000000,13,10500,"Albany, GA MSA",2021,2,64643,60490,4153,6.4
MT1312020000000,13,12020,"Athens-Clarke County, GA MSA",2021,2,103063,99154,3909,3.8
MT1312060000000,13,12060,"Atlanta-Sandy Springs-Roswell, GA MSA",2021,2,3116551,2968131,148420,4.8
MT1312260000000,13,12260,"Augusta-Richmond County, GA-SC MSA",2021,2,265920,253838,12082,4.5
MT1315260000000,13,15260,"Brunswick-St. Simons, GA MSA",2021,2,51382,49109,2273,4.4
MT1317980000000,13,17980,"Columbus, GA-AL MSA",2021,2,132382,125717,6665,5
MT1319140000000,13,19140,"Dalton, GA MSA",2021,2,66362,63638,2724,4.1
MT1323580000000,13,23580,"Gainesville, GA MSA",2021,2,100565,97305,3260,3.2
MT1325980000000,13,25980,"Hinesville, GA MSA",2021,2,30949,29423,1526,4.9
MT1331420000000,13,31420,"Macon-Bibb County, GA MSA",2021,2,100430,94772,5658,5.6
MT1340660000000,13,40660,"Rome, GA MSA",2021,2,43633,41713,1920,4.4
MT1342340000000,13,42340,"Savannah, GA MSA",2021,2,199014,189566,9448,4.7
MT1346660000000,13,46660,"Valdosta, GA MSA",2021,2,62822,59740,3082,4.9
MT1347580000000,13,47580,"Warner Robins, GA MSA",2021,2,89363,85542,3821,4.3
MT1527980000000,15,27980,"Kahului-Wailuku, HI MSA",2021,2,83530,73064,10466,12.5
MT1546520000000,15,46520,"Urban Honolulu, HI MSA",2021,2,467569,430801,36768,7.9
MT1614260000000,16,14260,"Boise City, ID MSA",2021,2,403440,387339,16101,4
MT1617660000000,16,17660,"Coeur d'Alene, ID MSA",2021,2,83955,79838,4117,4.9
MT1626820000000,16,26820,"Idaho Falls, ID MSA",2021,2,76608,74086,2522,3.3
MT1630300000000,16,30300,"Lewiston, ID-WA MSA",2021,2,29955,28773,1182,3.9
MT1638540000000,16,38540,"Pocatello, ID MSA",2021,2,37961,36251,1710,4.5
MT1646300000000,16,46300,"Twin Falls, ID MSA",2021,2,57483,55283,2200,3.8
MT1714010000000,17,14010,"Bloomington, IL MSA",2021,2,86962,82566,4396,5.1
MT1716580000000,17,16580,"Champaign-Urbana, IL MSA",2021,2,121676,115024,6652,5.5
MT1716980000000,17,16980,"Chicago-Naperville-Elgin, IL-IN MSA",2021,2,4684674,4340913,343761,7.3
MT1719340000000,17,19340,"Davenport-Moline-Rock Island, IA-IL MSA",2021,2,187532,176445,11087,5.9
MT1719500000000,17,19500,"Decatur, IL MSA",2021,2,46246,42211,4035,8.7
MT1728100000000,17,28100,"Kankakee, IL MSA",2021,2,51836,48126,3710,7.2
MT1737900000000,17,37900,"Peoria, IL MSA",2021,2,173901,162425,11476,6.6
MT1740420000000,17,40420,"Rockford, IL MSA",2021,2,162940,148187,14753,9.1
MT1744100000000,17,44100,"Springfield, IL MSA",2021,2,100979,94480,6499,6.4
MT1814020000000,18,14020,"Bloomington, IN MSA",2021,2,80282,77270,3012,3.8
MT1818020000000,18,18020,"Columbus, IN MSA",2021,2,38958,37358,1600,4.1
MT1821140000000,18,21140,"Elkhart-Goshen, IN MSA",2021,2,104849,100889,3960,3.8
MT1821780000000,18,21780,"Evansville, IN MSA",2021,2,134608,128923,5685,4.2
MT1823060000000,18,23060,"Fort Wayne, IN MSA",2021,2,224582,214834,9748,4.3
MT1826900000000,18,26900,"Indianapolis-Carmel-Greenwood, IN MSA",2021,2,1078030,1028480,49550,4.6
MT1829020000000,18,29020,"Kokomo, IN MSA",2021,2,37307,35350,1957,5.2
MT1829200000000,18,29200,"Lafayette-West Lafayette, IN MSA",2021,2,111960,107404,4556,4.1
MT1833140000000,18,33140,"Michigan City-La Porte, IN MSA",2021,2,50468,47399,3069,6.1
MT1834620000000,18,34620,"Muncie, IN MSA",2021,2,52345,49818,2527,4.8
MT1843780000000,18,43780,"South Bend-Mishawaka, IN-MI MSA",2021,2,154514,145902,8612,5.6
MT1845460000000,18,45460,"Terre Haute, IN MSA",2021,2,76903,73221,3682,4.8
MT1911180000000,19,11180,"Ames, IA MSA",2021,2,66556,64351,2205,3.3
MT1916300000000,19,16300,"Cedar Rapids, IA MSA",2021,2,146619,139516,7103,4.8
MT1919780000000,19,19780,"Des Moines-West Des Moines, IA MSA",2021,2,381684,365205,16479,4.3
MT1920220000000,19,20220,"Dubuque, IA MSA",2021,2,52480,50025,2455,4.7
MT1926980000000,19,26980,"Iowa City, IA MSA",2021,2,95219,91520,3699,3.9
MT1943580000000,19,43580,"Sioux City, IA-NE-SD MSA",2021,2,74514,71398,3116,4.2
MT1947940000000,19,47940,"Waterloo-Cedar Falls, IA MSA",2021,2,87773,83976,3797,4.3
MT2029940000000,20,29940,"Lawrence, KS MSA",2021,2,66817,64350,2467,3.7
MT2031740000000,20,31740,"Manhattan, KS MSA",2021,2,61272,59208,2064,3.4
MT2045820000000,20,45820,"Topeka, KS MSA",2021,2,116314,111962,4352,3.7
MT2048620000000,20,48620,"Wichita, KS MSA",2021,2,324668,307239,17429,5.4
MT2114540000000,21,14540,"Bowling Green, KY MSA",2021,2,86181,82636,3545,4.1
MT2121060000000,21,21060,"Elizabethtown, KY MSA",2021,2,53114,50728,2386,4.5
MT2130460000000,21,30460,"Lexington-Fayette, KY MSA",2021,2,259992,249315,10677,4.1
MT2131140000000,21,31140,"Louisville/Jefferson County, KY-IN MSA",2021,2,674931,644397,30534,4.5
MT2136980000000,21,36980,"Owensboro, KY MSA",2021,2,50609,48449,2160,4.3
MT2137140000000,21,37140,"Paducah, KY-IL MSA",2021,2,44303,41990,2313,5.2
MT2210780000000,22,10780,"Alexandria, LA MSA",2021,2,65190,61937,3253,5
MT2212940000000,22,12940,"Baton Rouge, LA MSA",2021,2,414136,388246,25890,6.3
MT2225220000000,22,25220,"Hammond, LA MSA",2021,2,58662,54333,4329,7.4
MT2226380000000,22,26380,"Houma-Bayou Cane-Thibodaux, LA MSA",2021,2,88388,83075,5313,6
MT2229180000000,22,29180,"Lafayette, LA MSA",2021,2,191265,180231,11034,5.8
MT2229340000000,22,29340,"Lake Charles, LA MSA",2021,2,101781,93904,7877,7.7
MT2233740000000,22,33740,"Monroe, LA MSA",2021,2,95435,89106,6329,6.6
MT2235380000000,22,35380,"New Orleans-Metairie, LA MSA",2021,2,464909,428457,36452,7.8
MT2243340000000,22,43340,"Shreveport-Bossier City, LA MSA",2021,2,166205,155095,11110,6.7
MT2243640000000,22,43640,"Slidell-Mandeville-Covington, LA MSA",2021,2,122238,116641,5597,4.6
MT2312620000000,23,12620,"Bangor, ME MSA",2021,2,72803,69275,3528,4.8
MT2330340000000,23,30340,"Lewiston-Auburn, ME MSA",2021,2,55312,52629,2683,4.9
MT2338860000000,23,38860,"Portland-South Portland, ME MSA",2021,2,300408,286690,13718,4.6
MT2412580000000,24,12580,"Baltimore-Columbia-Towson, MD MSA",2021,2,1452554,1364471,88083,6.1
MT2425180000000,24,25180,"Hagerstown-Martinsburg, MD-WV MSA",2021,2,140291,133244,7047,5
MT2430500000000,24,30500,"Lexington Park, MD MSA",2021,2,104825,99909,4916,4.7
MT2441540000000,24,41540,"Salisbury, MD MSA",2021,2,60489,56623,3866,6.4
MT2511200000000,25,11200,"Amherst Town-Northampton, MA MSA",2021,2,81722,76936,4786,5.9
MT2512700000000,25,12700,"Barnstable Town, MA MSA",2021,2,112324,104261,8063,7.2
MT2514460000000,25,14460,"Boston-Cambridge-Newton, MA-NH MSA",2021,2,2699764,2537948,161816,6
MT2538340000000,25,38340,"Pittsfield, MA MSA",2021,2,62891,58299,4592,7.3
MT2544140000000,25,44140,"Springfield, MA MSA",2021,2,226021,207507,18514,8.2
MT2549340000000,25,49340,"Worcester, MA MSA",2021,2,446876,417946,28930,6.5
MT2611460000000,26,11460,"Ann Arbor, MI MSA",2021,2,191554,182519,9035,4.7
MT2612980000000,26,12980,"Battle Creek, MI MSA",2021,2,59098,54955,4143,7
MT2613020000000,26,13020,"Bay City, MI MSA",2021,2,46989,43923,3066,6.5
MT2619820000000,26,19820,"Detroit-Warren-Dearborn, MI MSA",2021,2,2086359,1947167,139192,6.7
MT2622420000000,26,22420,"Flint, MI MSA",2021,2,177796,164506,13290,7.5
MT2624340000000,26,24340,"Grand Rapids-Wyoming-Kentwood, MI MSA",2021,2,581530,551736,29794,5.1
MT2627100000000,26,27100,"Jackson, MI MSA",2021,2,71068,66564,4504,6.3
MT2628020000000,26,28020,"Kalamazoo-Portage, MI MSA",2021,2,130172,123215,6957,5.3
MT2629620000000,26,29620,"Lansing-East Lansing, MI MSA",2021,2,231115,218522,12593,5.4
MT2633220000000,26,33220,"Midland, MI MSA",2021,2,38140,36136,2004,5.3
MT2633780000000,26,33780,"Monroe, MI MSA",2021,2,71560,67132,4428,6.2
MT2634740000000,26,34740,"Muskegon-Norton Shores, MI MSA",2021,2,79247,73227,6020,7.6
MT2635660000000,26,35660,"Niles, MI MSA",2021,2,71482,67083,4399,6.2
MT2640980000000,26,40980,"Saginaw, MI MSA",2021,2,81471,75585,5886,7.2
MT2645900000000,26,45900,"Traverse City, MI MSA",2021,2,74884,70573,4311,5.8
MT2720260000000,27,20260,"Duluth, MN-WI MSA",2021,2,137328,130522,6806,5
MT2731860000000,27,31860,"Mankato, MN MSA",2021,2,58538,56264,2274,3.9
MT2733460000000,27,33460,"Minneapolis-St. Paul-Bloomington, MN-WI MSA",2021,2,2012895,1926619,86276,4.3
MT2740340000000,27,40340,"Rochester, MN MSA",2021,2,124276,119605,4671,3.8
MT2741060000000,27,41060,"St. Cloud, MN MSA",2021,2,108392,103245,5147,4.7
MT2825060000000,28,25060,"Gulfport-Biloxi, MS MSA",2021,2,182399,171241,11158,6.1
MT2825620000000,28,25620,"Hattiesburg, MS MSA",2021,2,68930,64877,4053,5.9
MT2827140000000,28,27140,"Jackson, MS MSA",2021,2,276262,259771,16491,6
MT2916020000000,29,16020,"Cape Girardeau, MO-IL MSA",2021,2,47417,45370,2047,4.3
MT2917860000000,29,17860,"Columbia, MO MSA",2021,2,110503,106645,3858,3.5
MT2927620000000,29,27620,"Jefferson City, MO MSA",2021,2,73228,70563,2665,3.6
MT2927900000000,29,27900,"Joplin, MO-KS MSA",2021,2,93585,89612,3973,4.2
MT2928140000000,29,28140,"Kansas City, MO-KS MSA",2021,2,1150285,1097012,53273,4.6
MT2941140000000,29,41140,"St. Joseph, MO-KS MSA",2021,2,56323,53821,2502,4.4
MT2941180000000,29,41180,"St. Louis, MO-IL MSA",2021,2,1445267,1370941,74326,5.1
MT2944180000000,29,44180,"Springfield, MO MSA",2021,2,230995,221818,9177,4
MT3013740000000,30,13740,"Billings, MT MSA",2021,2,94548,91064,3484,3.7
MT3014580000000,30,14580,"Bozeman, MT MSA",2021,2,69830,67717,2113,3
MT3024500000000,30,24500,"Great Falls, MT MSA",2021,2,38456,36978,1478,3.8
MT3025740000000,30,25740,"Helena, MT MSA",2021,2,44854,43216,1638,3.7
MT3033540000000,30,33540,"Missoula, MT MSA",2021,2,69347,66806,2541,3.7
MT3124260000000,31,24260,"Grand Island, NE MSA",2021,2,40783,39489,1294,3.2
MT3130700000000,31,30700,"Lincoln, NE MSA",2021,2,185928,180121,5807,3.1
MT3136540000000,31,36540,"Omaha, NE-IA MSA",2021,2,508322,491043,17279,3.4
MT3216180000000,32,16180,"Carson City, NV MSA",2021,2,28813,27425,1388,4.8
MT3229820000000,32,29820,"Las Vegas-Henderson-North Las Vegas, NV MSA",2021,2,1086693,979608,107085,9.9
MT3239900000000,32,39900,"Reno, NV MSA",2021,2,287351,273438,13913,4.8
MT3331700000000,33,31700,"Manchester-Nashua, NH MSA",2021,2,237316,227009,10307,4.3
MT3412100000000,34,12100,"Atlantic City-Hammonton, NJ MSA",2021,2,176249,158947,17302,9.8
MT3445940000000,34,45940,"Trenton-Princeton, NJ MSA",2021,2,193309,180506,12803,6.6
MT3447220000000,34,47220,"Vineland, NJ MSA",2021,2,64560,58893,5667,8.8
MT3510740000000,35,10740,"Albuquerque, NM MSA",2021,2,438681,405385,33296,7.6
MT3522140000000,35,22140,"Farmington, NM MSA",2021,2,47709,42914,4795,10.1
MT3529740000000,35,29740,"Las Cruces, NM MSA",2021,2,95155,87717,7438,7.8
MT3542140000000,35,42140,"Santa Fe, NM MSA",2021,2,70805,65379,5426,7.7
MT3610580000000,36,10580,"Albany-Schenectady-Troy, NY MSA",2021,2,450091,426621,23470,5.2
MT3613780000000,36,13780,"Binghamton, NY MSA",2021,2,106851,100635,6216,5.8
MT3615380000000,36,15380,"Buffalo-Cheektowaga, NY MSA",2021,2,555900,519421,36479,6.6
MT3621300000000,36,21300,"Elmira, NY MSA",2021,2,36318,34105,2213,6.1
MT3624020000000,36,24020,"Glens Falls, NY MSA",2021,2,59912,56742,3170,5.3
MT3627060000000,36,27060,"Ithaca, NY MSA",2021,2,49302,47067,2235,4.5
MT3628740000000,36,28740,"Kingston, NY MSA",2021,2,84825,79948,4877,5.7
MT3628880000000,36,28880,"Kiryas Joel-Poughkeepsie-Newburgh, NY MSA",2021,2,325809,307331,18478,5.7
MT3635620000000,36,35620,"New York-Newark-Jersey City, NY-NJ MSA",2021,2,9704964,8846283,858681,8.8
MT3640380000000,36,40380,"Rochester, NY MSA",2021,2,512426,481660,30766,6
MT3645060000000,36,45060,"Syracuse, NY MSA",2021,2,310406,292327,18079,5.8
MT3646540000000,36,46540,"Utica-Rome, NY MSA",2021,2,129516,121611,7905,6.1
MT3648060000000,36,48060,"Watertown-Fort Drum, NY MSA",2021,2,44640,42191,2449,5.5
MT3711700000000,37,11700,"Asheville, NC MSA",2021,2,194081,184113,9968,5.1
MT3715500000000,37,15500,"Burlington, NC MSA",2021,2,79035,74531,4504,5.7
MT3716740000000,37,16740,"Charlotte-Concord-Gastonia, NC-SC MSA",2021,2,1350786,1276856,73930,5.5
MT3720500000000,37,20500,"Durham-Chapel Hill, NC MSA",2021,2,291734,277494,14240,4.9
MT3722180000000,37,22180,"Fayetteville, NC MSA",2021,2,148158,137069,11089,7.5
MT3724140000000,37,24140,"Goldsboro, NC MSA",2021,2,48685,45861,2824,5.8
MT3724660000000,37,24660,"Greensboro-High Point, NC MSA",2021,2,359251,336604,22647,6.3
MT3724780000000,37,24780,"Greenville, NC MSA",2021,2,77281,72314,4967,6.4
MT3725860000000,37,25860,"Hickory-Lenoir-Morganton, NC MSA",2021,2,163893,154763,9130,5.6
MT3727340000000,37,27340,"Jacksonville, NC MSA",2021,2,67947,64198,3749,5.5
MT3738240000000,37,38240,"Pinehurst-Southern Pines, NC MSA",2021,2,40527,38439,2088,5.2
MT3739580000000,37,39580,"Raleigh-Cary, NC MSA",2021,2,736079,701249,34830,4.7
MT3740580000000,37,40580,"Rocky Mount, NC MSA",2021,2,62706,57876,4830,7.7
MT3748900000000,37,48900,"Wilmington, NC MSA",2021,2,197381,186443,10938,5.5
MT3749180000000,37,49180,"Winston-Salem, NC MSA",2021,2,310339,292739,17600,5.7
MT3813900000000,38,13900,"Bismarck, ND MSA",2021,2,71879,69508,2371,3.3
MT3822020000000,38,22020,"Fargo, ND-MN MSA",2021,2,145338,140874,4464,3.1
MT3824220000000,38,24220,"Grand Forks, ND-MN MSA",2021,2,54168,52171,1997,3.7
MT3833500000000,38,33500,"Minot, ND MSA",2021,2,38771,37110,1661,4.3
MT3910420000000,39,10420,"Akron, OH MSA",2021,2,353285,331285,22000,6.2
MT3915940000000,39,15940,"Canton-Massillon, OH MSA",2021,2,192279,180161,12118,6.3
MT3917140000000,39,17140,"Cincinnati, OH-KY-IN MSA",2021,2,1128238,1069795,58443,5.2
MT3917410000000,39,17410,"Cleveland, OH MSA",2021,2,1053342,984392,68950,6.5
MT3918140000000,39,18140,"Columbus, OH MSA",2021,2,1112464,1048057,64407,5.8
MT3919430000000,39,19430,"Dayton-Kettering-Beavercreek, OH MSA",2021,2,384944,361167,23777,6.2
MT3930620000000,39,30620,"Lima, OH MSA",2021,2,48117,45420,2697,5.6
MT3931900000000,39,31900,"Mansfield, OH MSA",2021,2,53018,49705,3313,6.2
MT3941780000000,39,41780,"Sandusky, OH MSA",2021,2,56013,52514,3499,6.2
MT3944220000000,39,44220,"Springfield, OH MSA",2021,2,61185,57376,3809,6.2
MT3945780000000,39,45780,"Toledo, OH MSA",2021,2,292917,273190,19727,6.7
MT3948260000000,39,48260,"Weirton-Steubenville, WV-OH MSA",2021,2,52885,49253,3632,6.9
MT3949660000000,39,49660,"Youngstown-Warren, OH MSA",2021,2,188785,174593,14192,7.5
MT4021420000000,40,21420,"Enid, OK MSA",2021,2,28489,27249,1240,4.4
MT4030020000000,40,30020,"Lawton, OK MSA",2021,2,50901,48679,2222,4.4
MT4036420000000,40,36420,"Oklahoma City, OK MSA",2021,2,706833,674128,32705,4.6
MT4046140000000,40,46140,"Tulsa, OK MSA",2021,2,489224,464788,24436,5
MT4110540000000,41,10540,"Albany, OR MSA",2021,2,60264,56306,3958,6.6
MT4113460000000,41,13460,"Bend, OR MSA",2021,2,125621,117211,8410,6.7
MT4118700000000,41,18700,"Corvallis, OR MSA",2021,2,46407,44113,2294,4.9
MT4121660000000,41,21660,"Eugene-Springfield, OR MSA",2021,2,184087,172279,11808,6.4
MT4124420000000,41,24420,"Grants Pass, OR MSA",2021,2,35768,33180,2588,7.2
MT4132780000000,41,32780,"Medford, OR MSA",2021,2,106145,99276,6869,6.5
MT4138900000000,41,38900,"Portland-Vancouver-Hillsboro, OR-WA MSA",2021,2,1345249,1262652,82597,6.1
MT4141420000000,41,41420,"Salem, OR MSA",2021,2,211093,198620,12473,5.9
MT4210900000000,42,10900,"Allentown-Bethlehem-Easton, PA-NJ MSA",2021,2,440722,410184,30538,6.9
MT4211020000000,42,11020,"Altoona, PA MSA",2021,2,58056,54238,3818,6.6
MT4216540000000,42,16540,"Chambersburg, PA MSA",2021,2,77015,72703,4312,5.6
MT4221500000000,42,21500,"Erie, PA MSA",2021,2,127345,117222,10123,7.9
MT4223900000000,42,23900,"Gettysburg, PA MSA",2021,2,52025,49363,2662,5.1
MT4225420000000,42,25420,"Harrisburg-Carlisle, PA MSA",2021,2,304301,286307,17994,5.9
MT4227780000000,42,27780,"Johnstown, PA MSA",2021,2,57455,53362,4093,7.1
MT4229540000000,42,29540,"Lancaster, PA MSA",2021,2,286017,270750,15267,5.3
MT4230140000000,42,30140,"Lebanon, PA MSA",2021,2,71142,66771,4371,6.1
MT4237980000000,42,37980,"Philadelphia-Camden-Wilmington, PA-NJ-DE-MD MSA",2021,2,3174276,2953129,221147,7
MT4238300000000,42,38300,"Pittsburgh, PA MSA",2021,2,1230016,1144270,85746,7
MT4239740000000,42,39740,"Reading, PA MSA",2021,2,215099,199949,15150,7
MT4242540000000,42,42540,"Scranton--Wilkes-Barre, PA MSA",2021,2,274574,251910,22664,8.3
MT4244300000000,42,44300,"State College, PA MSA",2021,2,73439,69783,3656,5
MT4248700000000,42,48700,"Williamsport, PA MSA",2021,2,53331,49402,3929,7.4
MT4249620000000,42,49620,"York-Hanover, PA MSA",2021,2,234458,220457,14001,6
MT4439300000000,44,39300,"Providence-Warwick, RI-MA MSA",2021,2,866240,808195,58045,6.7
MT4516700000000,45,16700,"Charleston-North Charleston, SC MSA",2021,2,393928,377331,16597,4.2
MT4517900000000,45,17900,"Columbia, SC MSA",2021,2,394782,377576,17206,4.4
MT4522500000000,45,22500,"Florence, SC MSA",2021,2,88702,84145,4557,5.1
MT4524860000000,45,24860,"Greenville-Anderson-Greer, SC MSA",2021,2,442446,424867,17579,4
MT4525940000000,45,25940,"Hilton Head Island-Bluffton-Port Royal, SC MSA",2021,2,91153,87753,3400,3.7
MT4534820000000,45,34820,"Myrtle Beach-Conway-North Myrtle Beach, SC MSA",2021,2,152472,144321,8151,5.3
MT4543900000000,45,43900,"Spartanburg, SC MSA",2021,2,167643,159770,7873,4.7
MT4544940000000,45,44940,"Sumter, SC MSA",2021,2,42771,40517,2254,5.3
MT4639660000000,46,39660,"Rapid City, SD MSA",2021,2,75642,73397,2245,3
MT4643620000000,46,43620,"Sioux Falls, SD-MN MSA",2021,2,163461,159165,4296,2.6
MT4716860000000,47,16860,"Chattanooga, TN-GA MSA",2021,2,271827,259767,12060,4.4
MT4717300000000,47,17300,"Clarksville, TN-KY MSA",2021,2,132191,125373,6818,5.2
MT4717420000000,47,17420,"Cleveland, TN MSA",2021,2,57957,55075,2882,5
MT4727180000000,47,27180,"Jackson, TN MSA",2021,2,79772,75296,4476,5.6
MT4727740000000,47,27740,"Johnson City, TN MSA",2021,2,95953,91623,4330,4.5
MT4728700000000,47,28700,"Kingsport-Bristol, TN-VA MSA",2021,2,129458,122825,6633,5.1
MT4728940000000,47,28940,"Knoxville, TN MSA",2021,2,429685,410920,18765,4.4
MT4732820000000,47,32820,"Memphis, TN-MS-AR MSA",2021,2,646226,599223,47003,7.3
MT4734100000000,47,34100,"Morristown, TN MSA",2021,2,52427,49956,2471,4.7
MT4734980000000,47,34980,"Nashville-Davidson--Murfreesboro--Franklin, TN MSA",2021,2,1082250,1032577,49673,4.6
MT4810180000000,48,10180,"Abilene, TX MSA",2021,2,80410,76286,4124,5.1
MT4811100000000,48,11100,"Amarillo, TX MSA",2021,2,130543,124559,5984,4.6
MT4812420000000,48,12420,"Austin-Round Rock-San Marcos, TX MSA",2021,2,1273415,1210464,62951,4.9
MT4813140000000,48,13140,"Beaumont-Port Arthur, TX MSA",2021,2,172087,154770,17317,10.1
MT4815180000000,48,15180,"Brownsville-Harlingen, TX MSA",2021,2,179199,163048,16151,9
MT4817780000000,48,17780,"College Station-Bryan, TX MSA",2021,2,133087,126247,6840,5.1
MT4818580000000,48,18580,"Corpus Christi, TX MSA",2021,2,200718,184068,16650,8.3
MT4819100000000,48,19100,"Dallas-Fort Worth-Arlington, TX MSA",2021,2,4029534,3788532,241002,6
MT4820580000000,48,20580,"Eagle Pass, TX MSA",2021,2,23781,20239,3542,14.9
MT4821340000000,48,21340,"El Paso, TX MSA",2021,2,382301,355123,27178,7.1
MT4826420000000,48,26420,"Houston-Pasadena-The Woodlands, TX MSA",2021,2,3486667,3229147,257520,7.4
MT4828660000000,48,28660,"Killeen-Temple, TX MSA",2021,2,191118,179449,11669,6.1
MT4829700000000,48,29700,"Laredo, TX MSA",2021,2,110147,101659,8488,7.7
MT4830980000000,48,30980,"Longview, TX MSA",2021,2,124840,115525,9315,7.5
MT4831180000000,48,31180,"Lubbock, TX MSA",2021,2,173473,163885,9588,5.5
MT4832580000000,48,32580,"McAllen-Edinburg-Mission, TX MSA",2021,2,370611,332170,38441,10.4
MT4833260000000,48,33260,"Midland, TX MSA",2021,2,87207,80066,7141,8.2
MT4836220000000,48,36220,"Odessa, TX MSA",2021,2,77577,69119,8458,10.9
MT4841660000000,48,41660,"San Angelo, TX MSA",2021,2,57559,54442,3117,5.4
MT4841700000000,48,41700,"San Antonio-New Braunfels, TX MSA",2021,2,1209205,1135919,73286,6.1
MT4843300000000,48,43300,"Sherman-Denison, TX MSA",2021,2,65307,61906,3401,5.2
MT4845500000000,48,45500,"Texarkana, TX-AR MSA",2021,2,60755,56881,3874,6.4
MT4846340000000,48,46340,"Tyler, TX MSA",2021,2,109572,102958,6614,6
MT4847020000000,48,47020,"Victoria, TX MSA",2021,2,44566,41274,3292,7.4
MT4847380000000,48,47380,"Waco, TX MSA",2021,2,136469,128693,7776,5.7
MT4848660000000,48,48660,"Wichita Falls, TX MSA",2021,2,65676,61738,3938,6
MT4930860000000,49,30860,"Logan, UT-ID MSA",2021,2,75393,73584,1809,2.4
MT4936260000000,49,36260,"Ogden, UT MSA",2021,2,324529,314480,10049,3.1
MT4939340000000,49,39340,"Provo-Orem-Lehi, UT MSA",2021,2,334933,325380,9553,2.9
MT4941100000000,49,41100,"St. George, UT MSA",2021,2,81810,78838,2972,3.6
MT4941620000000,49,41620,"Salt Lake City-Murray, UT MSA",2021,2,678433,655107,23326,3.4
MT5015540000000,50,15540,"Burlington-South Burlington, VT MSA",2021,2,123520,118615,4905,4
MT5113980000000,51,13980,"Blacksburg-Christiansburg-Radford, VA MSA",2021,2,85858,82469,3389,3.9
MT5116820000000,51,16820,"Charlottesville, VA MSA",2021,2,109596,105221,4375,4
MT5125500000000,51,25500,"Harrisonburg, VA MSA",2021,2,67790,65290,2500,3.7
MT5131340000000,51,31340,"Lynchburg, VA MSA",2021,2,124076,118513,5563,4.5
MT5140060000000,51,40060,"Richmond, VA MSA",2021,2,671021,639035,31986,4.8
MT5140220000000,51,40220,"Roanoke, VA MSA",2021,2,150085,143450,6635,4.4
MT5144420000000,51,44420,"Staunton-Stuarts Draft, VA MSA",2021,2,60747,58442,2305,3.8
MT5147260000000,51,47260,"Virginia Beach-Chesapeake-Norfolk, VA-NC MSA",2021,2,840287,796082,44205,5.3
MT5149020000000,51,49020,"Winchester, VA-WV MSA",2021,2,71373,68754,2619,3.7
MT5313380000000,53,13380,"Bellingham, WA MSA",2021,2,112421,104997,7424,6.6
MT5314740000000,53,14740,"Bremerton-Silverdale-Port Orchard, WA MSA",2021,2,121602,114373,7229,5.9
MT5328420000000,53,28420,"Kennewick-Richland, WA MSA",2021,2,142999,133990,9009,6.3
MT5331020000000,53,31020,"Longview-Kelso, WA MSA",2021,2,47709,44391,3318,7
MT5334580000000,53,34580,"Mount Vernon-Anacortes, WA MSA",2021,2,58723,54518,4205,7.2
MT5336500000000,53,36500,"Olympia-Lacey-Tumwater, WA MSA",2021,2,137783,129498,8285,6
MT5342660000000,53,42660,"Seattle-Tacoma-Bellevue, WA MSA",2021,2,2146344,2017916,128428,6
MT5344060000000,53,44060,"Spokane-Spokane Valley, WA MSA",2021,2,277061,260404,16657,6
MT5347460000000,53,47460,"Walla Walla, WA MSA",2021,2,29742,28128,1614,5.4
MT5348300000000,53,48300,"Wenatchee-East Wenatchee, WA MSA",2021,2,62658,58800,3858,6.2
MT5349420000000,53,49420,"Yakima, WA MSA",2021,2,128416,119115,9301,7.2
MT5413220000000,54,13220,"Beckley, WV MSA",2021,2,45156,42106,3050,6.8
MT5416620000000,54,16620,"Charleston, WV MSA",2021,2,90330,84382,5948,6.6
MT5426580000000,54,26580,"Huntington-Ashland, WV-KY-OH MSA",2021,2,152181,143256,8925,5.9
MT5434060000000,54,34060,"Morgantown, WV MSA",2021,2,68921,65616,3305,4.8
MT5437620000000,54,37620,"Parkersburg-Vienna, WV MSA",2021,2,38792,36313,2479,6.4
MT5448540000000,54,48540,"Wheeling, WV-OH MSA",2021,2,60334,56220,4114,6.8
MT5511540000000,55,11540,"Appleton, WI MSA",2021,2,134426,129621,4805,3.6
MT5520740000000,55,20740,"Eau Claire, WI MSA",2021,2,92387,88418,3969,4.3
MT5522540000000,55,22540,"Fond du Lac, WI MSA",2021,2,56248,53998,2250,4
MT5524580000000,55,24580,"Green Bay, WI MSA",2021,2,175224,168204,7020,4
MT5527500000000,55,27500,"Janesville-Beloit, WI MSA",2021,2,84210,79928,4282,5.1
MT5528450000000,55,28450,"Kenosha, WI MSA",2021,2,92491,87975,4516,4.9
MT5529100000000,55,29100,"La Crosse-Onalaska, WI-MN MSA",2021,2,88208,84809,3399,3.9
MT5531540000000,55,31540,"Madison, WI MSA",2021,2,389576,375665,13911,3.6
MT5533340000000,55,33340,"Milwaukee-Waukesha, WI MSA",2021,2,811245,768525,42720,5.3
MT5536780000000,55,36780,"Oshkosh-Neenah, WI MSA",2021,2,91775,88261,3514,3.8
MT5539540000000,55,39540,"Racine-Mount Pleasant, WI MSA",2021,2,99946,94476,5470,5.5
MT5543100000000,55,43100,"Sheboygan, WI MSA",2021,2,62613,60310,2303,3.7
MT5548140000000,55,48140,"Wausau, WI MSA",2021,2,74670,72078,2592,3.5
MT5616220000000,56,16220,"Casper, WY MSA",2021,2,41459,38479,2980,7.2
MT5616940000000,56,16940,"Cheyenne, WY MSA",2021,2,48935,46639,2296,4.7
MT7210380000000,72,10380,"Aguadilla, PR MSA",2021,2,78537,71590,6947,8.8
MT7211640000000,72,11640,"Arecibo, PR MSA",2021,2,60918,56352,4566,7.5
MT7225020000000,72,25020,"Guayama, PR MSA",2021,2,18419,16611,1808,9.8
MT7232420000000,72,32420,"Mayaguez, PR MSA",2021,2,61984,56094,5890,9.5
MT7238660000000,72,38660,"Ponce, PR MSA",2021,2,83728,75125,8603,10.3
MT7241980000000,72,41980,"San Juan-Bayamon-Caguas, PR MSA",2021,2,760243,698100,62143,8.2
MT0111500000000,1,11500,"Anniston-Oxford, AL MSA",2021,3,49844,47760,2084,4.2
MT0112220000000,1,12220,"Auburn-Opelika, AL MSA",2021,3,89910,86956,2954,3.3
MT0113820000000,1,13820,"Birmingham, AL MSA",2021,3,551372,531932,19440,3.5
MT0119300000000,1,19300,"Daphne-Fairhope-Foley, AL MSA",2021,3,106476,103212,3264,3.1
MT0119460000000,1,19460,"Decatur, AL MSA",2021,3,71414,69295,2119,3
MT0120020000000,1,20020,"Dothan, AL MSA",2021,3,65561,63247,2314,3.5
MT0122520000000,1,22520,"Florence-Muscle Shoals, AL MSA",2021,3,66591,64155,2436,3.7
MT0123460000000,1,23460,"Gadsden, AL MSA",2021,3,41773,40028,1745,4.2
MT0126620000000,1,26620,"Huntsville, AL MSA",2021,3,247515,240696,6819,2.8
MT0133660000000,1,33660,"Mobile, AL MSA",2021,3,182898,172884,10014,5.5
MT0133860000000,1,33860,"Montgomery, AL MSA",2021,3,172113,164024,8089,4.7
MT0146220000000,1,46220,"Tuscaloosa, AL MSA",2021,3,119630,114574,5056,4.2
MT0211260000000,2,11260,"Anchorage, AK MSA",2021,3,195626,182039,13587,6.9
MT0221820000000,2,21820,"Fairbanks-College, AK MSA",2021,3,44434,41966,2468,5.6
MT0422380000000,4,22380,"Flagstaff, AZ MSA",2021,3,69986,64625,5361,7.7
MT0429420000000,4,29420,"Lake Havasu City-Kingman, AZ MSA",2021,3,84502,78686,5816,6.9
MT0438060000000,4,38060,"Phoenix-Mesa-Chandler, AZ MSA",2021,3,2517442,2374336,143106,5.7
MT0439150000000,4,39150,"Prescott Valley-Prescott, AZ MSA",2021,3,100593,95121,5472,5.4
MT0443420000000,4,43420,"Sierra Vista-Douglas, AZ MSA",2021,3,48164,45420,2744,5.7
MT0446060000000,4,46060,"Tucson, AZ MSA",2021,3,482226,452194,30032,6.2
MT0449740000000,4,49740,"Yuma, AZ MSA",2021,3,93711,81013,12698,13.6
MT0522220000000,5,22220,"Fayetteville-Springdale-Rogers, AR MSA",2021,3,272676,263218,9458,3.5
MT0522900000000,5,22900,"Fort Smith, AR-OK MSA",2021,3,99075,94792,4283,4.3
MT0526300000000,5,26300,"Hot Springs, AR MSA",2021,3,43031,40603,2428,5.6
MT0527860000000,5,27860,"Jonesboro, AR MSA",2021,3,62956,60355,2601,4.1
MT0530780000000,5,30780,"Little Rock-North Little Rock-Conway, AR MSA",2021,3,352173,334973,17200,4.9
MT0612540000000,6,12540,"Bakersfield-Delano, CA MSA",2021,3,385868,344518,41350,10.7
MT0617020000000,6,17020,"Chico, CA MSA",2021,3,89917,82912,7005,7.8
MT0620940000000,6,20940,"El Centro, CA MSA",2021,3,67000,54071,12929,19.3
MT0623420000000,6,23420,"Fresno, CA MSA",2021,3,498347,448915,49432,9.9
MT0625260000000,6,25260,"Hanford-Corcoran, CA MSA",2021,3,53856,48100,5756,10.7
MT0631080000000,6,31080,"Los Angeles-Long Beach-Anaheim, CA MSA",2021,3,6511643,5877806,633837,9.7
MT0632900000000,6,32900,"Merced, CA MSA",2021,3,114166,101693,12473,10.9
MT0633700000000,6,33700,"Modesto, CA MSA",2021,3,242632,220553,22079,9.1
MT0634900000000,6,34900,"Napa, CA MSA",2021,3,68294,63343,4951,7.2
MT0637100000000,6,37100,"Oxnard-Thousand Oaks-Ventura, CA MSA",2021,3,403714,374528,29186,7.2
MT0639820000000,6,39820,"Redding, CA MSA",2021,3,76423,70885,5538,7.2
MT0640140000000,6,40140,"Riverside-San Bernardino-Ontario, CA MSA",2021,3,2096233,1915299,180934,8.6
MT0640900000000,6,40900,"Sacramento-Roseville-Folsom, CA MSA",2021,3,1119385,1038527,80858,7.2
MT0641500000000,6,41500,"Salinas, CA MSA",2021,3,207723,189082,18641,9
MT0641740000000,6,41740,"San Diego-Chula Vista-Carlsbad, CA MSA",2021,3,1552863,1436539,116324,7.5
MT0641860000000,6,41860,"San Francisco-Oakland-Fremont, CA MSA",2021,3,2417517,2256646,160871,6.7
MT0641940000000,6,41940,"San Jose-Sunnyvale-Santa Clara, CA MSA",2021,3,1013690,954436,59254,5.8
MT0642020000000,6,42020,"San Luis Obispo-Paso Robles, CA MSA",2021,3,128781,120404,8377,6.5
MT0642100000000,6,42100,"Santa Cruz-Watsonville, CA MSA",2021,3,132268,122512,9756,7.4
MT0642200000000,6,42200,"Santa Maria-Santa Barbara, CA MSA",2021,3,212956,198523,14433,6.8
MT0642220000000,6,42220,"Santa Rosa-Petaluma, CA MSA",2021,3,239066,223380,15686,6.6
MT0644700000000,6,44700,"Stockton-Lodi, CA MSA",2021,3,347399,315012,32387,9.3
MT0646700000000,6,46700,"Vallejo, CA MSA",2021,3,207330,190277,17053,8.2
MT0647300000000,6,47300,"Visalia, CA MSA",2021,3,200939,178113,22826,11.4
MT0649700000000,6,49700,"Yuba City, CA MSA",2021,3,76198,69060,7138,9.4
MT0814500000000,8,14500,"Boulder, CO MSA",2021,3,186946,176985,9961,5.3
MT0817820000000,8,17820,"Colorado Springs, CO MSA",2021,3,373509,350443,23066,6.2
MT0819740000000,8,19740,"Denver-Aurora-Centennial, CO MSA",2021,3,1696292,1591681,104611,6.2
MT0822660000000,8,22660,"Fort Collins-Loveland, CO MSA",2021,3,197037,185879,11158,5.7
MT0824300000000,8,24300,"Grand Junction, CO MSA",2021,3,78347,73291,5056,6.5
MT0824540000000,8,24540,"Greeley, CO MSA",2021,3,166331,155458,10873,6.5
MT0839380000000,8,39380,"Pueblo, CO MSA",2021,3,75151,68426,6725,8.9
MT0914860000000,9,14860,"Bridgeport-Stamford-Danbury, CT MSA",2021,3,469277,437384,31893,6.8
MT0925540000000,9,25540,"Hartford-West Hartford-East Hartford, CT MSA",2021,3,579809,537585,42224,7.3
MT0935300000000,9,35300,"New Haven, CT MSA",2021,3,292863,271410,21453,7.3
MT0935980000000,9,35980,"Norwich-New London-Willimantic, CT MSA",2021,3,132918,122029,10889,8.2
MT0947930000000,9,47930,"Waterbury-Shelton, CT MSA",2021,3,226912,209087,17825,7.9
MT1020100000000,10,20100,"Dover, DE MSA",2021,3,84750,79309,5441,6.4
MT1147900000000,11,47900,"Washington-Arlington-Alexandria, DC-VA-MD-WV MSA",2021,3,3362125,3187390,174735,5.2
MT1215980000000,12,15980,"Cape Coral-Fort Myers, FL MSA",2021,3,342460,325540,16920,4.9
MT1218880000000,12,18880,"Crestview-Fort Walton Beach-Destin, FL MSA",2021,3,133563,128419,5144,3.9
MT1219660000000,12,19660,"Deltona-Daytona Beach-Ormond Beach, FL MSA",2021,3,294126,278217,15909,5.4
MT1223540000000,12,23540,"Gainesville, FL MSA",2021,3,161365,154154,7211,4.5
MT1226140000000,12,26140,"Homosassa Springs, FL MSA",2021,3,50319,47244,3075,6.1
MT1227260000000,12,27260,"Jacksonville, FL MSA",2021,3,791113,754247,36866,4.7
MT1229460000000,12,29460,"Lakeland-Winter Haven, FL MSA",2021,3,332310,312168,20142,6.1
MT1233100000000,12,33100,"Miami-Fort Lauderdale-West Palm Beach, FL MSA",2021,3,3028980,2842431,186549,6.2
MT1234940000000,12,34940,"Naples-Marco Island, FL MSA",2021,3,164512,156879,7633,4.6
MT1235840000000,12,35840,"North Port-Bradenton-Sarasota, FL MSA",2021,3,356488,340073,16415,4.6
MT1236100000000,12,36100,"Ocala, FL MSA",2021,3,145854,137894,7960,5.5
MT1236740000000,12,36740,"Orlando-Kissimmee-Sanford, FL MSA",2021,3,1333162,1255347,77815,5.8
MT1237340000000,12,37340,"Palm Bay-Melbourne-Titusville, FL MSA",2021,3,286673,273181,13492,4.7
MT1237460000000,12,37460,"Panama City-Panama City Beach, FL MSA",2021,3,95048,90669,4379,4.6
MT1237860000000,12,37860,"Pensacola-Ferry Pass-Brent, FL MSA",2021,3,228635,217759,10876,4.8
MT1238940000000,12,38940,"Port St. Lucie, FL MSA",2021,3,220069,208727,11342,5.2
MT1239460000000,12,39460,"Punta Gorda, FL MSA",2021,3,68109,64540,3569,5.2
MT1242680000000,12,42680,"Sebastian-Vero Beach-West Vero Corridor, FL MSA",2021,3,62120,58592,3528,5.7
MT1242700000000,12,42700,"Sebring, FL MSA",2021,3,33979,31688,2291,6.7
MT1245220000000,12,45220,"Tallahassee, FL MSA",2021,3,192712,183386,9326,4.8
MT1245300000000,12,45300,"Tampa-St. Petersburg-Clearwater, FL MSA",2021,3,1559070,1483065,76005,4.9
MT1248680000000,12,48680,"Wildwood-The Villages, FL MSA",2021,3,29181,27114,2067,7.1
MT1310500000000,13,10500,"Albany, GA MSA",2021,3,64461,60443,4018,6.2
MT1312020000000,13,12020,"Athens-Clarke County, GA MSA",2021,3,102954,99202,3752,3.6
MT1312060000000,13,12060,"Atlanta-Sandy Springs-Roswell, GA MSA",2021,3,3116223,2974289,141934,4.6
MT1312260000000,13,12260,"Augusta-Richmond County, GA-SC MSA",2021,3,265489,253727,11762,4.4
MT1315260000000,13,15260,"Brunswick-St. Simons, GA MSA",2021,3,51388,49188,2200,4.3
MT1317980000000,13,17980,"Columbus, GA-AL MSA",2021,3,131959,125498,6461,4.9
MT1319140000000,13,19140,"Dalton, GA MSA",2021,3,66340,63662,2678,4
MT1323580000000,13,23580,"Gainesville, GA MSA",2021,3,100366,97227,3139,3.1
MT1325980000000,13,25980,"Hinesville, GA MSA",2021,3,30902,29438,1464,4.7
MT1331420000000,13,31420,"Macon-Bibb County, GA MSA",2021,3,100107,94675,5432,5.4
MT1340660000000,13,40660,"Rome, GA MSA",2021,3,43642,41791,1851,4.2
MT1342340000000,13,42340,"Savannah, GA MSA",2021,3,199027,189940,9087,4.6
MT1346660000000,13,46660,"Valdosta, GA MSA",2021,3,62579,59600,2979,4.8
MT1347580000000,13,47580,"Warner Robins, GA MSA",2021,3,89183,85464,3719,4.2
MT1527980000000,15,27980,"Kahului-Wailuku, HI MSA",2021,3,83748,74241,9507,11.4
MT1546520000000,15,46520,"Urban Honolulu, HI MSA",2021,3,468321,433591,34730,7.4
MT1614260000000,16,14260,"Boise City, ID MSA",2021,3,404683,388735,15948,3.9
MT1617660000000,16,17660,"Coeur d'Alene, ID MSA",2021,3,84202,80140,4062,4.8
MT1626820000000,16,26820,"Idaho Falls, ID MSA",2021,3,76784,74268,2516,3.3
MT1630300000000,16,30300,"Lewiston, ID-WA MSA",2021,3,30024,28851,1173,3.9
MT1638540000000,16,38540,"Pocatello, ID MSA",2021,3,37989,36274,1715,4.5
MT1646300000000,16,46300,"Twin Falls, ID MSA",2021,3,57617,55416,2201,3.8
MT1714010000000,17,14010,"Bloomington, IL MSA",2021,3,87071,82747,4324,5
MT1716580000000,17,16580,"Champaign-Urbana, IL MSA",2021,3,121483,114969,6514,5.4
MT1716980000000,17,16980,"Chicago-Naperville-Elgin, IL-IN MSA",2021,3,4696432,4360261,336171,7.2
MT1719340000000,17,19340,"Davenport-Moline-Rock Island, IA-IL MSA",2021,3,187873,176769,11104,5.9
MT1719500000000,17,19500,"Decatur, IL MSA",2021,3,46096,42161,3935,8.5
MT1728100000000,17,28100,"Kankakee, IL MSA",2021,3,51692,48010,3682,7.1
MT1737900000000,17,37900,"Peoria, IL MSA",2021,3,173475,162184,11291,6.5
MT1740420000000,17,40420,"Rockford, IL MSA",2021,3,162812,147762,15050,9.2
MT1744100000000,17,44100,"Springfield, IL MSA",2021,3,100913,94532,6381,6.3
MT1814020000000,18,14020,"Bloomington, IN MSA",2021,3,80372,77477,2895,3.6
MT1818020000000,18,18020,"Columbus, IN MSA",2021,3,38840,37286,1554,4
MT1821140000000,18,21140,"Elkhart-Goshen, IN MSA",2021,3,104880,101077,3803,3.6
MT1821780000000,18,21780,"Evansville, IN MSA",2021,3,134206,128641,5565,4.1
MT1823060000000,18,23060,"Fort Wayne, IN MSA",2021,3,224525,215040,9485,4.2
MT1826900000000,18,26900,"Indianapolis-Carmel-Greenwood, IN MSA",2021,3,1076338,1028506,47832,4.4
MT1829020000000,18,29020,"Kokomo, IN MSA",2021,3,37267,35264,2003,5.4
MT1829200000000,18,29200,"Lafayette-West Lafayette, IN MSA",2021,3,112212,107812,4400,3.9
MT1833140000000,18,33140,"Michigan City-La Porte, IN MSA",2021,3,50416,47432,2984,5.9
MT1834620000000,18,34620,"Muncie, IN MSA",2021,3,52162,49698,2464,4.7
MT1843780000000,18,43780,"South Bend-Mishawaka, IN-MI MSA",2021,3,154166,145808,8358,5.4
MT1845460000000,18,45460,"Terre Haute, IN MSA",2021,3,76889,73276,3613,4.7
MT1911180000000,19,11180,"Ames, IA MSA",2021,3,66918,64677,2241,3.3
MT1916300000000,19,16300,"Cedar Rapids, IA MSA",2021,3,147079,139828,7251,4.9
MT1919780000000,19,19780,"Des Moines-West Des Moines, IA MSA",2021,3,383231,366602,16629,4.3
MT1920220000000,19,20220,"Dubuque, IA MSA",2021,3,52657,50170,2487,4.7
MT1926980000000,19,26980,"Iowa City, IA MSA",2021,3,95712,91942,3770,3.9
MT1943580000000,19,43580,"Sioux City, IA-NE-SD MSA",2021,3,74630,71447,3183,4.3
MT1947940000000,19,47940,"Waterloo-Cedar Falls, IA MSA",2021,3,88081,84242,3839,4.4
MT2029940000000,20,29940,"Lawrence, KS MSA",2021,3,66939,64580,2359,3.5
MT2031740000000,20,31740,"Manhattan, KS MSA",2021,3,61353,59360,1993,3.2
MT2045820000000,20,45820,"Topeka, KS MSA",2021,3,116265,112070,4195,3.6
MT2048620000000,20,48620,"Wichita, KS MSA",2021,3,324547,307870,16677,5.1
MT2114540000000,21,14540,"Bowling Green, KY MSA",2021,3,86134,82608,3526,4.1
MT2121060000000,21,21060,"Elizabethtown, KY MSA",2021,3,53021,50616,2405,4.5
MT2130460000000,21,30460,"Lexington-Fayette, KY MSA",2021,3,260192,249686,10506,4
MT2131140000000,21,31140,"Louisville/Jefferson County, KY-IN MSA",2021,3,674960,644944,30016,4.4
MT2136980000000,21,36980,"Owensboro, KY MSA",2021,3,50613,48467,2146,4.2
MT2137140000000,21,37140,"Paducah, KY-IL MSA",2021,3,44472,42179,2293,5.2
MT2210780000000,22,10780,"Alexandria, LA MSA",2021,3,65070,61934,3136,4.8
MT2212940000000,22,12940,"Baton Rouge, LA MSA",2021,3,413924,388410,25514,6.2
MT2225220000000,22,25220,"Hammond, LA MSA",2021,3,58648,54409,4239,7.2
MT2226380000000,22,26380,"Houma-Bayou Cane-Thibodaux, LA MSA",2021,3,88307,83155,5152,5.8
MT2229180000000,22,29180,"Lafayette, LA MSA",2021,3,191565,180802,10763,5.6
MT2229340000000,22,29340,"Lake Charles, LA MSA",2021,3,102075,94489,7586,7.4
MT2233740000000,22,33740,"Monroe, LA MSA",2021,3,95412,89204,6208,6.5
MT2235380000000,22,35380,"New Orleans-Metairie, LA MSA",2021,3,465756,429808,35948,7.7
MT2243340000000,22,43340,"Shreveport-Bossier City, LA MSA",2021,3,166057,155200,10857,6.5
MT2243640000000,22,43640,"Slidell-Mandeville-Covington, LA MSA",2021,3,122492,117006,5486,4.5
MT2312620000000,23,12620,"Bangor, ME MSA",2021,3,73088,69324,3764,5.1
MT2330340000000,23,30340,"Lewiston-Auburn, ME MSA",2021,3,55433,52587,2846,5.1
MT2338860000000,23,38860,"Portland-South Portland, ME MSA",2021,3,301492,287434,14058,4.7
MT2412580000000,24,12580,"Baltimore-Columbia-Towson, MD MSA",2021,3,1450746,1364983,85763,5.9
MT2425180000000,24,25180,"Hagerstown-Martinsburg, MD-WV MSA",2021,3,140448,133522,6926,4.9
MT2430500000000,24,30500,"Lexington Park, MD MSA",2021,3,104812,99973,4839,4.6
MT2441540000000,24,41540,"Salisbury, MD MSA",2021,3,60594,56763,3831,6.3
MT2511200000000,25,11200,"Amherst Town-Northampton, MA MSA",2021,3,81859,77320,4539,5.5
MT2512700000000,25,12700,"Barnstable Town, MA MSA",2021,3,112469,104607,7862,7
MT2514460000000,25,14460,"Boston-Cambridge-Newton, MA-NH MSA",2021,3,2696502,2542979,153523,5.7
MT2538340000000,25,38340,"Pittsfield, MA MSA",2021,3,62885,58450,4435,7.1
MT2544140000000,25,44140,"Springfield, MA MSA",2021,3,225787,207940,17847,7.9
MT2549340000000,25,49340,"Worcester, MA MSA",2021,3,446407,418767,27640,6.2
MT2611460000000,26,11460,"Ann Arbor, MI MSA",2021,3,191047,182163,8884,4.7
MT2612980000000,26,12980,"Battle Creek, MI MSA",2021,3,58850,54734,4116,7
MT2613020000000,26,13020,"Bay City, MI MSA",2021,3,46937,43907,3030,6.5
MT2619820000000,26,19820,"Detroit-Warren-Dearborn, MI MSA",2021,3,2090826,1952278,138548,6.6
MT2622420000000,26,22420,"Flint, MI MSA",2021,3,177230,163902,13328,7.5
MT2624340000000,26,24340,"Grand Rapids-Wyoming-Kentwood, MI MSA",2021,3,579687,550121,29566,5.1
MT2627100000000,26,27100,"Jackson, MI MSA",2021,3,70823,66359,4464,6.3
MT2628020000000,26,28020,"Kalamazoo-Portage, MI MSA",2021,3,129771,122880,6891,5.3
MT2629620000000,26,29620,"Lansing-East Lansing, MI MSA",2021,3,230393,217813,12580,5.5
MT2633220000000,26,33220,"Midland, MI MSA",2021,3,38083,36109,1974,5.2
MT2633780000000,26,33780,"Monroe, MI MSA",2021,3,71479,66910,4569,6.4
MT2634740000000,26,34740,"Muskegon-Norton Shores, MI MSA",2021,3,79091,73096,5995,7.6
MT2635660000000,26,35660,"Niles, MI MSA",2021,3,71311,66976,4335,6.1
MT2640980000000,26,40980,"Saginaw, MI MSA",2021,3,81391,75513,5878,7.2
MT2645900000000,26,45900,"Traverse City, MI MSA",2021,3,74909,70724,4185,5.6
MT2720260000000,27,20260,"Duluth, MN-WI MSA",2021,3,137166,130687,6479,4.7
MT2731860000000,27,31860,"Mankato, MN MSA",2021,3,58256,56069,2187,3.8
MT2733460000000,27,33460,"Minneapolis-St. Paul-Bloomington, MN-WI MSA",2021,3,2011461,1928317,83144,4.1
MT2740340000000,27,40340,"Rochester, MN MSA",2021,3,124076,119632,4444,3.6
MT2741060000000,27,41060,"St. Cloud, MN MSA",2021,3,108154,103179,4975,4.6
MT2825060000000,28,25060,"Gulfport-Biloxi, MS MSA",2021,3,182419,171383,11036,6
MT2825620000000,28,25620,"Hattiesburg, MS MSA",2021,3,69065,65056,4009,5.8
MT2827140000000,28,27140,"Jackson, MS MSA",2021,3,275871,259630,16241,5.9
MT2916020000000,29,16020,"Cape Girardeau, MO-IL MSA",2021,3,47436,45443,1993,4.2
MT2917860000000,29,17860,"Columbia, MO MSA",2021,3,110735,107004,3731,3.4
MT2927620000000,29,27620,"Jefferson City, MO MSA",2021,3,73132,70547,2585,3.5
MT2927900000000,29,27900,"Joplin, MO-KS MSA",2021,3,93788,89943,3845,4.1
MT2928140000000,29,28140,"Kansas City, MO-KS MSA",2021,3,1150829,1096904,53925,4.7
MT2941140000000,29,41140,"St. Joseph, MO-KS MSA",2021,3,56152,53719,2433,4.3
MT2941180000000,29,41180,"St. Louis, MO-IL MSA",2021,3,1444295,1371031,73264,5.1
MT2944180000000,29,44180,"Springfield, MO MSA",2021,3,231109,222167,8942,3.9
MT3013740000000,30,13740,"Billings, MT MSA",2021,3,94674,91254,3420,3.6
MT3014580000000,30,14580,"Bozeman, MT MSA",2021,3,70178,68116,2062,2.9
MT3024500000000,30,24500,"Great Falls, MT MSA",2021,3,38430,36985,1445,3.8
MT3025740000000,30,25740,"Helena, MT MSA",2021,3,44847,43247,1600,3.6
MT3033540000000,30,33540,"Missoula, MT MSA",2021,3,69584,67080,2504,3.6
MT3124260000000,31,24260,"Grand Island, NE MSA",2021,3,40753,39477,1276,3.1
MT3130700000000,31,30700,"Lincoln, NE MSA",2021,3,185985,180333,5652,3
MT3136540000000,31,36540,"Omaha, NE-IA MSA",2021,3,508779,491477,17302,3.4
MT3216180000000,32,16180,"Carson City, NV MSA",2021,3,28678,27330,1348,4.7
MT3229820000000,32,29820,"Las Vegas-Henderson-North Las Vegas, NV MSA",2021,3,1086036,984357,101679,9.4
MT3239900000000,32,39900,"Reno, NV MSA",2021,3,286644,273129,13515,4.7
MT3331700000000,33,31700,"Manchester-Nashua, NH MSA",2021,3,236645,226731,9914,4.2
MT3412100000000,34,12100,"Atlantic City-Hammonton, NJ MSA",2021,3,177025,159333,17692,10
MT3445940000000,34,45940,"Trenton-Princeton, NJ MSA",2021,3,193150,180414,12736,6.6
MT3447220000000,34,47220,"Vineland, NJ MSA",2021,3,64733,58957,5776,8.9
MT3510740000000,35,10740,"Albuquerque, NM MSA",2021,3,439362,406572,32790,7.5
MT3522140000000,35,22140,"Farmington, NM MSA",2021,3,47672,42960,4712,9.9
MT3529740000000,35,29740,"Las Cruces, NM MSA",2021,3,95295,87913,7382,7.7
MT3542140000000,35,42140,"Santa Fe, NM MSA",2021,3,71263,65884,5379,7.5
MT3610580000000,36,10580,"Albany-Schenectady-Troy, NY MSA",2021,3,449615,426348,23267,5.2
MT3613780000000,36,13780,"Binghamton, NY MSA",2021,3,106700,100527,6173,5.8
MT3615380000000,36,15380,"Buffalo-Cheektowaga, NY MSA",2021,3,556504,521148,35356,6.4
MT3621300000000,36,21300,"Elmira, NY MSA",2021,3,36239,34067,2172,6
MT3624020000000,36,24020,"Glens Falls, NY MSA",2021,3,59939,56736,3203,5.3
MT3627060000000,36,27060,"Ithaca, NY MSA",2021,3,49269,47062,2207,4.5
MT3628740000000,36,28740,"Kingston, NY MSA",2021,3,85021,80180,4841,5.7
MT3628880000000,36,28880,"Kiryas Joel-Poughkeepsie-Newburgh, NY MSA",2021,3,325730,307566,18164,5.6
MT3635620000000,36,35620,"New York-Newark-Jersey City, NY-NJ MSA",2021,3,9722944,8870563,852381,8.8
MT3640380000000,36,40380,"Rochester, NY MSA",2021,3,511582,481504,30078,5.9
MT3645060000000,36,45060,"Syracuse, NY MSA",2021,3,310298,292335,17963,5.8
MT3646540000000,36,46540,"Utica-Rome, NY MSA",2021,3,129892,122052,7840,6
MT3648060000000,36,48060,"Watertown-Fort Drum, NY MSA",2021,3,44641,42151,2490,5.6
MT3711700000000,37,11700,"Asheville, NC MSA",2021,3,194172,184396,9776,5
MT3715500000000,37,15500,"Burlington, NC MSA",2021,3,79248,74815,4433,5.6
MT3716740000000,37,16740,"Charlotte-Concord-Gastonia, NC-SC MSA",2021,3,1351079,1278597,72482,5.4
MT3720500000000,37,20500,"Durham-Chapel Hill, NC MSA",2021,3,292571,278617,13954,4.8
MT3722180000000,37,22180,"Fayetteville, NC MSA",2021,3,148208,137219,10989,7.4
MT3724140000000,37,24140,"Goldsboro, NC MSA",2021,3,48637,45852,2785,5.7
MT3724660000000,37,24660,"Greensboro-High Point, NC MSA",2021,3,358392,336222,22170,6.2
MT3724780000000,37,24780,"Greenville, NC MSA",2021,3,77758,72884,4874,6.3
MT3725860000000,37,25860,"Hickory-Lenoir-Morganton, NC MSA",2021,3,163864,154874,8990,5.5
MT3727340000000,37,27340,"Jacksonville, NC MSA",2021,3,67975,64268,3707,5.5
MT3738240000000,37,38240,"Pinehurst-Southern Pines, NC MSA",2021,3,40577,38519,2058,5.1
MT3739580000000,37,39580,"Raleigh-Cary, NC MSA",2021,3,738749,704847,33902,4.6
MT3740580000000,37,40580,"Rocky Mount, NC MSA",2021,3,62798,58010,4788,7.6
MT3748900000000,37,48900,"Wilmington, NC MSA",2021,3,197852,186984,10868,5.5
MT3749180000000,37,49180,"Winston-Salem, NC MSA",2021,3,310276,292976,17300,5.6
MT3813900000000,38,13900,"Bismarck, ND MSA",2021,3,71948,69648,2300,3.2
MT3822020000000,38,22020,"Fargo, ND-MN MSA",2021,3,145412,141089,4323,3
MT3824220000000,38,24220,"Grand Forks, ND-MN MSA",2021,3,54162,52224,1938,3.6
MT3833500000000,38,33500,"Minot, ND MSA",2021,3,38840,37264,1576,4.1
MT3910420000000,39,10420,"Akron, OH MSA",2021,3,353336,331286,22050,6.2
MT3915940000000,39,15940,"Canton-Massillon, OH MSA",2021,3,192360,180102,12258,6.4
MT3917140000000,39,17140,"Cincinnati, OH-KY-IN MSA",2021,3,1127521,1069850,57671,5.1
MT3917410000000,39,17410,"Cleveland, OH MSA",2021,3,1056207,989029,67178,6.4
MT3918140000000,39,18140,"Columbus, OH MSA",2021,3,1111889,1047420,64469,5.8
MT3919430000000,39,19430,"Dayton-Kettering-Beavercreek, OH MSA",2021,3,384115,360302,23813,6.2
MT3930620000000,39,30620,"Lima, OH MSA",2021,3,48096,45344,2752,5.7
MT3931900000000,39,31900,"Mansfield, OH MSA",2021,3,52972,49628,3344,6.3
MT3941780000000,39,41780,"Sandusky, OH MSA",2021,3,56051,52496,3555,6.3
MT3944220000000,39,44220,"Springfield, OH MSA",2021,3,61218,57302,3916,6.4
MT3945780000000,39,45780,"Toledo, OH MSA",2021,3,292441,272471,19970,6.8
MT3948260000000,39,48260,"Weirton-Steubenville, WV-OH MSA",2021,3,52781,49231,3550,6.7
MT3949660000000,39,49660,"Youngstown-Warren, OH MSA",2021,3,188753,174620,14133,7.5
MT4021420000000,40,21420,"Enid, OK MSA",2021,3,28432,27252,1180,4.2
MT4030020000000,40,30020,"Lawton, OK MSA",2021,3,50888,48687,2201,4.3
MT4036420000000,40,36420,"Oklahoma City, OK MSA",2021,3,707805,675484,32321,4.6
MT4046140000000,40,46140,"Tulsa, OK MSA",2021,3,489662,465684,23978,4.9
MT4110540000000,41,10540,"Albany, OR MSA",2021,3,60381,56466,3915,6.5
MT4113460000000,41,13460,"Bend, OR MSA",2021,3,125850,117721,8129,6.5
MT4118700000000,41,18700,"Corvallis, OR MSA",2021,3,46479,44234,2245,4.8
MT4121660000000,41,21660,"Eugene-Springfield, OR MSA",2021,3,184525,172797,11728,6.4
MT4124420000000,41,24420,"Grants Pass, OR MSA",2021,3,35781,33196,2585,7.2
MT4132780000000,41,32780,"Medford, OR MSA",2021,3,106308,99556,6752,6.4
MT4138900000000,41,38900,"Portland-Vancouver-Hillsboro, OR-WA MSA",2021,3,1346375,1266273,80102,5.9
MT4141420000000,41,41420,"Salem, OR MSA",2021,3,211602,199300,12302,5.8
MT4210900000000,42,10900,"Allentown-Bethlehem-Easton, PA-NJ MSA",2021,3,440563,410520,30043,6.8
MT4211020000000,42,11020,"Altoona, PA MSA",2021,3,57867,54152,3715,6.4
MT4216540000000,42,16540,"Chambersburg, PA MSA",2021,3,76641,72425,4216,5.5
MT4221500000000,42,21500,"Erie, PA MSA",2021,3,127119,117268,9851,7.7
MT4223900000000,42,23900,"Gettysburg, PA MSA",2021,3,51854,49313,2541,4.9
MT4225420000000,42,25420,"Harrisburg-Carlisle, PA MSA",2021,3,303268,285799,17469,5.8
MT4227780000000,42,27780,"Johnstown, PA MSA",2021,3,57355,53314,4041,7
MT4229540000000,42,29540,"Lancaster, PA MSA",2021,3,285339,270550,14789,5.2
MT4230140000000,42,30140,"Lebanon, PA MSA",2021,3,70935,66699,4236,6
MT4237980000000,42,37980,"Philadelphia-Camden-Wilmington, PA-NJ-DE-MD MSA",2021,3,3174824,2957139,217685,6.9
MT4238300000000,42,38300,"Pittsburgh, PA MSA",2021,3,1227781,1144632,83149,6.8
MT4239740000000,42,39740,"Reading, PA MSA",2021,3,214116,199395,14721,6.9
MT4242540000000,42,42540,"Scranton--Wilkes-Barre, PA MSA",2021,3,273947,252028,21919,8
MT4244300000000,42,44300,"State College, PA MSA",2021,3,73385,69894,3491,4.8
MT4248700000000,42,48700,"Williamsport, PA MSA",2021,3,53207,49352,3855,7.2
MT4249620000000,42,49620,"York-Hanover, PA MSA",2021,3,234049,220399,13650,5.8
MT4439300000000,44,39300,"Providence-Warwick, RI-MA MSA",2021,3,866241,810042,56199,6.5
MT4516700000000,45,16700,"Charleston-North Charleston, SC MSA",2021,3,394246,378375,15871,4
MT4517900000000,45,17900,"Columbia, SC MSA",2021,3,394811,378338,16473,4.2
MT4522500000000,45,22500,"Florence, SC MSA",2021,3,88589,84184,4405,5
MT4524860000000,45,24860,"Greenville-Anderson-Greer, SC MSA",2021,3,441978,424988,16990,3.8
MT4525940000000,45,25940,"Hilton Head Island-Bluffton-Port Royal, SC MSA",2021,3,91146,87857,3289,3.6
MT4534820000000,45,34820,"Myrtle Beach-Conway-North Myrtle Beach, SC MSA",2021,3,152835,144774,8061,5.3
MT4543900000000,45,43900,"Spartanburg, SC MSA",2021,3,167406,159735,7671,4.6
MT4544940000000,45,44940,"Sumter, SC MSA",2021,3,42682,40524,2158,5.1
MT4639660000000,46,39660,"Rapid City, SD MSA",2021,3,75997,73774,2223,2.9
MT4643620000000,46,43620,"Sioux Falls, SD-MN MSA",2021,3,163858,159623,4235,2.6
MT4716860000000,47,16860,"Chattanooga, TN-GA MSA",2021,3,271144,259339,11805,4.4
MT4717300000000,47,17300,"Clarksville, TN-KY MSA",2021,3,131977,125227,6750,5.1
MT4717420000000,47,17420,"Cleveland, TN MSA",2021,3,57866,55040,2826,4.9
MT4727180000000,47,27180,"Jackson, TN MSA",2021,3,79370,74987,4383,5.5
MT4727740000000,47,27740,"Johnson City, TN MSA",2021,3,95781,91549,4232,4.4
MT4728700000000,47,28700,"Kingsport-Bristol, TN-VA MSA",2021,3,129228,122705,6523,5
MT4728940000000,47,28940,"Knoxville, TN MSA",2021,3,429442,411123,18319,4.3
MT4732820000000,47,32820,"Memphis, TN-MS-AR MSA",2021,3,643969,597672,46297,7.2
MT4734100000000,47,34100,"Morristown, TN MSA",2021,3,52319,49878,2441,4.7
MT4734980000000,47,34980,"Nashville-Davidson--Murfreesboro--Franklin, TN MSA",2021,3,1081026,1032548,48478,4.5
MT4810180000000,48,10180,"Abilene, TX MSA",2021,3,80364,76299,4065,5.1
MT4811100000000,48,11100,"Amarillo, TX MSA",2021,3,130587,124729,5858,4.5
MT4812420000000,48,12420,"Austin-Round Rock-San Marcos, TX MSA",2021,3,1279436,1217806,61630,4.8
MT4813140000000,48,13140,"Beaumont-Port Arthur, TX MSA",2021,3,171697,154486,17211,10
MT4815180000000,48,15180,"Brownsville-Harlingen, TX MSA",2021,3,179469,163526,15943,8.9
MT4817780000000,48,17780,"College Station-Bryan, TX MSA",2021,3,133586,126860,6726,5
MT4818580000000,48,18580,"Corpus Christi, TX MSA",2021,3,200626,184298,16328,8.1
MT4819100000000,48,19100,"Dallas-Fort Worth-Arlington, TX MSA",2021,3,4036304,3799719,236585,5.9
MT4820580000000,48,20580,"Eagle Pass, TX MSA",2021,3,23683,20256,3427,14.5
MT4821340000000,48,21340,"El Paso, TX MSA",2021,3,382471,356041,26430,6.9
MT4826420000000,48,26420,"Houston-Pasadena-The Woodlands, TX MSA",2021,3,3486829,3235656,251173,7.2
MT4828660000000,48,28660,"Killeen-Temple, TX MSA",2021,3,191396,179814,11582,6.1
MT4829700000000,48,29700,"Laredo, TX MSA",2021,3,110241,102018,8223,7.5
MT4830980000000,48,30980,"Longview, TX MSA",2021,3,124720,115645,9075,7.3
MT4831180000000,48,31180,"Lubbock, TX MSA",2021,3,173497,164116,9381,5.4
MT4832580000000,48,32580,"McAllen-Edinburg-Mission, TX MSA",2021,3,371635,333667,37968,10.2
MT4833260000000,48,33260,"Midland, TX MSA",2021,3,87486,80748,6738,7.7
MT4836220000000,48,36220,"Odessa, TX MSA",2021,3,77512,69541,7971,10.3
MT4841660000000,48,41660,"San Angelo, TX MSA",2021,3,57581,54561,3020,5.2
MT4841700000000,48,41700,"San Antonio-New Braunfels, TX MSA",2021,3,1210615,1138905,71710,5.9
MT4843300000000,48,43300,"Sherman-Denison, TX MSA",2021,3,65382,62054,3328,5.1
MT4845500000000,48,45500,"Texarkana, TX-AR MSA",2021,3,60792,56941,3851,6.3
MT4846340000000,48,46340,"Tyler, TX MSA",2021,3,109654,103121,6533,6
MT4847020000000,48,47020,"Victoria, TX MSA",2021,3,44420,41232,3188,7.2
MT4847380000000,48,47380,"Waco, TX MSA",2021,3,136335,128705,7630,5.6
MT4848660000000,48,48660,"Wichita Falls, TX MSA",2021,3,65563,61753,3810,5.8
MT4930860000000,49,30860,"Logan, UT-ID MSA",2021,3,75625,73874,1751,2.3
MT4936260000000,49,36260,"Ogden, UT MSA",2021,3,324391,314672,9719,3
MT4939340000000,49,39340,"Provo-Orem-Lehi, UT MSA",2021,3,335890,326690,9200,2.7
MT4941100000000,49,41100,"St. George, UT MSA",2021,3,82002,79150,2852,3.5
MT4941620000000,49,41620,"Salt Lake City-Murray, UT MSA",2021,3,679305,656885,22420,3.3
MT5015540000000,50,15540,"Burlington-South Burlington, VT MSA",2021,3,123571,118716,4855,3.9
MT5113980000000,51,13980,"Blacksburg-Christiansburg-Radford, VA MSA",2021,3,86033,82679,3354,3.9
MT5116820000000,51,16820,"Charlottesville, VA MSA",2021,3,109852,105581,4271,3.9
MT5125500000000,51,25500,"Harrisonburg, VA MSA",2021,3,67983,65511,2472,3.6
MT5131340000000,51,31340,"Lynchburg, VA MSA",2021,3,124120,118644,5476,4.4
MT5140060000000,51,40060,"Richmond, VA MSA",2021,3,671894,640521,31373,4.7
MT5140220000000,51,40220,"Roanoke, VA MSA",2021,3,150149,143606,6543,4.4
MT5144420000000,51,44420,"Staunton-Stuarts Draft, VA MSA",2021,3,60745,58467,2278,3.8
MT5147260000000,51,47260,"Virginia Beach-Chesapeake-Norfolk, VA-NC MSA",2021,3,840170,796675,43495,5.2
MT5149020000000,51,49020,"Winchester, VA-WV MSA",2021,3,71428,68834,2594,3.6
MT5313380000000,53,13380,"Bellingham, WA MSA",2021,3,112506,105410,7096,6.3
MT5314740000000,53,14740,"Bremerton-Silverdale-Port Orchard, WA MSA",2021,3,121600,114710,6890,5.7
MT5328420000000,53,28420,"Kennewick-Richland, WA MSA",2021,3,143600,134734,8866,6.2
MT5331020000000,53,31020,"Longview-Kelso, WA MSA",2021,3,47744,44544,3200,6.7
MT5334580000000,53,34580,"Mount Vernon-Anacortes, WA MSA",2021,3,58767,54704,4063,6.9
MT5336500000000,53,36500,"Olympia-Lacey-Tumwater, WA MSA",2021,3,137924,129985,7939,5.8
MT5342660000000,53,42660,"Seattle-Tacoma-Bellevue, WA MSA",2021,3,2147953,2024773,123180,5.7
MT5344060000000,53,44060,"Spokane-Spokane Valley, WA MSA",2021,3,278025,261975,16050,5.8
MT5347460000000,53,47460,"Walla Walla, WA MSA",2021,3,29885,28342,1543,5.2
MT5348300000000,53,48300,"Wenatchee-East Wenatchee, WA MSA",2021,3,62875,59144,3731,5.9
MT5349420000000,53,49420,"Yakima, WA MSA",2021,3,128450,119271,9179,7.1
MT5413220000000,54,13220,"Beckley, WV MSA",2021,3,45108,42086,3022,6.7
MT5416620000000,54,16620,"Charleston, WV MSA",2021,3,90250,84375,5875,6.5
MT5426580000000,54,26580,"Huntington-Ashland, WV-KY-OH MSA",2021,3,152260,143426,8834,5.8
MT5434060000000,54,34060,"Morgantown, WV MSA",2021,3,69121,65872,3249,4.7
MT5437620000000,54,37620,"Parkersburg-Vienna, WV MSA",2021,3,38836,36385,2451,6.3
MT5448540000000,54,48540,"Wheeling, WV-OH MSA",2021,3,60150,56051,4099,6.8
MT5511540000000,55,11540,"Appleton, WI MSA",2021,3,134300,129634,4666,3.5
MT5520740000000,55,20740,"Eau Claire, WI MSA",2021,3,92420,88599,3821,4.1
MT5522540000000,55,22540,"Fond du Lac, WI MSA",2021,3,56195,54034,2161,3.8
MT5524580000000,55,24580,"Green Bay, WI MSA",2021,3,175135,168353,6782,3.9
MT5527500000000,55,27500,"Janesville-Beloit, WI MSA",2021,3,84318,80036,4282,5.1
MT5528450000000,55,28450,"Kenosha, WI MSA",2021,3,92333,87929,4404,4.8
MT5529100000000,55,29100,"La Crosse-Onalaska, WI-MN MSA",2021,3,88235,84959,3276,3.7
MT5531540000000,55,31540,"Madison, WI MSA",2021,3,390191,376734,13457,3.4
MT5533340000000,55,33340,"Milwaukee-Waukesha, WI MSA",2021,3,810742,769234,41508,5.1
MT5536780000000,55,36780,"Oshkosh-Neenah, WI MSA",2021,3,91714,88313,3401,3.7
MT5539540000000,55,39540,"Racine-Mount Pleasant, WI MSA",2021,3,99889,94557,5332,5.3
MT5543100000000,55,43100,"Sheboygan, WI MSA",2021,3,62470,60238,2232,3.6
MT5548140000000,55,48140,"Wausau, WI MSA",2021,3,74699,72194,2505,3.4
MT5616220000000,56,16220,"Casper, WY MSA",2021,3,41424,38505,2919,7
MT5616940000000,56,16940,"Cheyenne, WY MSA",2021,3,48891,46600,2291,4.7
MT7210380000000,72,10380,"Aguadilla, PR MSA",2021,3,79319,72422,6897,8.7
MT7211640000000,72,11640,"Arecibo, PR MSA",2021,3,61324,56804,4520,7.4
MT7225020000000,72,25020,"Guayama, PR MSA",2021,3,18661,16872,1789,9.6
MT7232420000000,72,32420,"Mayaguez, PR MSA",2021,3,62805,56948,5857,9.3
MT7238660000000,72,38660,"Ponce, PR MSA",2021,3,84812,76284,8528,10.1
MT7241980000000,72,41980,"San Juan-Bayamon-Caguas, PR MSA",2021,3,770288,709548,60740,7.9
MT0111500000000,1,11500,"Anniston-Oxford, AL MSA",2021,4,49720,47684,2036,4.1
MT0112220000000,1,12220,"Auburn-Opelika, AL MSA",2021,4,89773,86927,2846,3.2
MT0113820000000,1,13820,"Birmingham, AL MSA",2021,4,551115,532298,18817,3.4
MT0119300000000,1,19300,"Daphne-Fairhope-Foley, AL MSA",2021,4,106428,103206,3222,3
MT0119460000000,1,19460,"Decatur, AL MSA",2021,4,71315,69235,2080,2.9
MT0120020000000,1,20020,"Dothan, AL MSA",2021,4,65404,63134,2270,3.5
MT0122520000000,1,22520,"Florence-Muscle Shoals, AL MSA",2021,4,66448,64019,2429,3.7
MT0123460000000,1,23460,"Gadsden, AL MSA",2021,4,41544,39847,1697,4.1
MT0126620000000,1,26620,"Huntsville, AL MSA",2021,4,248114,241452,6662,2.7
MT0133660000000,1,33660,"Mobile, AL MSA",2021,4,182807,173126,9681,5.3
MT0133860000000,1,33860,"Montgomery, AL MSA",2021,4,171674,163858,7816,4.6
MT0146220000000,1,46220,"Tuscaloosa, AL MSA",2021,4,119450,114579,4871,4.1
MT0211260000000,2,11260,"Anchorage, AK MSA",2021,4,196255,182723,13532,6.9
MT0221820000000,2,21820,"Fairbanks-College, AK MSA",2021,4,44605,42133,2472,5.5
MT0422380000000,4,22380,"Flagstaff, AZ MSA",2021,4,70217,65026,5191,7.4
MT0429420000000,4,29420,"Lake Havasu City-Kingman, AZ MSA",2021,4,84763,79037,5726,6.8
MT0438060000000,4,38060,"Phoenix-Mesa-Chandler, AZ MSA",2021,4,2521458,2383130,138328,5.5
MT0439150000000,4,39150,"Prescott Valley-Prescott, AZ MSA",2021,4,100667,95401,5266,5.2
MT0443420000000,4,43420,"Sierra Vista-Douglas, AZ MSA",2021,4,47879,45190,2689,5.6
MT0446060000000,4,46060,"Tucson, AZ MSA",2021,4,483033,454049,28984,6
MT0449740000000,4,49740,"Yuma, AZ MSA",2021,4,94055,81183,12872,13.7
MT0522220000000,5,22220,"Fayetteville-Springdale-Rogers, AR MSA",2021,4,273469,264285,9184,3.4
MT0522900000000,5,22900,"Fort Smith, AR-OK MSA",2021,4,99046,94848,4198,4.2
MT0526300000000,5,26300,"Hot Springs, AR MSA",2021,4,43131,40779,2352,5.5
MT0527860000000,5,27860,"Jonesboro, AR MSA",2021,4,62952,60423,2529,4
MT0530780000000,5,30780,"Little Rock-North Little Rock-Conway, AR MSA",2021,4,352668,335890,16778,4.8
MT0612540000000,6,12540,"Bakersfield-Delano, CA MSA",2021,4,386473,344968,41505,10.7
MT0617020000000,6,17020,"Chico, CA MSA",2021,4,90105,83155,6950,7.7
MT0620940000000,6,20940,"El Centro, CA MSA",2021,4,67395,54246,13149,19.5
MT0623420000000,6,23420,"Fresno, CA MSA",2021,4,499664,450572,49092,9.8
MT0625260000000,6,25260,"Hanford-Corcoran, CA MSA",2021,4,53889,48059,5830,10.8
MT0631080000000,6,31080,"Los Angeles-Long Beach-Anaheim, CA MSA",2021,4,6542837,5920258,622579,9.5
MT0632900000000,6,32900,"Merced, CA MSA",2021,4,114374,101959,12415,10.9
MT0633700000000,6,33700,"Modesto, CA MSA",2021,4,243006,221017,21989,9
MT0634900000000,6,34900,"Napa, CA MSA",2021,4,68445,63706,4739,6.9
MT0637100000000,6,37100,"Oxnard-Thousand Oaks-Ventura, CA MSA",2021,4,405013,376239,28774,7.1
MT0639820000000,6,39820,"Redding, CA MSA",2021,4,76437,70897,5540,7.2
MT0640140000000,6,40140,"Riverside-San Bernardino-Ontario, CA MSA",2021,4,2101349,1923475,177874,8.5
MT0640900000000,6,40900,"Sacramento-Roseville-Folsom, CA MSA",2021,4,1122027,1042118,79909,7.1
MT0641500000000,6,41500,"Salinas, CA MSA",2021,4,208263,189422,18841,9
MT0641740000000,6,41740,"San Diego-Chula Vista-Carlsbad, CA MSA",2021,4,1558693,1445064,113629,7.3
MT0641860000000,6,41860,"San Francisco-Oakland-Fremont, CA MSA",2021,4,2424058,2266828,157230,6.5
MT0641940000000,6,41940,"San Jose-Sunnyvale-Santa Clara, CA MSA",2021,4,1015205,957260,57945,5.7
MT0642020000000,6,42020,"San Luis Obispo-Paso Robles, CA MSA",2021,4,129016,120881,8135,6.3
MT0642100000000,6,42100,"Santa Cruz-Watsonville, CA MSA",2021,4,132439,122720,9719,7.3
MT0642200000000,6,42200,"Santa Maria-Santa Barbara, CA MSA",2021,4,213818,199642,14176,6.6
MT0642220000000,6,42220,"Santa Rosa-Petaluma, CA MSA",2021,4,239644,224301,15343,6.4
MT0644700000000,6,44700,"Stockton-Lodi, CA MSA",2021,4,347981,315690,32291,9.3
MT0646700000000,6,46700,"Vallejo, CA MSA",2021,4,207799,190971,16828,8.1
MT0647300000000,6,47300,"Visalia, CA MSA",2021,4,201493,178389,23104,11.5
MT0649700000000,6,49700,"Yuba City, CA MSA",2021,4,76456,69247,7209,9.4
MT0814500000000,8,14500,"Boulder, CO MSA",2021,4,187821,177978,9843,5.2
MT0817820000000,8,17820,"Colorado Springs, CO MSA",2021,4,374901,351899,23002,6.1
MT0819740000000,8,19740,"Denver-Aurora-Centennial, CO MSA",2021,4,1701833,1597618,104215,6.1
MT0822660000000,8,22660,"Fort Collins-Loveland, CO MSA",2021,4,197794,186790,11004,5.6
MT0824300000000,8,24300,"Grand Junction, CO MSA",2021,4,78569,73532,5037,6.4
MT0824540000000,8,24540,"Greeley, CO MSA",2021,4,166528,155709,10819,6.5
MT0839380000000,8,39380,"Pueblo, CO MSA",2021,4,75305,68571,6734,8.9
MT0914860000000,9,14860,"Bridgeport-Stamford-Danbury, CT MSA",2021,4,470300,438801,31499,6.7
MT0925540000000,9,25540,"Hartford-West Hartford-East Hartford, CT MSA",2021,4,579899,537914,41985,7.2
MT0935300000000,9,35300,"New Haven, CT MSA",2021,4,293097,271804,21293,7.3
MT0935980000000,9,35980,"Norwich-New London-Willimantic, CT MSA",2021,4,133046,122261,10785,8.1
MT0947930000000,9,47930,"Waterbury-Shelton, CT MSA",2021,4,226948,209117,17831,7.9
MT1020100000000,10,20100,"Dover, DE MSA",2021,4,85155,79668,5487,6.4
MT1147900000000,11,47900,"Washington-Arlington-Alexandria, DC-VA-MD-WV MSA",2021,4,3367576,3196820,170756,5.1
MT1215980000000,12,15980,"Cape Coral-Fort Myers, FL MSA",2021,4,344287,327668,16619,4.8
MT1218880000000,12,18880,"Crestview-Fort Walton Beach-Destin, FL MSA",2021,4,133780,128725,5055,3.8
MT1219660000000,12,19660,"Deltona-Daytona Beach-Ormond Beach, FL MSA",2021,4,295098,279425,15673,5.3
MT1223540000000,12,23540,"Gainesville, FL MSA",2021,4,161799,154745,7054,4.4
MT1226140000000,12,26140,"Homosassa Springs, FL MSA",2021,4,50363,47320,3043,6
MT1227260000000,12,27260,"Jacksonville, FL MSA",2021,4,791361,755425,35936,4.5
MT1229460000000,12,29460,"Lakeland-Winter Haven, FL MSA",2021,4,332810,313015,19795,5.9
MT1233100000000,12,33100,"Miami-Fort Lauderdale-West Palm Beach, FL MSA",2021,4,3041795,2862916,178879,5.9
MT1234940000000,12,34940,"Naples-Marco Island, FL MSA",2021,4,165672,158215,7457,4.5
MT1235840000000,12,35840,"North Port-Bradenton-Sarasota, FL MSA",2021,4,357985,341867,16118,4.5
MT1236100000000,12,36100,"Ocala, FL MSA",2021,4,145881,138018,7863,5.4
MT1236740000000,12,36740,"Orlando-Kissimmee-Sanford, FL MSA",2021,4,1340116,1264406,75710,5.6
MT1237340000000,12,37340,"Palm Bay-Melbourne-Titusville, FL MSA",2021,4,287209,274066,13143,4.6
MT1237460000000,12,37460,"Panama City-Panama City Beach, FL MSA",2021,4,95099,90786,4313,4.5
MT1237860000000,12,37860,"Pensacola-Ferry Pass-Brent, FL MSA",2021,4,228816,218161,10655,4.7
MT1238940000000,12,38940,"Port St. Lucie, FL MSA",2021,4,220819,209652,11167,5.1
MT1239460000000,12,39460,"Punta Gorda, FL MSA",2021,4,68301,64771,3530,5.2
MT1242680000000,12,42680,"Sebastian-Vero Beach-West Vero Corridor, FL MSA",2021,4,62257,58796,3461,5.6
MT1242700000000,12,42700,"Sebring, FL MSA",2021,4,34099,31841,2258,6.6
MT1245220000000,12,45220,"Tallahassee, FL MSA",2021,4,193139,184069,9070,4.7
MT1245300000000,12,45300,"Tampa-St. Petersburg-Clearwater, FL MSA",2021,4,1562123,1487547,74576,4.8
MT1248680000000,12,48680,"Wildwood-The Villages, FL MSA",2021,4,29379,27336,2043,7
MT1310500000000,13,10500,"Albany, GA MSA",2021,4,64272,60403,3869,6
MT1312020000000,13,12020,"Athens-Clarke County, GA MSA",2021,4,102828,99225,3603,3.5
MT1312060000000,13,12060,"Atlanta-Sandy Springs-Roswell, GA MSA",2021,4,3117957,2981923,136034,4.4
MT1312260000000,13,12260,"Augusta-Richmond County, GA-SC MSA",2021,4,265217,253780,11437,4.3
MT1315260000000,13,15260,"Brunswick-St. Simons, GA MSA",2021,4,51393,49265,2128,4.1
MT1317980000000,13,17980,"Columbus, GA-AL MSA",2021,4,131479,125216,6263,4.8
MT1319140000000,13,19140,"Dalton, GA MSA",2021,4,66279,63646,2633,4
MT1323580000000,13,23580,"Gainesville, GA MSA",2021,4,100168,97151,3017,3
MT1325980000000,13,25980,"Hinesville, GA MSA",2021,4,30866,29464,1402,4.5
MT1331420000000,13,31420,"Macon-Bibb County, GA MSA",2021,4,99772,94583,5189,5.2
MT1340660000000,13,40660,"Rome, GA MSA",2021,4,43676,41906,1770,4.1
MT1342340000000,13,42340,"Savannah, GA MSA",2021,4,199317,190583,8734,4.4
MT1346660000000,13,46660,"Valdosta, GA MSA",2021,4,62322,59455,2867,4.6
MT1347580000000,13,47580,"Warner Robins, GA MSA",2021,4,89006,85427,3579,4
MT1527980000000,15,27980,"Kahului-Wailuku, HI MSA",2021,4,83810,75243,8567,10.2
MT1546520000000,15,46520,"Urban Honolulu, HI MSA",2021,4,468911,435658,33253,7.1
MT1614260000000,16,14260,"Boise City, ID MSA",2021,4,405944,390301,15643,3.9
MT1617660000000,16,17660,"Coeur d'Alene, ID MSA",2021,4,84441,80449,3992,4.7
MT1626820000000,16,26820,"Idaho Falls, ID MSA",2021,4,76965,74487,2478,3.2
MT1630300000000,16,30300,"Lewiston, ID-WA MSA",2021,4,30110,28955,1155,3.8
MT1638540000000,16,38540,"Pocatello, ID MSA",2021,4,38046,36351,1695,4.5
MT1646300000000,16,46300,"Twin Falls, ID MSA",2021,4,57735,55562,2173,3.8
MT1714010000000,17,14010,"Bloomington, IL MSA",2021,4,87406,83146,4260,4.9
MT1716580000000,17,16580,"Champaign-Urbana, IL MSA",2021,4,121338,114946,6392,5.3
MT1716980000000,17,16980,"Chicago-Naperville-Elgin, IL-IN MSA",2021,4,4710774,4380727,330047,7
MT1719340000000,17,19340,"Davenport-Moline-Rock Island, IA-IL MSA",2021,4,188349,177303,11046,5.9
MT1719500000000,17,19500,"Decatur, IL MSA",2021,4,46039,42200,3839,8.3
MT1728100000000,17,28100,"Kankakee, IL MSA",2021,4,51511,47845,3666,7.1
MT1737900000000,17,37900,"Peoria, IL MSA",2021,4,173209,162075,11134,6.4
MT1740420000000,17,40420,"Rockford, IL MSA",2021,4,162352,147248,15104,9.3
MT1744100000000,17,44100,"Springfield, IL MSA",2021,4,100869,94585,6284,6.2
MT1814020000000,18,14020,"Bloomington, IN MSA",2021,4,80460,77699,2761,3.4
MT1818020000000,18,18020,"Columbus, IN MSA",2021,4,38696,37193,1503,3.9
MT1821140000000,18,21140,"Elkhart-Goshen, IN MSA",2021,4,104897,101242,3655,3.5
MT1821780000000,18,21780,"Evansville, IN MSA",2021,4,133872,128438,5434,4.1
MT1823060000000,18,23060,"Fort Wayne, IN MSA",2021,4,224438,215236,9202,4.1
MT1826900000000,18,26900,"Indianapolis-Carmel-Greenwood, IN MSA",2021,4,1075024,1028883,46141,4.3
MT1829020000000,18,29020,"Kokomo, IN MSA",2021,4,37171,35149,2022,5.4
MT1829200000000,18,29200,"Lafayette-West Lafayette, IN MSA",2021,4,112657,108407,4250,3.8
MT1833140000000,18,33140,"Michigan City-La Porte, IN MSA",2021,4,50387,47483,2904,5.8
MT1834620000000,18,34620,"Muncie, IN MSA",2021,4,51991,49587,2404,4.6
MT1843780000000,18,43780,"South Bend-Mishawaka, IN-MI MSA",2021,4,153916,145802,8114,5.3
MT1845460000000,18,45460,"Terre Haute, IN MSA",2021,4,76888,73349,3539,4.6
MT1911180000000,19,11180,"Ames, IA MSA",2021,4,67264,65018,2246,3.3
MT1916300000000,19,16300,"Cedar Rapids, IA MSA",2021,4,147689,140299,7390,5
MT1919780000000,19,19780,"Des Moines-West Des Moines, IA MSA",2021,4,385234,368378,16856,4.4
MT1920220000000,19,20220,"Dubuque, IA MSA",2021,4,52859,50363,2496,4.7
MT1926980000000,19,26980,"Iowa City, IA MSA",2021,4,96282,92462,3820,4
MT1943580000000,19,43580,"Sioux City, IA-NE-SD MSA",2021,4,74756,71547,3209,4.3
MT1947940000000,19,47940,"Waterloo-Cedar Falls, IA MSA",2021,4,88410,84567,3843,4.3
MT2029940000000,20,29940,"Lawrence, KS MSA",2021,4,67123,64837,2286,3.4
MT2031740000000,20,31740,"Manhattan, KS MSA",2021,4,61549,59596,1953,3.2
MT2045820000000,20,45820,"Topeka, KS MSA",2021,4,116267,112144,4123,3.5
MT2048620000000,20,48620,"Wichita, KS MSA",2021,4,324679,308519,16160,5
MT2114540000000,21,14540,"Bowling Green, KY MSA",2021,4,86112,82618,3494,4.1
MT2121060000000,21,21060,"Elizabethtown, KY MSA",2021,4,52990,50554,2436,4.6
MT2130460000000,21,30460,"Lexington-Fayette, KY MSA",2021,4,260572,250253,10319,4
MT2131140000000,21,31140,"Louisville/Jefferson County, KY-IN MSA",2021,4,674659,645263,29396,4.4
MT2136980000000,21,36980,"Owensboro, KY MSA",2021,4,50668,48534,2134,4.2
MT2137140000000,21,37140,"Paducah, KY-IL MSA",2021,4,44635,42363,2272,5.1
MT2210780000000,22,10780,"Alexandria, LA MSA",2021,4,64958,61951,3007,4.6
MT2212940000000,22,12940,"Baton Rouge, LA MSA",2021,4,413919,388895,25024,6
MT2225220000000,22,25220,"Hammond, LA MSA",2021,4,58688,54549,4139,7.1
MT2226380000000,22,26380,"Houma-Bayou Cane-Thibodaux, LA MSA",2021,4,88177,83226,4951,5.6
MT2229180000000,22,29180,"Lafayette, LA MSA",2021,4,191942,181486,10456,5.4
MT2229340000000,22,29340,"Lake Charles, LA MSA",2021,4,102328,95027,7301,7.1
MT2233740000000,22,33740,"Monroe, LA MSA",2021,4,95463,89400,6063,6.4
MT2235380000000,22,35380,"New Orleans-Metairie, LA MSA",2021,4,466248,431193,35055,7.5
MT2243340000000,22,43340,"Shreveport-Bossier City, LA MSA",2021,4,166091,155483,10608,6.4
MT2243640000000,22,43640,"Slidell-Mandeville-Covington, LA MSA",2021,4,122757,117421,5336,4.3
MT2312620000000,23,12620,"Bangor, ME MSA",2021,4,73271,69348,3923,5.4
MT2330340000000,23,30340,"Lewiston-Auburn, ME MSA",2021,4,55493,52523,2970,5.4
MT2338860000000,23,38860,"Portland-South Portland, ME MSA",2021,4,302342,288160,14182,4.7
MT2412580000000,24,12580,"Baltimore-Columbia-Towson, MD MSA",2021,4,1449349,1366763,82586,5.7
MT2425180000000,24,25180,"Hagerstown-Martinsburg, MD-WV MSA",2021,4,140634,133850,6784,4.8
MT2430500000000,24,30500,"Lexington Park, MD MSA",2021,4,104934,100196,4738,4.5
MT2441540000000,24,41540,"Salisbury, MD MSA",2021,4,60665,56876,3789,6.2
MT2511200000000,25,11200,"Amherst Town-Northampton, MA MSA",2021,4,82135,77815,4320,5.3
MT2512700000000,25,12700,"Barnstable Town, MA MSA",2021,4,112580,104892,7688,6.8
MT2514460000000,25,14460,"Boston-Cambridge-Newton, MA-NH MSA",2021,4,2695978,2549497,146481,5.4
MT2538340000000,25,38340,"Pittsfield, MA MSA",2021,4,62906,58620,4286,6.8
MT2544140000000,25,44140,"Springfield, MA MSA",2021,4,225660,208431,17229,7.6
MT2549340000000,25,49340,"Worcester, MA MSA",2021,4,446661,420095,26566,5.9
MT2611460000000,26,11460,"Ann Arbor, MI MSA",2021,4,190794,182080,8714,4.6
MT2612980000000,26,12980,"Battle Creek, MI MSA",2021,4,58666,54570,4096,7
MT2613020000000,26,13020,"Bay City, MI MSA",2021,4,46994,43989,3005,6.4
MT2619820000000,26,19820,"Detroit-Warren-Dearborn, MI MSA",2021,4,2096184,1957254,138930,6.6
MT2622420000000,26,22420,"Flint, MI MSA",2021,4,176900,163545,13355,7.5
MT2624340000000,26,24340,"Grand Rapids-Wyoming-Kentwood, MI MSA",2021,4,578668,549463,29205,5
MT2627100000000,26,27100,"Jackson, MI MSA",2021,4,70683,66270,4413,6.2
MT2628020000000,26,28020,"Kalamazoo-Portage, MI MSA",2021,4,129587,122784,6803,5.2
MT2629620000000,26,29620,"Lansing-East Lansing, MI MSA",2021,4,230053,217431,12622,5.5
MT2633220000000,26,33220,"Midland, MI MSA",2021,4,38079,36136,1943,5.1
MT2633780000000,26,33780,"Monroe, MI MSA",2021,4,71507,66794,4713,6.6
MT2634740000000,26,34740,"Muskegon-Norton Shores, MI MSA",2021,4,79048,73076,5972,7.6
MT2635660000000,26,35660,"Niles, MI MSA",2021,4,71171,66903,4268,6
MT2640980000000,26,40980,"Saginaw, MI MSA",2021,4,81369,75469,5900,7.3
MT2645900000000,26,45900,"Traverse City, MI MSA",2021,4,74871,70736,4135,5.5
MT2720260000000,27,20260,"Duluth, MN-WI MSA",2021,4,137037,130820,6217,4.5
MT2731860000000,27,31860,"Mankato, MN MSA",2021,4,58035,55934,2101,3.6
MT2733460000000,27,33460,"Minneapolis-St. Paul-Bloomington, MN-WI MSA",2021,4,2009812,1929436,80376,4
MT2740340000000,27,40340,"Rochester, MN MSA",2021,4,123939,119691,4248,3.4
MT2741060000000,27,41060,"St. Cloud, MN MSA",2021,4,107888,103061,4827,4.5
MT2825060000000,28,25060,"Gulfport-Biloxi, MS MSA",2021,4,182523,171656,10867,6
MT2825620000000,28,25620,"Hattiesburg, MS MSA",2021,4,69218,65275,3943,5.7
MT2827140000000,28,27140,"Jackson, MS MSA",2021,4,275563,259641,15922,5.8
MT2916020000000,29,16020,"Cape Girardeau, MO-IL MSA",2021,4,47446,45531,1915,4
MT2917860000000,29,17860,"Columbia, MO MSA",2021,4,111018,107474,3544,3.2
MT2927620000000,29,27620,"Jefferson City, MO MSA",2021,4,72985,70544,2441,3.3
MT2927900000000,29,27900,"Joplin, MO-KS MSA",2021,4,94003,90322,3681,3.9
MT2928140000000,29,28140,"Kansas City, MO-KS MSA",2021,4,1151776,1096744,55032,4.8
MT2941140000000,29,41140,"St. Joseph, MO-KS MSA",2021,4,55988,53646,2342,4.2
MT2941180000000,29,41180,"St. Louis, MO-IL MSA",2021,4,1442985,1371030,71955,5
MT2944180000000,29,44180,"Springfield, MO MSA",2021,4,231141,222530,8611,3.7
MT3013740000000,30,13740,"Billings, MT MSA",2021,4,94982,91632,3350,3.5
MT3014580000000,30,14580,"Bozeman, MT MSA",2021,4,70513,68501,2012,2.9
MT3024500000000,30,24500,"Great Falls, MT MSA",2021,4,38433,37017,1416,3.7
MT3025740000000,30,25740,"Helena, MT MSA",2021,4,44877,43327,1550,3.5
MT3033540000000,30,33540,"Missoula, MT MSA",2021,4,69875,67404,2471,3.5
MT3124260000000,31,24260,"Grand Island, NE MSA",2021,4,40730,39468,1262,3.1
MT3130700000000,31,30700,"Lincoln, NE MSA",2021,4,186071,180681,5390,2.9
MT3136540000000,31,36540,"Omaha, NE-IA MSA",2021,4,509326,492206,17120,3.4
MT3216180000000,32,16180,"Carson City, NV MSA",2021,4,28470,27153,1317,4.6
MT3229820000000,32,29820,"Las Vegas-Henderson-North Las Vegas, NV MSA",2021,4,1086944,990185,96759,8.9
MT3239900000000,32,39900,"Reno, NV MSA",2021,4,285839,272701,13138,4.6
MT3331700000000,33,31700,"Manchester-Nashua, NH MSA",2021,4,236053,226489,9564,4.1
MT3412100000000,34,12100,"Atlantic City-Hammonton, NJ MSA",2021,4,177890,159824,18066,10.2
MT3445940000000,34,45940,"Trenton-Princeton, NJ MSA",2021,4,192972,180383,12589,6.5
MT3447220000000,34,47220,"Vineland, NJ MSA",2021,4,64950,59076,5874,9
MT3510740000000,35,10740,"Albuquerque, NM MSA",2021,4,439602,407458,32144,7.3
MT3522140000000,35,22140,"Farmington, NM MSA",2021,4,47713,43122,4591,9.6
MT3529740000000,35,29740,"Las Cruces, NM MSA",2021,4,95663,88334,7329,7.7
MT3542140000000,35,42140,"Santa Fe, NM MSA",2021,4,71862,66570,5292,7.4
MT3610580000000,36,10580,"Albany-Schenectady-Troy, NY MSA",2021,4,449254,426501,22753,5.1
MT3613780000000,36,13780,"Binghamton, NY MSA",2021,4,106564,100485,6079,5.7
MT3615380000000,36,15380,"Buffalo-Cheektowaga, NY MSA",2021,4,556781,522484,34297,6.2
MT3621300000000,36,21300,"Elmira, NY MSA",2021,4,36168,34055,2113,5.8
MT3624020000000,36,24020,"Glens Falls, NY MSA",2021,4,59998,56787,3211,5.4
MT3627060000000,36,27060,"Ithaca, NY MSA",2021,4,49209,47066,2143,4.4
MT3628740000000,36,28740,"Kingston, NY MSA",2021,4,85249,80516,4733,5.6
MT3628880000000,36,28880,"Kiryas Joel-Poughkeepsie-Newburgh, NY MSA",2021,4,325809,308142,17667,5.4
MT3635620000000,36,35620,"New York-Newark-Jersey City, NY-NJ MSA",2021,4,9737849,8897393,840456,8.6
MT3640380000000,36,40380,"Rochester, NY MSA",2021,4,511041,481784,29257,5.7
MT3645060000000,36,45060,"Syracuse, NY MSA",2021,4,310205,292570,17635,5.7
MT3646540000000,36,46540,"Utica-Rome, NY MSA",2021,4,129988,122306,7682,5.9
MT3648060000000,36,48060,"Watertown-Fort Drum, NY MSA",2021,4,44671,42144,2527,5.7
MT3711700000000,37,11700,"Asheville, NC MSA",2021,4,194392,184911,9481,4.9
MT3715500000000,37,15500,"Burlington, NC MSA",2021,4,79502,75185,4317,5.4
MT3716740000000,37,16740,"Charlotte-Concord-Gastonia, NC-SC MSA",2021,4,1352291,1281774,70517,5.2
MT3720500000000,37,20500,"Durham-Chapel Hill, NC MSA",2021,4,293810,280236,13574,4.6
MT3722180000000,37,22180,"Fayetteville, NC MSA",2021,4,148280,137519,10761,7.3
MT3724140000000,37,24140,"Goldsboro, NC MSA",2021,4,48649,45934,2715,5.6
MT3724660000000,37,24660,"Greensboro-High Point, NC MSA",2021,4,357923,336377,21546,6
MT3724780000000,37,24780,"Greenville, NC MSA",2021,4,78165,73463,4702,6
MT3725860000000,37,25860,"Hickory-Lenoir-Morganton, NC MSA",2021,4,163850,155067,8783,5.4
MT3727340000000,37,27340,"Jacksonville, NC MSA",2021,4,68031,64395,3636,5.3
MT3738240000000,37,38240,"Pinehurst-Southern Pines, NC MSA",2021,4,40647,38629,2018,5
MT3739580000000,37,39580,"Raleigh-Cary, NC MSA",2021,4,742515,709459,33056,4.5
MT3740580000000,37,40580,"Rocky Mount, NC MSA",2021,4,62907,58205,4702,7.5
MT3748900000000,37,48900,"Wilmington, NC MSA",2021,4,198332,187632,10700,5.4
MT3749180000000,37,49180,"Winston-Salem, NC MSA",2021,4,310283,293417,16866,5.4
MT3813900000000,38,13900,"Bismarck, ND MSA",2021,4,72016,69795,2221,3.1
MT3822020000000,38,22020,"Fargo, ND-MN MSA",2021,4,145595,141372,4223,2.9
MT3824220000000,38,24220,"Grand Forks, ND-MN MSA",2021,4,54170,52289,1881,3.5
MT3833500000000,38,33500,"Minot, ND MSA",2021,4,38993,37498,1495,3.8
MT3910420000000,39,10420,"Akron, OH MSA",2021,4,353477,331693,21784,6.2
MT3915940000000,39,15940,"Canton-Massillon, OH MSA",2021,4,192419,180198,12221,6.4
MT3917140000000,39,17140,"Cincinnati, OH-KY-IN MSA",2021,4,1127246,1070667,56579,5
MT3917410000000,39,17410,"Cleveland, OH MSA",2021,4,1059661,993453,66208,6.2
MT3918140000000,39,18140,"Columbus, OH MSA",2021,4,1111071,1048032,63039,5.7
MT3919430000000,39,19430,"Dayton-Kettering-Beavercreek, OH MSA",2021,4,383544,360042,23502,6.1
MT3930620000000,39,30620,"Lima, OH MSA",2021,4,48100,45338,2762,5.7
MT3931900000000,39,31900,"Mansfield, OH MSA",2021,4,52954,49596,3358,6.3
MT3941780000000,39,41780,"Sandusky, OH MSA",2021,4,56149,52563,3586,6.4
MT3944220000000,39,44220,"Springfield, OH MSA",2021,4,61250,57292,3958,6.5
MT3945780000000,39,45780,"Toledo, OH MSA",2021,4,292085,272082,20003,6.8
MT3948260000000,39,48260,"Weirton-Steubenville, WV-OH MSA",2021,4,52711,49242,3469,6.6
MT3949660000000,39,49660,"Youngstown-Warren, OH MSA",2021,4,188733,174857,13876,7.4
MT4021420000000,40,21420,"Enid, OK MSA",2021,4,28359,27245,1114,3.9
MT4030020000000,40,30020,"Lawton, OK MSA",2021,4,50881,48739,2142,4.2
MT4036420000000,40,36420,"Oklahoma City, OK MSA",2021,4,709030,677276,31754,4.5
MT4046140000000,40,46140,"Tulsa, OK MSA",2021,4,489898,466799,23099,4.7
MT4110540000000,41,10540,"Albany, OR MSA",2021,4,60468,56646,3822,6.3
MT4113460000000,41,13460,"Bend, OR MSA",2021,4,125958,118158,7800,6.2
MT4118700000000,41,18700,"Corvallis, OR MSA",2021,4,46595,44436,2159,4.6
MT4121660000000,41,21660,"Eugene-Springfield, OR MSA",2021,4,184938,173484,11454,6.2
MT4124420000000,41,24420,"Grants Pass, OR MSA",2021,4,35764,33214,2550,7.1
MT4132780000000,41,32780,"Medford, OR MSA",2021,4,106369,99817,6552,6.2
MT4138900000000,41,38900,"Portland-Vancouver-Hillsboro, OR-WA MSA",2021,4,1347738,1270836,76902,5.7
MT4141420000000,41,41420,"Salem, OR MSA",2021,4,211935,199989,11946,5.6
MT4210900000000,42,10900,"Allentown-Bethlehem-Easton, PA-NJ MSA",2021,4,440497,410961,29536,6.7
MT4211020000000,42,11020,"Altoona, PA MSA",2021,4,57717,54102,3615,6.3
MT4216540000000,42,16540,"Chambersburg, PA MSA",2021,4,76348,72231,4117,5.4
MT4221500000000,42,21500,"Erie, PA MSA",2021,4,126949,117411,9538,7.5
MT4223900000000,42,23900,"Gettysburg, PA MSA",2021,4,51733,49277,2456,4.7
MT4225420000000,42,25420,"Harrisburg-Carlisle, PA MSA",2021,4,302387,285438,16949,5.6
MT4227780000000,42,27780,"Johnstown, PA MSA",2021,4,57319,53323,3996,7
MT4229540000000,42,29540,"Lancaster, PA MSA",2021,4,284804,270462,14342,5
MT4230140000000,42,30140,"Lebanon, PA MSA",2021,4,70763,66664,4099,5.8
MT4237980000000,42,37980,"Philadelphia-Camden-Wilmington, PA-NJ-DE-MD MSA",2021,4,3175996,2963202,212794,6.7
MT4238300000000,42,38300,"Pittsburgh, PA MSA",2021,4,1226702,1145934,80768,6.6
MT4239740000000,42,39740,"Reading, PA MSA",2021,4,213332,199011,14321,6.7
MT4242540000000,42,42540,"Scranton--Wilkes-Barre, PA MSA",2021,4,273423,252236,21187,7.7
MT4244300000000,42,44300,"State College, PA MSA",2021,4,73467,70077,3390,4.6
MT4248700000000,42,48700,"Williamsport, PA MSA",2021,4,53084,49285,3799,7.2
MT4249620000000,42,49620,"York-Hanover, PA MSA",2021,4,233707,220439,13268,5.7
MT4439300000000,44,39300,"Providence-Warwick, RI-MA MSA",2021,4,866304,812038,54266,6.3
MT4516700000000,45,16700,"Charleston-North Charleston, SC MSA",2021,4,394889,379662,15227,3.9
MT4517900000000,45,17900,"Columbia, SC MSA",2021,4,394616,378840,15776,4
MT4522500000000,45,22500,"Florence, SC MSA",2021,4,88637,84358,4279,4.8
MT4524860000000,45,24860,"Greenville-Anderson-Greer, SC MSA",2021,4,441759,425283,16476,3.7
MT4525940000000,45,25940,"Hilton Head Island-Bluffton-Port Royal, SC MSA",2021,4,91180,87985,3195,3.5
MT4534820000000,45,34820,"Myrtle Beach-Conway-North Myrtle Beach, SC MSA",2021,4,153337,145324,8013,5.2
MT4543900000000,45,43900,"Spartanburg, SC MSA",2021,4,167310,159809,7501,4.5
MT4544940000000,45,44940,"Sumter, SC MSA",2021,4,42608,40536,2072,4.9
MT4639660000000,46,39660,"Rapid City, SD MSA",2021,4,76330,74136,2194,2.9
MT4643620000000,46,43620,"Sioux Falls, SD-MN MSA",2021,4,164284,160122,4162,2.5
MT4716860000000,47,16860,"Chattanooga, TN-GA MSA",2021,4,270783,259223,11560,4.3
MT4717300000000,47,17300,"Clarksville, TN-KY MSA",2021,4,131876,125213,6663,5.1
MT4717420000000,47,17420,"Cleveland, TN MSA",2021,4,57761,54991,2770,4.8
MT4727180000000,47,27180,"Jackson, TN MSA",2021,4,79029,74729,4300,5.4
MT4727740000000,47,27740,"Johnson City, TN MSA",2021,4,95704,91569,4135,4.3
MT4728700000000,47,28700,"Kingsport-Bristol, TN-VA MSA",2021,4,129056,122654,6402,5
MT4728940000000,47,28940,"Knoxville, TN MSA",2021,4,429522,411708,17814,4.1
MT4732820000000,47,32820,"Memphis, TN-MS-AR MSA",2021,4,643053,597320,45733,7.1
MT4734100000000,47,34100,"Morristown, TN MSA",2021,4,52279,49857,2422,4.6
MT4734980000000,47,34980,"Nashville-Davidson--Murfreesboro--Franklin, TN MSA",2021,4,1081833,1034665,47168,4.4
MT4810180000000,48,10180,"Abilene, TX MSA",2021,4,80316,76363,3953,4.9
MT4811100000000,48,11100,"Amarillo, TX MSA",2021,4,130617,124950,5667,4.3
MT4812420000000,48,12420,"Austin-Round Rock-San Marcos, TX MSA",2021,4,1286780,1227012,59768,4.6
MT4813140000000,48,13140,"Beaumont-Port Arthur, TX MSA",2021,4,171372,154447,16925,9.9
MT4815180000000,48,15180,"Brownsville-Harlingen, TX MSA",2021,4,179681,164068,15613,8.7
MT4817780000000,48,17780,"College Station-Bryan, TX MSA",2021,4,134063,127536,6527,4.9
MT4818580000000,48,18580,"Corpus Christi, TX MSA",2021,4,200600,184705,15895,7.9
MT4819100000000,48,19100,"Dallas-Fort Worth-Arlington, TX MSA",2021,4,4043789,3813930,229859,5.7
MT4820580000000,48,20580,"Eagle Pass, TX MSA",2021,4,23590,20290,3300,14
MT4821340000000,48,21340,"El Paso, TX MSA",2021,4,382731,357113,25618,6.7
MT4826420000000,48,26420,"Houston-Pasadena-The Woodlands, TX MSA",2021,4,3489951,3245937,244014,7
MT4828660000000,48,28660,"Killeen-Temple, TX MSA",2021,4,191673,180307,11366,5.9
MT4829700000000,48,29700,"Laredo, TX MSA",2021,4,110444,102511,7933,7.2
MT4830980000000,48,30980,"Longview, TX MSA",2021,4,124675,115883,8792,7.1
MT4831180000000,48,31180,"Lubbock, TX MSA",2021,4,173406,164299,9107,5.3
MT4832580000000,48,32580,"McAllen-Edinburg-Mission, TX MSA",2021,4,372663,335459,37204,10
MT4833260000000,48,33260,"Midland, TX MSA",2021,4,87808,81470,6338,7.2
MT4836220000000,48,36220,"Odessa, TX MSA",2021,4,77507,70037,7470,9.6
MT4841660000000,48,41660,"San Angelo, TX MSA",2021,4,57638,54731,2907,5
MT4841700000000,48,41700,"San Antonio-New Braunfels, TX MSA",2021,4,1212873,1143202,69671,5.7
MT4843300000000,48,43300,"Sherman-Denison, TX MSA",2021,4,65465,62235,3230,4.9
MT4845500000000,48,45500,"Texarkana, TX-AR MSA",2021,4,60832,57043,3789,6.2
MT4846340000000,48,46340,"Tyler, TX MSA",2021,4,109692,103328,6364,5.8
MT4847020000000,48,47020,"Victoria, TX MSA",2021,4,44249,41191,3058,6.9
MT4847380000000,48,47380,"Waco, TX MSA",2021,4,136235,128819,7416,5.4
MT4848660000000,48,48660,"Wichita Falls, TX MSA",2021,4,65447,61791,3656,5.6
MT4930860000000,49,30860,"Logan, UT-ID MSA",2021,4,75871,74181,1690,2.2
MT4936260000000,49,36260,"Ogden, UT MSA",2021,4,324290,314904,9386,2.9
MT4939340000000,49,39340,"Provo-Orem-Lehi, UT MSA",2021,4,336873,328010,8863,2.6
MT4941100000000,49,41100,"St. George, UT MSA",2021,4,82215,79482,2733,3.3
MT4941620000000,49,41620,"Salt Lake City-Murray, UT MSA",2021,4,680420,658768,21652,3.2
MT5015540000000,50,15540,"Burlington-South Burlington, VT MSA",2021,4,123658,118861,4797,3.9
MT5113980000000,51,13980,"Blacksburg-Christiansburg-Radford, VA MSA",2021,4,86353,83065,3288,3.8
MT5116820000000,51,16820,"Charlottesville, VA MSA",2021,4,110231,106072,4159,3.8
MT5125500000000,51,25500,"Harrisonburg, VA MSA",2021,4,68255,65839,2416,3.5
MT5131340000000,51,31340,"Lynchburg, VA MSA",2021,4,124253,118899,5354,4.3
MT5140060000000,51,40060,"Richmond, VA MSA",2021,4,673451,642685,30766,4.6
MT5140220000000,51,40220,"Roanoke, VA MSA",2021,4,150225,143804,6421,4.3
MT5144420000000,51,44420,"Staunton-Stuarts Draft, VA MSA",2021,4,60824,58582,2242,3.7
MT5147260000000,51,47260,"Virginia Beach-Chesapeake-Norfolk, VA-NC MSA",2021,4,840390,797796,42594,5.1
MT5149020000000,51,49020,"Winchester, VA-WV MSA",2021,4,71533,68975,2558,3.6
MT5313380000000,53,13380,"Bellingham, WA MSA",2021,4,112760,106004,6756,6
MT5314740000000,53,14740,"Bremerton-Silverdale-Port Orchard, WA MSA",2021,4,121741,115204,6537,5.4
MT5328420000000,53,28420,"Kennewick-Richland, WA MSA",2021,4,144204,135497,8707,6
MT5331020000000,53,31020,"Longview-Kelso, WA MSA",2021,4,47788,44707,3081,6.4
MT5334580000000,53,34580,"Mount Vernon-Anacortes, WA MSA",2021,4,58850,54939,3911,6.6
MT5336500000000,53,36500,"Olympia-Lacey-Tumwater, WA MSA",2021,4,138171,130581,7590,5.5
MT5342660000000,53,42660,"Seattle-Tacoma-Bellevue, WA MSA",2021,4,2151037,2032187,118850,5.5
MT5344060000000,53,44060,"Spokane-Spokane Valley, WA MSA",2021,4,279117,263663,15454,5.5
MT5347460000000,53,47460,"Walla Walla, WA MSA",2021,4,30017,28548,1469,4.9
MT5348300000000,53,48300,"Wenatchee-East Wenatchee, WA MSA",2021,4,63026,59424,3602,5.7
MT5349420000000,53,49420,"Yakima, WA MSA",2021,4,128402,119346,9056,7.1
MT5413220000000,54,13220,"Beckley, WV MSA",2021,4,45113,42142,2971,6.6
MT5416620000000,54,16620,"Charleston, WV MSA",2021,4,90171,84412,5759,6.4
MT5426580000000,54,26580,"Huntington-Ashland, WV-KY-OH MSA",2021,4,152457,143763,8694,5.7
MT5434060000000,54,34060,"Morgantown, WV MSA",2021,4,69431,66249,3182,4.6
MT5437620000000,54,37620,"Parkersburg-Vienna, WV MSA",2021,4,38888,36485,2403,6.2
MT5448540000000,54,48540,"Wheeling, WV-OH MSA",2021,4,59984,55903,4081,6.8
MT5511540000000,55,11540,"Appleton, WI MSA",2021,4,134259,129744,4515,3.4
MT5520740000000,55,20740,"Eau Claire, WI MSA",2021,4,92437,88796,3641,3.9
MT5522540000000,55,22540,"Fond du Lac, WI MSA",2021,4,56139,54080,2059,3.7
MT5524580000000,55,24580,"Green Bay, WI MSA",2021,4,175088,168539,6549,3.7
MT5527500000000,55,27500,"Janesville-Beloit, WI MSA",2021,4,84406,80137,4269,5.1
MT5528450000000,55,28450,"Kenosha, WI MSA",2021,4,92152,87848,4304,4.7
MT5529100000000,55,29100,"La Crosse-Onalaska, WI-MN MSA",2021,4,88334,85199,3135,3.5
MT5531540000000,55,31540,"Madison, WI MSA",2021,4,391245,378263,12982,3.3
MT5533340000000,55,33340,"Milwaukee-Waukesha, WI MSA",2021,4,811302,770940,40362,5
MT5536780000000,55,36780,"Oshkosh-Neenah, WI MSA",2021,4,91719,88444,3275,3.6
MT5539540000000,55,39540,"Racine-Mount Pleasant, WI MSA",2021,4,99955,94758,5197,5.2
MT5543100000000,55,43100,"Sheboygan, WI MSA",2021,4,62344,60184,2160,3.5
MT5548140000000,55,48140,"Wausau, WI MSA",2021,4,74686,72264,2422,3.2
MT5616220000000,56,16220,"Casper, WY MSA",2021,4,41382,38567,2815,6.8
MT5616940000000,56,16940,"Cheyenne, WY MSA",2021,4,48858,46599,2259,4.6
MT7210380000000,72,10380,"Aguadilla, PR MSA",2021,4,80244,73185,7059,8.8
MT7211640000000,72,11640,"Arecibo, PR MSA",2021,4,61825,57226,4599,7.4
MT7225020000000,72,25020,"Guayama, PR MSA",2021,4,18906,17086,1820,9.6
MT7232420000000,72,32420,"Mayaguez, PR MSA",2021,4,63597,57615,5982,9.4
MT7238660000000,72,38660,"Ponce, PR MSA",2021,4,85997,77332,8665,10.1
MT7241980000000,72,41980,"San Juan-Bayamon-Caguas, PR MSA",2021,4,779090,719289,59801,7.7
MT0111500000000,1,11500,"Anniston-Oxford, AL MSA",2021,5,49600,47611,1989,4
MT0112220000000,1,12220,"Auburn-Opelika, AL MSA",2021,5,89654,86899,2755,3.1
MT0113820000000,1,13820,"Birmingham, AL MSA",2021,5,550851,532624,18227,3.3
MT0119300000000,1,19300,"Daphne-Fairhope-Foley, AL MSA",2021,5,106451,103271,3180,3
MT0119460000000,1,19460,"Decatur, AL MSA",2021,5,71249,69203,2046,2.9
MT0120020000000,1,20020,"Dothan, AL MSA",2021,5,65315,63082,2233,3.4
MT0122520000000,1,22520,"Florence-Muscle Shoals, AL MSA",2021,5,66275,63869,2406,3.6
MT0123460000000,1,23460,"Gadsden, AL MSA",2021,5,41346,39683,1663,4
MT0126620000000,1,26620,"Huntsville, AL MSA",2021,5,248604,242087,6517,2.6
MT0133660000000,1,33660,"Mobile, AL MSA",2021,5,182817,173412,9405,5.1
MT0133860000000,1,33860,"Montgomery, AL MSA",2021,5,171388,163783,7605,4.4
MT0146220000000,1,46220,"Tuscaloosa, AL MSA",2021,5,119218,114501,4717,4
MT0211260000000,2,11260,"Anchorage, AK MSA",2021,5,196645,183382,13263,6.7
MT0221820000000,2,21820,"Fairbanks-College, AK MSA",2021,5,44724,42284,2440,5.5
MT0422380000000,4,22380,"Flagstaff, AZ MSA",2021,5,70398,65443,4955,7
MT0429420000000,4,29420,"Lake Havasu City-Kingman, AZ MSA",2021,5,84955,79388,5567,6.6
MT0438060000000,4,38060,"Phoenix-Mesa-Chandler, AZ MSA",2021,5,2524714,2392803,131911,5.2
MT0439150000000,4,39150,"Prescott Valley-Prescott, AZ MSA",2021,5,100725,95704,5021,5
MT0443420000000,4,43420,"Sierra Vista-Douglas, AZ MSA",2021,5,47676,45058,2618,5.5
MT0446060000000,4,46060,"Tucson, AZ MSA",2021,5,483986,456359,27627,5.7
MT0449740000000,4,49740,"Yuma, AZ MSA",2021,5,94289,81402,12887,13.7
MT0522220000000,5,22220,"Fayetteville-Springdale-Rogers, AR MSA",2021,5,274142,265328,8814,3.2
MT0522900000000,5,22900,"Fort Smith, AR-OK MSA",2021,5,98908,94838,4070,4.1
MT0526300000000,5,26300,"Hot Springs, AR MSA",2021,5,43216,40972,2244,5.2
MT0527860000000,5,27860,"Jonesboro, AR MSA",2021,5,62940,60510,2430,3.9
MT0530780000000,5,30780,"Little Rock-North Little Rock-Conway, AR MSA",2021,5,352967,336780,16187,4.6
MT0612540000000,6,12540,"Bakersfield-Delano, CA MSA",2021,5,387175,345663,41512,10.7
MT0617020000000,6,17020,"Chico, CA MSA",2021,5,90287,83439,6848,7.6
MT0620940000000,6,20940,"El Centro, CA MSA",2021,5,67579,54401,13178,19.5
MT0623420000000,6,23420,"Fresno, CA MSA",2021,5,501113,452458,48655,9.7
MT0625260000000,6,25260,"Hanford-Corcoran, CA MSA",2021,5,53950,48066,5884,10.9
MT0631080000000,6,31080,"Los Angeles-Long Beach-Anaheim, CA MSA",2021,5,6568824,5964558,604266,9.2
MT0632900000000,6,32900,"Merced, CA MSA",2021,5,114529,102198,12331,10.8
MT0633700000000,6,33700,"Modesto, CA MSA",2021,5,243283,221503,21780,9
MT0634900000000,6,34900,"Napa, CA MSA",2021,5,68619,64069,4550,6.6
MT0637100000000,6,37100,"Oxnard-Thousand Oaks-Ventura, CA MSA",2021,5,406543,378443,28100,6.9
MT0639820000000,6,39820,"Redding, CA MSA",2021,5,76418,70902,5516,7.2
MT0640140000000,6,40140,"Riverside-San Bernardino-Ontario, CA MSA",2021,5,2106483,1932805,173678,8.2
MT0640900000000,6,40900,"Sacramento-Roseville-Folsom, CA MSA",2021,5,1124561,1046122,78439,7
MT0641500000000,6,41500,"Salinas, CA MSA",2021,5,208781,189810,18971,9.1
MT0641740000000,6,41740,"San Diego-Chula Vista-Carlsbad, CA MSA",2021,5,1565254,1454729,110525,7.1
MT0641860000000,6,41860,"San Francisco-Oakland-Fremont, CA MSA",2021,5,2432104,2279300,152804,6.3
MT0641940000000,6,41940,"San Jose-Sunnyvale-Santa Clara, CA MSA",2021,5,1016926,960647,56279,5.5
MT0642020000000,6,42020,"San Luis Obispo-Paso Robles, CA MSA",2021,5,129388,121526,7862,6.1
MT0642100000000,6,42100,"Santa Cruz-Watsonville, CA MSA",2021,5,132738,123092,9646,7.3
MT0642200000000,6,42200,"Santa Maria-Santa Barbara, CA MSA",2021,5,214736,200940,13796,6.4
MT0642220000000,6,42220,"Santa Rosa-Petaluma, CA MSA",2021,5,240220,225373,14847,6.2
MT0644700000000,6,44700,"Stockton-Lodi, CA MSA",2021,5,348638,316657,31981,9.2
MT0646700000000,6,46700,"Vallejo, CA MSA",2021,5,208230,191732,16498,7.9
MT0647300000000,6,47300,"Visalia, CA MSA",2021,5,202233,179027,23206,11.5
MT0649700000000,6,49700,"Yuba City, CA MSA",2021,5,76697,69443,7254,9.5
MT0814500000000,8,14500,"Boulder, CO MSA",2021,5,188614,178971,9643,5.1
MT0817820000000,8,17820,"Colorado Springs, CO MSA",2021,5,376255,353398,22857,6.1
MT0819740000000,8,19740,"Denver-Aurora-Centennial, CO MSA",2021,5,1706685,1603516,103169,6
MT0822660000000,8,22660,"Fort Collins-Loveland, CO MSA",2021,5,198569,187759,10810,5.4
MT0824300000000,8,24300,"Grand Junction, CO MSA",2021,5,78711,73738,4973,6.3
MT0824540000000,8,24540,"Greeley, CO MSA",2021,5,166802,156109,10693,6.4
MT0839380000000,8,39380,"Pueblo, CO MSA",2021,5,75470,68752,6718,8.9
MT0914860000000,9,14860,"Bridgeport-Stamford-Danbury, CT MSA",2021,5,471447,440460,30987,6.6
MT0925540000000,9,25540,"Hartford-West Hartford-East Hartford, CT MSA",2021,5,581385,539908,41477,7.1
MT0935300000000,9,35300,"New Haven, CT MSA",2021,5,293398,272376,21022,7.2
MT0935980000000,9,35980,"Norwich-New London-Willimantic, CT MSA",2021,5,133441,122836,10605,7.9
MT0947930000000,9,47930,"Waterbury-Shelton, CT MSA",2021,5,227040,209303,17737,7.8
MT1020100000000,10,20100,"Dover, DE MSA",2021,5,85471,79987,5484,6.4
MT1147900000000,11,47900,"Washington-Arlington-Alexandria, DC-VA-MD-WV MSA",2021,5,3374421,3208120,166301,4.9
MT1215980000000,12,15980,"Cape Coral-Fort Myers, FL MSA",2021,5,346062,329743,16319,4.7
MT1218880000000,12,18880,"Crestview-Fort Walton Beach-Destin, FL MSA",2021,5,133975,129009,4966,3.7
MT1219660000000,12,19660,"Deltona-Daytona Beach-Ormond Beach, FL MSA",2021,5,296106,280676,15430,5.2
MT1223540000000,12,23540,"Gainesville, FL MSA",2021,5,162199,155291,6908,4.3
MT1226140000000,12,26140,"Homosassa Springs, FL MSA",2021,5,50407,47407,3000,6
MT1227260000000,12,27260,"Jacksonville, FL MSA",2021,5,792053,757033,35020,4.4
MT1229460000000,12,29460,"Lakeland-Winter Haven, FL MSA",2021,5,333345,313976,19369,5.8
MT1233100000000,12,33100,"Miami-Fort Lauderdale-West Palm Beach, FL MSA",2021,5,3054342,2883364,170978,5.6
MT1234940000000,12,34940,"Naples-Marco Island, FL MSA",2021,5,166881,159637,7244,4.3
MT1235840000000,12,35840,"North Port-Bradenton-Sarasota, FL MSA",2021,5,359391,343556,15835,4.4
MT1236100000000,12,36100,"Ocala, FL MSA",2021,5,145988,138221,7767,5.3
MT1236740000000,12,36740,"Orlando-Kissimmee-Sanford, FL MSA",2021,5,1349212,1275463,73749,5.5
MT1237340000000,12,37340,"Palm Bay-Melbourne-Titusville, FL MSA",2021,5,287650,274861,12789,4.4
MT1237460000000,12,37460,"Panama City-Panama City Beach, FL MSA",2021,5,95116,90895,4221,4.4
MT1237860000000,12,37860,"Pensacola-Ferry Pass-Brent, FL MSA",2021,5,229034,218602,10432,4.6
MT1238940000000,12,38940,"Port St. Lucie, FL MSA",2021,5,221552,210600,10952,4.9
MT1239460000000,12,39460,"Punta Gorda, FL MSA",2021,5,68597,65101,3496,5.1
MT1242680000000,12,42680,"Sebastian-Vero Beach-West Vero Corridor, FL MSA",2021,5,62450,59083,3367,5.4
MT1242700000000,12,42700,"Sebring, FL MSA",2021,5,34260,32045,2215,6.5
MT1245220000000,12,45220,"Tallahassee, FL MSA",2021,5,193663,184826,8837,4.6
MT1245300000000,12,45300,"Tampa-St. Petersburg-Clearwater, FL MSA",2021,5,1565849,1492734,73115,4.7
MT1248680000000,12,48680,"Wildwood-The Villages, FL MSA",2021,5,29571,27558,2013,6.8
MT1310500000000,13,10500,"Albany, GA MSA",2021,5,64072,60377,3695,5.8
MT1312020000000,13,12020,"Athens-Clarke County, GA MSA",2021,5,102697,99236,3461,3.4
MT1312060000000,13,12060,"Atlanta-Sandy Springs-Roswell, GA MSA",2021,5,3120496,2990398,130098,4.2
MT1312260000000,13,12260,"Augusta-Richmond County, GA-SC MSA",2021,5,265036,253952,11084,4.2
MT1315260000000,13,15260,"Brunswick-St. Simons, GA MSA",2021,5,51391,49340,2051,4
MT1317980000000,13,17980,"Columbus, GA-AL MSA",2021,5,130992,124939,6053,4.6
MT1319140000000,13,19140,"Dalton, GA MSA",2021,5,66170,63589,2581,3.9
MT1323580000000,13,23580,"Gainesville, GA MSA",2021,5,99991,97094,2897,2.9
MT1325980000000,13,25980,"Hinesville, GA MSA",2021,5,30823,29479,1344,4.4
MT1331420000000,13,31420,"Macon-Bibb County, GA MSA",2021,5,99433,94508,4925,5
MT1340660000000,13,40660,"Rome, GA MSA",2021,5,43704,42014,1690,3.9
MT1342340000000,13,42340,"Savannah, GA MSA",2021,5,199847,191462,8385,4.2
MT1346660000000,13,46660,"Valdosta, GA MSA",2021,5,62077,59323,2754,4.4
MT1347580000000,13,47580,"Warner Robins, GA MSA",2021,5,88833,85414,3419,3.8
MT1527980000000,15,27980,"Kahului-Wailuku, HI MSA",2021,5,83763,76138,7625,9.1
MT1546520000000,15,46520,"Urban Honolulu, HI MSA",2021,5,466328,437286,29042,6.2
MT1614260000000,16,14260,"Boise City, ID MSA",2021,5,407186,392020,15166,3.7
MT1617660000000,16,17660,"Coeur d'Alene, ID MSA",2021,5,84635,80739,3896,4.6
MT1626820000000,16,26820,"Idaho Falls, ID MSA",2021,5,77144,74736,2408,3.1
MT1630300000000,16,30300,"Lewiston, ID-WA MSA",2021,5,30194,29061,1133,3.8
MT1638540000000,16,38540,"Pocatello, ID MSA",2021,5,38132,36483,1649,4.3
MT1646300000000,16,46300,"Twin Falls, ID MSA",2021,5,57817,55703,2114,3.7
MT1714010000000,17,14010,"Bloomington, IL MSA",2021,5,87876,83684,4192,4.8
MT1716580000000,17,16580,"Champaign-Urbana, IL MSA",2021,5,121280,114987,6293,5.2
MT1716980000000,17,16980,"Chicago-Naperville-Elgin, IL-IN MSA",2021,5,4726093,4401747,324346,6.9
MT1719340000000,17,19340,"Davenport-Moline-Rock Island, IA-IL MSA",2021,5,188763,177925,10838,5.7
MT1719500000000,17,19500,"Decatur, IL MSA",2021,5,46057,42309,3748,8.1
MT1728100000000,17,28100,"Kankakee, IL MSA",2021,5,51319,47672,3647,7.1
MT1737900000000,17,37900,"Peoria, IL MSA",2021,5,173029,162071,10958,6.3
MT1740420000000,17,40420,"Rockford, IL MSA",2021,5,161613,146725,14888,9.2
MT1744100000000,17,44100,"Springfield, IL MSA",2021,5,100831,94655,6176,6.1
MT1814020000000,18,14020,"Bloomington, IN MSA",2021,5,83248,80627,2621,3.1
MT1818020000000,18,18020,"Columbus, IN MSA",2021,5,38528,37081,1447,3.8
MT1821140000000,18,21140,"Elkhart-Goshen, IN MSA",2021,5,104926,101428,3498,3.3
MT1821780000000,18,21780,"Evansville, IN MSA",2021,5,133605,128336,5269,3.9
MT1823060000000,18,23060,"Fort Wayne, IN MSA",2021,5,224363,215468,8895,4
MT1826900000000,18,26900,"Indianapolis-Carmel-Greenwood, IN MSA",2021,5,1074078,1029796,44282,4.1
MT1829020000000,18,29020,"Kokomo, IN MSA",2021,5,37000,34994,2006,5.4
MT1829200000000,18,29200,"Lafayette-West Lafayette, IN MSA",2021,5,113064,108963,4101,3.6
MT1833140000000,18,33140,"Michigan City-La Porte, IN MSA",2021,5,50360,47547,2813,5.6
MT1834620000000,18,34620,"Muncie, IN MSA",2021,5,51814,49473,2341,4.5
MT1843780000000,18,43780,"South Bend-Mishawaka, IN-MI MSA",2021,5,153667,145835,7832,5.1
MT1845460000000,18,45460,"Terre Haute, IN MSA",2021,5,76805,73359,3446,4.5
MT1911180000000,19,11180,"Ames, IA MSA",2021,5,67551,65331,2220,3.3
MT1916300000000,19,16300,"Cedar Rapids, IA MSA",2021,5,148339,140835,7504,5.1
MT1919780000000,19,19780,"Des Moines-West Des Moines, IA MSA",2021,5,387460,370366,17094,4.4
MT1920220000000,19,20220,"Dubuque, IA MSA",2021,5,53044,50576,2468,4.7
MT1926980000000,19,26980,"Iowa City, IA MSA",2021,5,96850,92995,3855,4
MT1943580000000,19,43580,"Sioux City, IA-NE-SD MSA",2021,5,74888,71710,3178,4.2
MT1947940000000,19,47940,"Waterloo-Cedar Falls, IA MSA",2021,5,88712,84926,3786,4.3
MT2029940000000,20,29940,"Lawrence, KS MSA",2021,5,67339,65105,2234,3.3
MT2031740000000,20,31740,"Manhattan, KS MSA",2021,5,61818,59885,1933,3.1
MT2045820000000,20,45820,"Topeka, KS MSA",2021,5,116289,112185,4104,3.5
MT2048620000000,20,48620,"Wichita, KS MSA",2021,5,324858,309100,15758,4.9
MT2114540000000,21,14540,"Bowling Green, KY MSA",2021,5,86135,82678,3457,4
MT2121060000000,21,21060,"Elizabethtown, KY MSA",2021,5,53013,50544,2469,4.7
MT2130460000000,21,30460,"Lexington-Fayette, KY MSA",2021,5,261145,250990,10155,3.9
MT2131140000000,21,31140,"Louisville/Jefferson County, KY-IN MSA",2021,5,674163,645529,28634,4.2
MT2136980000000,21,36980,"Owensboro, KY MSA",2021,5,50781,48653,2128,4.2
MT2137140000000,21,37140,"Paducah, KY-IL MSA",2021,5,44747,42488,2259,5
MT2210780000000,22,10780,"Alexandria, LA MSA",2021,5,64848,61991,2857,4.4
MT2212940000000,22,12940,"Baton Rouge, LA MSA",2021,5,413828,389606,24222,5.9
MT2225220000000,22,25220,"Hammond, LA MSA",2021,5,58696,54683,4013,6.8
MT2226380000000,22,26380,"Houma-Bayou Cane-Thibodaux, LA MSA",2021,5,88000,83279,4721,5.4
MT2229180000000,22,29180,"Lafayette, LA MSA",2021,5,192408,182347,10061,5.2
MT2229340000000,22,29340,"Lake Charles, LA MSA",2021,5,102571,95613,6958,6.8
MT2233740000000,22,33740,"Monroe, LA MSA",2021,5,95536,89681,5855,6.1
MT2235380000000,22,35380,"New Orleans-Metairie, LA MSA",2021,5,466207,432534,33673,7.2
MT2243340000000,22,43340,"Shreveport-Bossier City, LA MSA",2021,5,166179,155936,10243,6.2
MT2243640000000,22,43640,"Slidell-Mandeville-Covington, LA MSA",2021,5,123018,117888,5130,4.2
MT2312620000000,23,12620,"Bangor, ME MSA",2021,5,73396,69394,4002,5.5
MT2330340000000,23,30340,"Lewiston-Auburn, ME MSA",2021,5,55521,52478,3043,5.5
MT2338860000000,23,38860,"Portland-South Portland, ME MSA",2021,5,302993,288898,14095,4.7
MT2412580000000,24,12580,"Baltimore-Columbia-Towson, MD MSA",2021,5,1448377,1369523,78854,5.4
MT2425180000000,24,25180,"Hagerstown-Martinsburg, MD-WV MSA",2021,5,140747,134153,6594,4.7
MT2430500000000,24,30500,"Lexington Park, MD MSA",2021,5,105160,100536,4624,4.4
MT2441540000000,24,41540,"Salisbury, MD MSA",2021,5,60718,56968,3750,6.2
MT2511200000000,25,11200,"Amherst Town-Northampton, MA MSA",2021,5,82520,78377,4143,5
MT2512700000000,25,12700,"Barnstable Town, MA MSA",2021,5,112628,105111,7517,6.7
MT2514460000000,25,14460,"Boston-Cambridge-Newton, MA-NH MSA",2021,5,2697189,2556916,140273,5.2
MT2538340000000,25,38340,"Pittsfield, MA MSA",2021,5,62914,58777,4137,6.6
MT2544140000000,25,44140,"Springfield, MA MSA",2021,5,225582,208953,16629,7.4
MT2549340000000,25,49340,"Worcester, MA MSA",2021,5,447367,421730,25637,5.7
MT2611460000000,26,11460,"Ann Arbor, MI MSA",2021,5,190823,182312,8511,4.5
MT2612980000000,26,12980,"Battle Creek, MI MSA",2021,5,58539,54480,4059,6.9
MT2613020000000,26,13020,"Bay City, MI MSA",2021,5,47115,44132,2983,6.3
MT2619820000000,26,19820,"Detroit-Warren-Dearborn, MI MSA",2021,5,2099929,1962091,137838,6.6
MT2622420000000,26,22420,"Flint, MI MSA",2021,5,176768,163445,13323,7.5
MT2624340000000,26,24340,"Grand Rapids-Wyoming-Kentwood, MI MSA",2021,5,578532,549856,28676,5
MT2627100000000,26,27100,"Jackson, MI MSA",2021,5,70652,66307,4345,6.1
MT2628020000000,26,28020,"Kalamazoo-Portage, MI MSA",2021,5,129582,122900,6682,5.2
MT2629620000000,26,29620,"Lansing-East Lansing, MI MSA",2021,5,230128,217418,12710,5.5
MT2633220000000,26,33220,"Midland, MI MSA",2021,5,38119,36208,1911,5
MT2633780000000,26,33780,"Monroe, MI MSA",2021,5,71583,66778,4805,6.7
MT2634740000000,26,34740,"Muskegon-Norton Shores, MI MSA",2021,5,79086,73172,5914,7.5
MT2635660000000,26,35660,"Niles, MI MSA",2021,5,71037,66842,4195,5.9
MT2640980000000,26,40980,"Saginaw, MI MSA",2021,5,81395,75465,5930,7.3
MT2645900000000,26,45900,"Traverse City, MI MSA",2021,5,74806,70695,4111,5.5
MT2720260000000,27,20260,"Duluth, MN-WI MSA",2021,5,136929,130918,6011,4.4
MT2731860000000,27,31860,"Mankato, MN MSA",2021,5,57839,55819,2020,3.5
MT2733460000000,27,33460,"Minneapolis-St. Paul-Bloomington, MN-WI MSA",2021,5,2008155,1930671,77484,3.9
MT2740340000000,27,40340,"Rochester, MN MSA",2021,5,123818,119738,4080,3.3
MT2741060000000,27,41060,"St. Cloud, MN MSA",2021,5,107615,102921,4694,4.4
MT2825060000000,28,25060,"Gulfport-Biloxi, MS MSA",2021,5,182720,172110,10610,5.8
MT2825620000000,28,25620,"Hattiesburg, MS MSA",2021,5,69344,65502,3842,5.5
MT2827140000000,28,27140,"Jackson, MS MSA",2021,5,275323,259841,15482,5.6
MT2916020000000,29,16020,"Cape Girardeau, MO-IL MSA",2021,5,47429,45603,1826,3.8
MT2917860000000,29,17860,"Columbia, MO MSA",2021,5,111323,107984,3339,3
MT2927620000000,29,27620,"Jefferson City, MO MSA",2021,5,72832,70550,2282,3.1
MT2927900000000,29,27900,"Joplin, MO-KS MSA",2021,5,94176,90678,3498,3.7
MT2928140000000,29,28140,"Kansas City, MO-KS MSA",2021,5,1153254,1097032,56222,4.9
MT2941140000000,29,41140,"St. Joseph, MO-KS MSA",2021,5,55861,53618,2243,4
MT2941180000000,29,41180,"St. Louis, MO-IL MSA",2021,5,1441695,1371492,70203,4.9
MT2944180000000,29,44180,"Springfield, MO MSA",2021,5,231156,222925,8231,3.6
MT3013740000000,30,13740,"Billings, MT MSA",2021,5,95364,92111,3253,3.4
MT3014580000000,30,14580,"Bozeman, MT MSA",2021,5,70779,68823,1956,2.8
MT3024500000000,30,24500,"Great Falls, MT MSA",2021,5,38447,37067,1380,3.6
MT3025740000000,30,25740,"Helena, MT MSA",2021,5,44922,43429,1493,3.3
MT3033540000000,30,33540,"Missoula, MT MSA",2021,5,70148,67725,2423,3.5
MT3124260000000,31,24260,"Grand Island, NE MSA",2021,5,40726,39480,1246,3.1
MT3130700000000,31,30700,"Lincoln, NE MSA",2021,5,186211,181127,5084,2.7
MT3136540000000,31,36540,"Omaha, NE-IA MSA",2021,5,509966,493228,16738,3.3
MT3216180000000,32,16180,"Carson City, NV MSA",2021,5,28215,26931,1284,4.6
MT3229820000000,32,29820,"Las Vegas-Henderson-North Las Vegas, NV MSA",2021,5,1089107,997094,92013,8.4
MT3239900000000,32,39900,"Reno, NV MSA",2021,5,284941,272210,12731,4.5
MT3331700000000,33,31700,"Manchester-Nashua, NH MSA",2021,5,235608,226388,9220,3.9
MT3412100000000,34,12100,"Atlantic City-Hammonton, NJ MSA",2021,5,178533,160242,18291,10.2
MT3445940000000,34,45940,"Trenton-Princeton, NJ MSA",2021,5,192859,180468,12391,6.4
MT3447220000000,34,47220,"Vineland, NJ MSA",2021,5,65164,59220,5944,9.1
MT3510740000000,35,10740,"Albuquerque, NM MSA",2021,5,439457,408157,31300,7.1
MT3522140000000,35,22140,"Farmington, NM MSA",2021,5,47804,43372,4432,9.3
MT3529740000000,35,29740,"Las Cruces, NM MSA",2021,5,96154,88909,7245,7.5
MT3542140000000,35,42140,"Santa Fe, NM MSA",2021,5,72447,67307,5140,7.1
MT3610580000000,36,10580,"Albany-Schenectady-Troy, NY MSA",2021,5,449062,427139,21923,4.9
MT3613780000000,36,13780,"Binghamton, NY MSA",2021,5,106444,100519,5925,5.6
MT3615380000000,36,15380,"Buffalo-Cheektowaga, NY MSA",2021,5,556630,523539,33091,5.9
MT3621300000000,36,21300,"Elmira, NY MSA",2021,5,36103,34062,2041,5.7
MT3624020000000,36,24020,"Glens Falls, NY MSA",2021,5,60044,56869,3175,5.3
MT3627060000000,36,27060,"Ithaca, NY MSA",2021,5,49117,47064,2053,4.2
MT3628740000000,36,28740,"Kingston, NY MSA",2021,5,85451,80897,4554,5.3
MT3628880000000,36,28880,"Kiryas Joel-Poughkeepsie-Newburgh, NY MSA",2021,5,326014,309009,17005,5.2
MT3635620000000,36,35620,"New York-Newark-Jersey City, NY-NJ MSA",2021,5,9748859,8928250,820609,8.4
MT3640380000000,36,40380,"Rochester, NY MSA",2021,5,510663,482466,28197,5.5
MT3645060000000,36,45060,"Syracuse, NY MSA",2021,5,310000,292913,17087,5.5
MT3646540000000,36,46540,"Utica-Rome, NY MSA",2021,5,129876,122435,7441,5.7
MT3648060000000,36,48060,"Watertown-Fort Drum, NY MSA",2021,5,44709,42169,2540,5.7
MT3711700000000,37,11700,"Asheville, NC MSA",2021,5,194922,185802,9120,4.7
MT3715500000000,37,15500,"Burlington, NC MSA",2021,5,79782,75602,4180,5.2
MT3716740000000,37,16740,"Charlotte-Concord-Gastonia, NC-SC MSA",2021,5,1354645,1286373,68272,5
MT3720500000000,37,20500,"Durham-Chapel Hill, NC MSA",2021,5,295359,282226,13133,4.4
MT3722180000000,37,22180,"Fayetteville, NC MSA",2021,5,148469,138034,10435,7
MT3724140000000,37,24140,"Goldsboro, NC MSA",2021,5,48718,46090,2628,5.4
MT3724660000000,37,24660,"Greensboro-High Point, NC MSA",2021,5,358106,337258,20848,5.8
MT3724780000000,37,24780,"Greenville, NC MSA",2021,5,78517,74019,4498,5.7
MT3725860000000,37,25860,"Hickory-Lenoir-Morganton, NC MSA",2021,5,163949,155428,8521,5.2
MT3727340000000,37,27340,"Jacksonville, NC MSA",2021,5,68176,64636,3540,5.2
MT3738240000000,37,38240,"Pinehurst-Southern Pines, NC MSA",2021,5,40748,38775,1973,4.8
MT3739580000000,37,39580,"Raleigh-Cary, NC MSA",2021,5,747041,714900,32141,4.3
MT3740580000000,37,40580,"Rocky Mount, NC MSA",2021,5,63062,58475,4587,7.3
MT3748900000000,37,48900,"Wilmington, NC MSA",2021,5,198921,188500,10421,5.2
MT3749180000000,37,49180,"Winston-Salem, NC MSA",2021,5,310488,294159,16329,5.3
MT3813900000000,38,13900,"Bismarck, ND MSA",2021,5,72081,69946,2135,3
MT3822020000000,38,22020,"Fargo, ND-MN MSA",2021,5,145871,141708,4163,2.9
MT3824220000000,38,24220,"Grand Forks, ND-MN MSA",2021,5,54183,52360,1823,3.4
MT3833500000000,38,33500,"Minot, ND MSA",2021,5,39168,37749,1419,3.6
MT3910420000000,39,10420,"Akron, OH MSA",2021,5,353307,332236,21071,6
MT3915940000000,39,15940,"Canton-Massillon, OH MSA",2021,5,192275,180356,11919,6.2
MT3917140000000,39,17140,"Cincinnati, OH-KY-IN MSA",2021,5,1127316,1072289,55027,4.9
MT3917410000000,39,17410,"Cleveland, OH MSA",2021,5,1061391,996882,64509,6.1
MT3918140000000,39,18140,"Columbus, OH MSA",2021,5,1109991,1049965,60026,5.4
MT3919430000000,39,19430,"Dayton-Kettering-Beavercreek, OH MSA",2021,5,383035,360323,22712,5.9
MT3930620000000,39,30620,"Lima, OH MSA",2021,5,48071,45352,2719,5.7
MT3931900000000,39,31900,"Mansfield, OH MSA",2021,5,52932,49602,3330,6.3
MT3941780000000,39,41780,"Sandusky, OH MSA",2021,5,56292,52728,3564,6.3
MT3944220000000,39,44220,"Springfield, OH MSA",2021,5,61229,57338,3891,6.4
MT3945780000000,39,45780,"Toledo, OH MSA",2021,5,291650,272036,19614,6.7
MT3948260000000,39,48260,"Weirton-Steubenville, WV-OH MSA",2021,5,52653,49280,3373,6.4
MT3949660000000,39,49660,"Youngstown-Warren, OH MSA",2021,5,188554,175205,13349,7.1
MT4021420000000,40,21420,"Enid, OK MSA",2021,5,28272,27226,1046,3.7
MT4030020000000,40,30020,"Lawton, OK MSA",2021,5,50884,48833,2051,4
MT4036420000000,40,36420,"Oklahoma City, OK MSA",2021,5,710259,679479,30780,4.3
MT4046140000000,40,46140,"Tulsa, OK MSA",2021,5,489855,468032,21823,4.5
MT4110540000000,41,10540,"Albany, OR MSA",2021,5,60509,56827,3682,6.1
MT4113460000000,41,13460,"Bend, OR MSA",2021,5,125868,118451,7417,5.9
MT4118700000000,41,18700,"Corvallis, OR MSA",2021,5,46738,44699,2039,4.4
MT4121660000000,41,21660,"Eugene-Springfield, OR MSA",2021,5,185222,174246,10976,5.9
MT4124420000000,41,24420,"Grants Pass, OR MSA",2021,5,35696,33219,2477,6.9
MT4132780000000,41,32780,"Medford, OR MSA",2021,5,106281,100006,6275,5.9
MT4138900000000,41,38900,"Portland-Vancouver-Hillsboro, OR-WA MSA",2021,5,1348861,1275903,72958,5.4
MT4141420000000,41,41420,"Salem, OR MSA",2021,5,212004,200583,11421,5.4
MT4210900000000,42,10900,"Allentown-Bethlehem-Easton, PA-NJ MSA",2021,5,440517,411594,28923,6.6
MT4211020000000,42,11020,"Altoona, PA MSA",2021,5,57599,54069,3530,6.1
MT4216540000000,42,16540,"Chambersburg, PA MSA",2021,5,76140,72141,3999,5.3
MT4221500000000,42,21500,"Erie, PA MSA",2021,5,126762,117568,9194,7.3
MT4223900000000,42,23900,"Gettysburg, PA MSA",2021,5,51663,49268,2395,4.6
MT4225420000000,42,25420,"Harrisburg-Carlisle, PA MSA",2021,5,301696,285260,16436,5.4
MT4227780000000,42,27780,"Johnstown, PA MSA",2021,5,57305,53356,3949,6.9
MT4229540000000,42,29540,"Lancaster, PA MSA",2021,5,284434,270531,13903,4.9
MT4230140000000,42,30140,"Lebanon, PA MSA",2021,5,70640,66677,3963,5.6
MT4237980000000,42,37980,"Philadelphia-Camden-Wilmington, PA-NJ-DE-MD MSA",2021,5,3177558,2970634,206924,6.5
MT4238300000000,42,38300,"Pittsburgh, PA MSA",2021,5,1226299,1147733,78566,6.4
MT4239740000000,42,39740,"Reading, PA MSA",2021,5,212775,198882,13893,6.5
MT4242540000000,42,42540,"Scranton--Wilkes-Barre, PA MSA",2021,5,272920,252480,20440,7.5
MT4244300000000,42,44300,"State College, PA MSA",2021,5,73629,70294,3335,4.5
MT4248700000000,42,48700,"Williamsport, PA MSA",2021,5,52927,49184,3743,7.1
MT4249620000000,42,49620,"York-Hanover, PA MSA",2021,5,233415,220571,12844,5.5
MT4439300000000,44,39300,"Providence-Warwick, RI-MA MSA",2021,5,866478,814115,52363,6
MT4516700000000,45,16700,"Charleston-North Charleston, SC MSA",2021,5,395753,381135,14618,3.7
MT4517900000000,45,17900,"Columbia, SC MSA",2021,5,394186,379063,15123,3.8
MT4522500000000,45,22500,"Florence, SC MSA",2021,5,88777,84620,4157,4.7
MT4524860000000,45,24860,"Greenville-Anderson-Greer, SC MSA",2021,5,441868,425886,15982,3.6
MT4525940000000,45,25940,"Hilton Head Island-Bluffton-Port Royal, SC MSA",2021,5,91241,88136,3105,3.4
MT4534820000000,45,34820,"Myrtle Beach-Conway-North Myrtle Beach, SC MSA",2021,5,153858,145903,7955,5.2
MT4543900000000,45,43900,"Spartanburg, SC MSA",2021,5,167274,159955,7319,4.4
MT4544940000000,45,44940,"Sumter, SC MSA",2021,5,42521,40527,1994,4.7
MT4639660000000,46,39660,"Rapid City, SD MSA",2021,5,76616,74459,2157,2.8
MT4643620000000,46,43620,"Sioux Falls, SD-MN MSA",2021,5,164704,160632,4072,2.5
MT4716860000000,47,16860,"Chattanooga, TN-GA MSA",2021,5,270700,259436,11264,4.2
MT4717300000000,47,17300,"Clarksville, TN-KY MSA",2021,5,131873,125333,6540,5
MT4717420000000,47,17420,"Cleveland, TN MSA",2021,5,57618,54916,2702,4.7
MT4727180000000,47,27180,"Jackson, TN MSA",2021,5,78784,74586,4198,5.3
MT4727740000000,47,27740,"Johnson City, TN MSA",2021,5,95721,91696,4025,4.2
MT4728700000000,47,28700,"Kingsport-Bristol, TN-VA MSA",2021,5,128930,122687,6243,4.8
MT4728940000000,47,28940,"Knoxville, TN MSA",2021,5,429892,412681,17211,4
MT4732820000000,47,32820,"Memphis, TN-MS-AR MSA",2021,5,643284,598368,44916,7
MT4734100000000,47,34100,"Morristown, TN MSA",2021,5,52304,49906,2398,4.6
MT4734980000000,47,34980,"Nashville-Davidson--Murfreesboro--Franklin, TN MSA",2021,5,1084559,1038986,45573,4.2
MT4810180000000,48,10180,"Abilene, TX MSA",2021,5,80320,76505,3815,4.7
MT4811100000000,48,11100,"Amarillo, TX MSA",2021,5,130687,125226,5461,4.2
MT4812420000000,48,12420,"Austin-Round Rock-San Marcos, TX MSA",2021,5,1295256,1237660,57596,4.4
MT4813140000000,48,13140,"Beaumont-Port Arthur, TX MSA",2021,5,171110,154662,16448,9.6
MT4815180000000,48,15180,"Brownsville-Harlingen, TX MSA",2021,5,179829,164671,15158,8.4
MT4817780000000,48,17780,"College Station-Bryan, TX MSA",2021,5,134525,128231,6294,4.7
MT4818580000000,48,18580,"Corpus Christi, TX MSA",2021,5,200615,185263,15352,7.7
MT4819100000000,48,19100,"Dallas-Fort Worth-Arlington, TX MSA",2021,5,4052680,3831096,221584,5.5
MT4820580000000,48,20580,"Eagle Pass, TX MSA",2021,5,23491,20329,3162,13.5
MT4821340000000,48,21340,"El Paso, TX MSA",2021,5,383141,358449,24692,6.4
MT4826420000000,48,26420,"Houston-Pasadena-The Woodlands, TX MSA",2021,5,3495697,3259733,235964,6.8
MT4828660000000,48,28660,"Killeen-Temple, TX MSA",2021,5,191979,180906,11073,5.8
MT4829700000000,48,29700,"Laredo, TX MSA",2021,5,110706,103088,7618,6.9
MT4830980000000,48,30980,"Longview, TX MSA",2021,5,124730,116262,8468,6.8
MT4831180000000,48,31180,"Lubbock, TX MSA",2021,5,173280,164483,8797,5.1
MT4832580000000,48,32580,"McAllen-Edinburg-Mission, TX MSA",2021,5,373635,337504,36131,9.7
MT4833260000000,48,33260,"Midland, TX MSA",2021,5,88158,82196,5962,6.8
MT4836220000000,48,36220,"Odessa, TX MSA",2021,5,77556,70578,6978,9
MT4841660000000,48,41660,"San Angelo, TX MSA",2021,5,57726,54936,2790,4.8
MT4841700000000,48,41700,"San Antonio-New Braunfels, TX MSA",2021,5,1215931,1148560,67371,5.5
MT4843300000000,48,43300,"Sherman-Denison, TX MSA",2021,5,65551,62426,3125,4.8
MT4845500000000,48,45500,"Texarkana, TX-AR MSA",2021,5,60854,57173,3681,6
MT4846340000000,48,46340,"Tyler, TX MSA",2021,5,109712,103580,6132,5.6
MT4847020000000,48,47020,"Victoria, TX MSA",2021,5,44105,41186,2919,6.6
MT4847380000000,48,47380,"Waco, TX MSA",2021,5,136254,129087,7167,5.3
MT4848660000000,48,48660,"Wichita Falls, TX MSA",2021,5,65366,61872,3494,5.3
MT4930860000000,49,30860,"Logan, UT-ID MSA",2021,5,76102,74477,1625,2.1
MT4936260000000,49,36260,"Ogden, UT MSA",2021,5,324301,315291,9010,2.8
MT4939340000000,49,39340,"Provo-Orem-Lehi, UT MSA",2021,5,337868,329346,8522,2.5
MT4941100000000,49,41100,"St. George, UT MSA",2021,5,82435,79819,2616,3.2
MT4941620000000,49,41620,"Salt Lake City-Murray, UT MSA",2021,5,681643,660779,20864,3.1
MT5015540000000,50,15540,"Burlington-South Burlington, VT MSA",2021,5,122931,119038,3893,3.2
MT5113980000000,51,13980,"Blacksburg-Christiansburg-Radford, VA MSA",2021,5,86841,83624,3217,3.7
MT5116820000000,51,16820,"Charlottesville, VA MSA",2021,5,110690,106656,4034,3.6
MT5125500000000,51,25500,"Harrisonburg, VA MSA",2021,5,68569,66229,2340,3.4
MT5131340000000,51,31340,"Lynchburg, VA MSA",2021,5,124428,119241,5187,4.2
MT5140060000000,51,40060,"Richmond, VA MSA",2021,5,675277,645335,29942,4.4
MT5140220000000,51,40220,"Roanoke, VA MSA",2021,5,150303,144047,6256,4.2
MT5144420000000,51,44420,"Staunton-Stuarts Draft, VA MSA",2021,5,60989,58796,2193,3.6
MT5147260000000,51,47260,"Virginia Beach-Chesapeake-Norfolk, VA-NC MSA",2021,5,840551,799266,41285,4.9
MT5149020000000,51,49020,"Winchester, VA-WV MSA",2021,5,71673,69175,2498,3.5
MT5313380000000,53,13380,"Bellingham, WA MSA",2021,5,113157,106703,6454,5.7
MT5314740000000,53,14740,"Bremerton-Silverdale-Port Orchard, WA MSA",2021,5,121980,115740,6240,5.1
MT5328420000000,53,28420,"Kennewick-Richland, WA MSA",2021,5,144729,136153,8576,5.9
MT5331020000000,53,31020,"Longview-Kelso, WA MSA",2021,5,47826,44849,2977,6.2
MT5334580000000,53,34580,"Mount Vernon-Anacortes, WA MSA",2021,5,58956,55179,3777,6.4
MT5336500000000,53,36500,"Olympia-Lacey-Tumwater, WA MSA",2021,5,138513,131212,7301,5.3
MT5342660000000,53,42660,"Seattle-Tacoma-Bellevue, WA MSA",2021,5,2154275,2040073,114202,5.3
MT5344060000000,53,44060,"Spokane-Spokane Valley, WA MSA",2021,5,280265,265291,14974,5.3
MT5347460000000,53,47460,"Walla Walla, WA MSA",2021,5,30115,28707,1408,4.7
MT5348300000000,53,48300,"Wenatchee-East Wenatchee, WA MSA",2021,5,63059,59568,3491,5.5
MT5349420000000,53,49420,"Yakima, WA MSA",2021,5,128329,119395,8934,7
MT5413220000000,54,13220,"Beckley, WV MSA",2021,5,45156,42277,2879,6.4
MT5416620000000,54,16620,"Charleston, WV MSA",2021,5,90093,84531,5562,6.2
MT5426580000000,54,26580,"Huntington-Ashland, WV-KY-OH MSA",2021,5,152673,144185,8488,5.6
MT5434060000000,54,34060,"Morgantown, WV MSA",2021,5,69785,66680,3105,4.4
MT5437620000000,54,37620,"Parkersburg-Vienna, WV MSA",2021,5,38920,36598,2322,6
MT5448540000000,54,48540,"Wheeling, WV-OH MSA",2021,5,59835,55811,4024,6.7
MT5511540000000,55,11540,"Appleton, WI MSA",2021,5,134305,129949,4356,3.2
MT5520740000000,55,20740,"Eau Claire, WI MSA",2021,5,92464,89000,3464,3.7
MT5522540000000,55,22540,"Fond du Lac, WI MSA",2021,5,56110,54152,1958,3.5
MT5524580000000,55,24580,"Green Bay, WI MSA",2021,5,175069,168748,6321,3.6
MT5527500000000,55,27500,"Janesville-Beloit, WI MSA",2021,5,84451,80230,4221,5
MT5528450000000,55,28450,"Kenosha, WI MSA",2021,5,91985,87789,4196,4.6
MT5529100000000,55,29100,"La Crosse-Onalaska, WI-MN MSA",2021,5,88476,85481,2995,3.4
MT5531540000000,55,31540,"Madison, WI MSA",2021,5,392475,380000,12475,3.2
MT5533340000000,55,33340,"Milwaukee-Waukesha, WI MSA",2021,5,812600,773476,39124,4.8
MT5536780000000,55,36780,"Oshkosh-Neenah, WI MSA",2021,5,91780,88631,3149,3.4
MT5539540000000,55,39540,"Racine-Mount Pleasant, WI MSA",2021,5,100100,95061,5039,5
MT5543100000000,55,43100,"Sheboygan, WI MSA",2021,5,62237,60148,2089,3.4
MT5548140000000,55,48140,"Wausau, WI MSA",2021,5,74638,72294,2344,3.1
MT5616220000000,56,16220,"Casper, WY MSA",2021,5,41295,38631,2664,6.5
MT5616940000000,56,16940,"Cheyenne, WY MSA",2021,5,48831,46636,2195,4.5
MT7210380000000,72,10380,"Aguadilla, PR MSA",2021,5,81206,73818,7388,9.1
MT7211640000000,72,11640,"Arecibo, PR MSA",2021,5,62356,57588,4768,7.6
MT7225020000000,72,25020,"Guayama, PR MSA",2021,5,19106,17216,1890,9.9
MT7232420000000,72,32420,"Mayaguez, PR MSA",2021,5,64245,58010,6235,9.7
MT7238660000000,72,38660,"Ponce, PR MSA",2021,5,87086,78092,8994,10.3
MT7241980000000,72,41980,"San Juan-Bayamon-Caguas, PR MSA",2021,5,784901,725627,59274,7.6
MT0111500000000,1,11500,"Anniston-Oxford, AL MSA",2021,6,49502,47565,1937,3.9
MT0112220000000,1,12220,"Auburn-Opelika, AL MSA",2021,6,89565,86888,2677,3
MT0113820000000,1,13820,"Birmingham, AL MSA",2021,6,550483,532904,17579,3.2
MT0119300000000,1,19300,"Daphne-Fairhope-Foley, AL MSA",2021,6,106585,103477,3108,2.9
MT0119460000000,1,19460,"Decatur, AL MSA",2021,6,71207,69205,2002,2.8
MT0120020000000,1,20020,"Dothan, AL MSA",2021,6,65288,63104,2184,3.3
MT0122520000000,1,22520,"Florence-Muscle Shoals, AL MSA",2021,6,66122,63766,2356,3.6
MT0123460000000,1,23460,"Gadsden, AL MSA",2021,6,41182,39561,1621,3.9
MT0126620000000,1,26620,"Huntsville, AL MSA",2021,6,248885,242529,6356,2.6
MT0133660000000,1,33660,"Mobile, AL MSA",2021,6,182762,173667,9095,5
MT0133860000000,1,33860,"Montgomery, AL MSA",2021,6,171206,163839,7367,4.3
MT0146220000000,1,46220,"Tuscaloosa, AL MSA",2021,6,118973,114398,4575,3.8
MT0211260000000,2,11260,"Anchorage, AK MSA",2021,6,196861,184062,12799,6.5
MT0221820000000,2,21820,"Fairbanks-College, AK MSA",2021,6,44783,42404,2379,5.3
MT0422380000000,4,22380,"Flagstaff, AZ MSA",2021,6,70511,65840,4671,6.6
MT0429420000000,4,29420,"Lake Havasu City-Kingman, AZ MSA",2021,6,85015,79678,5337,6.3
MT0438060000000,4,38060,"Phoenix-Mesa-Chandler, AZ MSA",2021,6,2526756,2402702,124054,4.9
MT0439150000000,4,39150,"Prescott Valley-Prescott, AZ MSA",2021,6,100726,95986,4740,4.7
MT0443420000000,4,43420,"Sierra Vista-Douglas, AZ MSA",2021,6,47537,44999,2538,5.3
MT0446060000000,4,46060,"Tucson, AZ MSA",2021,6,484679,458659,26020,5.4
MT0449740000000,4,49740,"Yuma, AZ MSA",2021,6,94344,81637,12707,13.5
MT0522220000000,5,22220,"Fayetteville-Springdale-Rogers, AR MSA",2021,6,274693,266318,8375,3
MT0522900000000,5,22900,"Fort Smith, AR-OK MSA",2021,6,98674,94776,3898,4
MT0526300000000,5,26300,"Hot Springs, AR MSA",2021,6,43248,41137,2111,4.9
MT0527860000000,5,27860,"Jonesboro, AR MSA",2021,6,62924,60620,2304,3.7
MT0530780000000,5,30780,"Little Rock-North Little Rock-Conway, AR MSA",2021,6,353022,337612,15410,4.4
MT0612540000000,6,12540,"Bakersfield-Delano, CA MSA",2021,6,387838,346660,41178,10.6
MT0617020000000,6,17020,"Chico, CA MSA",2021,6,90427,83740,6687,7.4
MT0620940000000,6,20940,"El Centro, CA MSA",2021,6,67590,54600,12990,19.2
MT0623420000000,6,23420,"Fresno, CA MSA",2021,6,502462,454490,47972,9.5
MT0625260000000,6,25260,"Hanford-Corcoran, CA MSA",2021,6,54008,48128,5880,10.9
MT0631080000000,6,31080,"Los Angeles-Long Beach-Anaheim, CA MSA",2021,6,6588256,6008461,579795,8.8
MT0632900000000,6,32900,"Merced, CA MSA",2021,6,114683,102486,12197,10.6
MT0633700000000,6,33700,"Modesto, CA MSA",2021,6,243411,222006,21405,8.8
MT0634900000000,6,34900,"Napa, CA MSA",2021,6,68775,64419,4356,6.3
MT0637100000000,6,37100,"Oxnard-Thousand Oaks-Ventura, CA MSA",2021,6,407988,380852,27136,6.7
MT0639820000000,6,39820,"Redding, CA MSA",2021,6,76374,70927,5447,7.1
MT0640140000000,6,40140,"Riverside-San Bernardino-Ontario, CA MSA",2021,6,2110467,1942623,167844,8
MT0640900000000,6,40900,"Sacramento-Roseville-Folsom, CA MSA",2021,6,1126829,1050472,76357,6.8
MT0641500000000,6,41500,"Salinas, CA MSA",2021,6,209331,190401,18930,9
MT0641740000000,6,41740,"San Diego-Chula Vista-Carlsbad, CA MSA",2021,6,1571213,1464651,106562,6.8
MT0641860000000,6,41860,"San Francisco-Oakland-Fremont, CA MSA",2021,6,2440303,2293299,147004,6
MT0641940000000,6,41940,"San Jose-Sunnyvale-Santa Clara, CA MSA",2021,6,1018679,964455,54224,5.3
MT0642020000000,6,42020,"San Luis Obispo-Paso Robles, CA MSA",2021,6,129860,122307,7553,5.8
MT0642100000000,6,42100,"Santa Cruz-Watsonville, CA MSA",2021,6,133082,123588,9494,7.1
MT0642200000000,6,42200,"Santa Maria-Santa Barbara, CA MSA",2021,6,215596,202277,13319,6.2
MT0642220000000,6,42220,"Santa Rosa-Petaluma, CA MSA",2021,6,240805,226561,14244,5.9
MT0644700000000,6,44700,"Stockton-Lodi, CA MSA",2021,6,349270,317908,31362,9
MT0646700000000,6,46700,"Vallejo, CA MSA",2021,6,208596,192556,16040,7.7
MT0647300000000,6,47300,"Visalia, CA MSA",2021,6,203060,180025,23035,11.3
MT0649700000000,6,49700,"Yuba City, CA MSA",2021,6,76912,69674,7238,9.4
MT0814500000000,8,14500,"Boulder, CO MSA",2021,6,189261,179894,9367,4.9
MT0817820000000,8,17820,"Colorado Springs, CO MSA",2021,6,377399,354879,22520,6
MT0819740000000,8,19740,"Denver-Aurora-Centennial, CO MSA",2021,6,1710722,1609557,101165,5.9
MT0822660000000,8,22660,"Fort Collins-Loveland, CO MSA",2021,6,199251,188708,10543,5.3
MT0824300000000,8,24300,"Grand Junction, CO MSA",2021,6,78778,73907,4871,6.2
MT0824540000000,8,24540,"Greeley, CO MSA",2021,6,167127,156648,10479,6.3
MT0839380000000,8,39380,"Pueblo, CO MSA",2021,6,75601,68941,6660,8.8
MT0914860000000,9,14860,"Bridgeport-Stamford-Danbury, CT MSA",2021,6,472187,441888,30299,6.4
MT0925540000000,9,25540,"Hartford-West Hartford-East Hartford, CT MSA",2021,6,584191,543599,40592,6.9
MT0935300000000,9,35300,"New Haven, CT MSA",2021,6,293469,272892,20577,7
MT0935980000000,9,35980,"Norwich-New London-Willimantic, CT MSA",2021,6,133907,123577,10330,7.7
MT0947930000000,9,47930,"Waterbury-Shelton, CT MSA",2021,6,226975,209506,17469,7.7
MT1020100000000,10,20100,"Dover, DE MSA",2021,6,86567,80180,6387,7.4
MT1147900000000,11,47900,"Washington-Arlington-Alexandria, DC-VA-MD-WV MSA",2021,6,3380021,3219853,160168,4.7
MT1215980000000,12,15980,"Cape Coral-Fort Myers, FL MSA",2021,6,347643,331689,15954,4.6
MT1218880000000,12,18880,"Crestview-Fort Walton Beach-Destin, FL MSA",2021,6,134170,129295,4875,3.6
MT1219660000000,12,19660,"Deltona-Daytona Beach-Ormond Beach, FL MSA",2021,6,297183,282070,15113,5.1
MT1223540000000,12,23540,"Gainesville, FL MSA",2021,6,162505,155731,6774,4.2
MT1226140000000,12,26140,"Homosassa Springs, FL MSA",2021,6,50457,47518,2939,5.8
MT1227260000000,12,27260,"Jacksonville, FL MSA",2021,6,793354,759233,34121,4.3
MT1229460000000,12,29460,"Lakeland-Winter Haven, FL MSA",2021,6,334057,315256,18801,5.6
MT1233100000000,12,33100,"Miami-Fort Lauderdale-West Palm Beach, FL MSA",2021,6,3065750,2903123,162627,5.3
MT1234940000000,12,34940,"Naples-Marco Island, FL MSA",2021,6,167982,161002,6980,4.2
MT1235840000000,12,35840,"North Port-Bradenton-Sarasota, FL MSA",2021,6,360642,345142,15500,4.3
MT1236100000000,12,36100,"Ocala, FL MSA",2021,6,146173,138529,7644,5.2
MT1236740000000,12,36740,"Orlando-Kissimmee-Sanford, FL MSA",2021,6,1359383,1287937,71446,5.3
MT1237340000000,12,37340,"Palm Bay-Melbourne-Titusville, FL MSA",2021,6,287973,275546,12427,4.3
MT1237460000000,12,37460,"Panama City-Panama City Beach, FL MSA",2021,6,95093,90990,4103,4.3
MT1237860000000,12,37860,"Pensacola-Ferry Pass-Brent, FL MSA",2021,6,229321,219115,10206,4.5
MT1238940000000,12,38940,"Port St. Lucie, FL MSA",2021,6,222142,211466,10676,4.8
MT1239460000000,12,39460,"Punta Gorda, FL MSA",2021,6,68949,65508,3441,5
MT1242680000000,12,42680,"Sebastian-Vero Beach-West Vero Corridor, FL MSA",2021,6,62697,59438,3259,5.2
MT1242700000000,12,42700,"Sebring, FL MSA",2021,6,34418,32255,2163,6.3
MT1245220000000,12,45220,"Tallahassee, FL MSA",2021,6,194194,185554,8640,4.4
MT1245300000000,12,45300,"Tampa-St. Petersburg-Clearwater, FL MSA",2021,6,1570185,1498777,71408,4.5
MT1248680000000,12,48680,"Wildwood-The Villages, FL MSA",2021,6,29745,27763,1982,6.7
MT1310500000000,13,10500,"Albany, GA MSA",2021,6,63842,60335,3507,5.5
MT1312020000000,13,12020,"Athens-Clarke County, GA MSA",2021,6,102593,99256,3337,3.3
MT1312060000000,13,12060,"Atlanta-Sandy Springs-Roswell, GA MSA",2021,6,3123810,2999469,124341,4
MT1312260000000,13,12260,"Augusta-Richmond County, GA-SC MSA",2021,6,264838,254114,10724,4
MT1315260000000,13,15260,"Brunswick-St. Simons, GA MSA",2021,6,51392,49420,1972,3.8
MT1317980000000,13,17980,"Columbus, GA-AL MSA",2021,6,130575,124729,5846,4.5
MT1319140000000,13,19140,"Dalton, GA MSA",2021,6,66028,63514,2514,3.8
MT1323580000000,13,23580,"Gainesville, GA MSA",2021,6,99874,97081,2793,2.8
MT1325980000000,13,25980,"Hinesville, GA MSA",2021,6,30757,29462,1295,4.2
MT1331420000000,13,31420,"Macon-Bibb County, GA MSA",2021,6,99109,94444,4665,4.7
MT1340660000000,13,40660,"Rome, GA MSA",2021,6,43706,42081,1625,3.7
MT1342340000000,13,42340,"Savannah, GA MSA",2021,6,200419,192386,8033,4
MT1346660000000,13,46660,"Valdosta, GA MSA",2021,6,61841,59202,2639,4.3
MT1347580000000,13,47580,"Warner Robins, GA MSA",2021,6,88665,85393,3272,3.7
MT1527980000000,15,27980,"Kahului-Wailuku, HI MSA",2021,6,83619,76948,6671,8
MT1546520000000,15,46520,"Urban Honolulu, HI MSA",2021,6,465775,438609,27166,5.8
MT1614260000000,16,14260,"Boise City, ID MSA",2021,6,408412,393812,14600,3.6
MT1617660000000,16,17660,"Coeur d'Alene, ID MSA",2021,6,84806,81017,3789,4.5
MT1626820000000,16,26820,"Idaho Falls, ID MSA",2021,6,77338,75015,2323,3
MT1630300000000,16,30300,"Lewiston, ID-WA MSA",2021,6,30253,29145,1108,3.7
MT1638540000000,16,38540,"Pocatello, ID MSA",2021,6,38238,36648,1590,4.2
MT1646300000000,16,46300,"Twin Falls, ID MSA",2021,6,57851,55814,2037,3.5
MT1714010000000,17,14010,"Bloomington, IL MSA",2021,6,88348,84233,4115,4.7
MT1716580000000,17,16580,"Champaign-Urbana, IL MSA",2021,6,121290,115082,6208,5.1
MT1716980000000,17,16980,"Chicago-Naperville-Elgin, IL-IN MSA",2021,6,4739222,4422330,316892,6.7
MT1719340000000,17,19340,"Davenport-Moline-Rock Island, IA-IL MSA",2021,6,189007,178512,10495,5.6
MT1719500000000,17,19500,"Decatur, IL MSA",2021,6,46076,42409,3667,8
MT1728100000000,17,28100,"Kankakee, IL MSA",2021,6,51125,47513,3612,7.1
MT1737900000000,17,37900,"Peoria, IL MSA",2021,6,172862,162111,10751,6.2
MT1740420000000,17,40420,"Rockford, IL MSA",2021,6,160864,146358,14506,9
MT1744100000000,17,44100,"Springfield, IL MSA",2021,6,100845,94797,6048,6
MT1814020000000,18,14020,"Bloomington, IN MSA",2021,6,83219,80728,2491,3
MT1818020000000,18,18020,"Columbus, IN MSA",2021,6,38358,36968,1390,3.6
MT1821140000000,18,21140,"Elkhart-Goshen, IN MSA",2021,6,104995,101665,3330,3.2
MT1821780000000,18,21780,"Evansville, IN MSA",2021,6,133379,128306,5073,3.8
MT1823060000000,18,23060,"Fort Wayne, IN MSA",2021,6,224318,215765,8553,3.8
MT1826900000000,18,26900,"Indianapolis-Carmel-Greenwood, IN MSA",2021,6,1073520,1031274,42246,3.9
MT1829020000000,18,29020,"Kokomo, IN MSA",2021,6,36762,34807,1955,5.3
MT1829200000000,18,29200,"Lafayette-West Lafayette, IN MSA",2021,6,113310,109360,3950,3.5
MT1833140000000,18,33140,"Michigan City-La Porte, IN MSA",2021,6,50320,47619,2701,5.4
MT1834620000000,18,34620,"Muncie, IN MSA",2021,6,51630,49354,2276,4.4
MT1843780000000,18,43780,"South Bend-Mishawaka, IN-MI MSA",2021,6,153357,145862,7495,4.9
MT1845460000000,18,45460,"Terre Haute, IN MSA",2021,6,76593,73259,3334,4.4
MT1911180000000,19,11180,"Ames, IA MSA",2021,6,67729,65558,2171,3.2
MT1916300000000,19,16300,"Cedar Rapids, IA MSA",2021,6,148947,141355,7592,5.1
MT1919780000000,19,19780,"Des Moines-West Des Moines, IA MSA",2021,6,389713,372397,17316,4.4
MT1920220000000,19,20220,"Dubuque, IA MSA",2021,6,53184,50777,2407,4.5
MT1926980000000,19,26980,"Iowa City, IA MSA",2021,6,97343,93450,3893,4
MT1943580000000,19,43580,"Sioux City, IA-NE-SD MSA",2021,6,75036,71942,3094,4.1
MT1947940000000,19,47940,"Waterloo-Cedar Falls, IA MSA",2021,6,88963,85292,3671,4.1
MT2029940000000,20,29940,"Lawrence, KS MSA",2021,6,67561,65370,2191,3.2
MT2031740000000,20,31740,"Manhattan, KS MSA",2021,6,62090,60173,1917,3.1
MT2045820000000,20,45820,"Topeka, KS MSA",2021,6,116287,112194,4093,3.5
MT2048620000000,20,48620,"Wichita, KS MSA",2021,6,324918,309595,15323,4.7
MT2114540000000,21,14540,"Bowling Green, KY MSA",2021,6,86222,82801,3421,4
MT2121060000000,21,21060,"Elizabethtown, KY MSA",2021,6,53065,50567,2498,4.7
MT2130460000000,21,30460,"Lexington-Fayette, KY MSA",2021,6,261845,251799,10046,3.8
MT2131140000000,21,31140,"Louisville/Jefferson County, KY-IN MSA",2021,6,673870,645949,27921,4.1
MT2136980000000,21,36980,"Owensboro, KY MSA",2021,6,50942,48812,2130,4.2
MT2137140000000,21,37140,"Paducah, KY-IL MSA",2021,6,44806,42544,2262,5
MT2210780000000,22,10780,"Alexandria, LA MSA",2021,6,64734,62036,2698,4.2
MT2212940000000,22,12940,"Baton Rouge, LA MSA",2021,6,413418,390330,23088,5.6
MT2225220000000,22,25220,"Hammond, LA MSA",2021,6,58615,54758,3857,6.6
MT2226380000000,22,26380,"Houma-Bayou Cane-Thibodaux, LA MSA",2021,6,87807,83302,4505,5.1
MT2229180000000,22,29180,"Lafayette, LA MSA",2021,6,192858,183302,9556,5
MT2229340000000,22,29340,"Lake Charles, LA MSA",2021,6,102807,96269,6538,6.4
MT2233740000000,22,33740,"Monroe, LA MSA",2021,6,95589,90008,5581,5.8
MT2235380000000,22,35380,"New Orleans-Metairie, LA MSA",2021,6,465673,433742,31931,6.9
MT2243340000000,22,43340,"Shreveport-Bossier City, LA MSA",2021,6,166215,156477,9738,5.9
MT2243640000000,22,43640,"Slidell-Mandeville-Covington, LA MSA",2021,6,123221,118338,4883,4
MT2312620000000,23,12620,"Bangor, ME MSA",2021,6,73506,69495,4011,5.5
MT2330340000000,23,30340,"Lewiston-Auburn, ME MSA",2021,6,55548,52479,3069,5.5
MT2338860000000,23,38860,"Portland-South Portland, ME MSA",2021,6,303425,289606,13819,4.6
MT2412580000000,24,12580,"Baltimore-Columbia-Towson, MD MSA",2021,6,1447699,1372577,75122,5.2
MT2425180000000,24,25180,"Hagerstown-Martinsburg, MD-WV MSA",2021,6,140756,134386,6370,4.5
MT2430500000000,24,30500,"Lexington Park, MD MSA",2021,6,105425,100915,4510,4.3
MT2441540000000,24,41540,"Salisbury, MD MSA",2021,6,60749,57028,3721,6.1
MT2511200000000,25,11200,"Amherst Town-Northampton, MA MSA",2021,6,82902,78903,3999,4.8
MT2512700000000,25,12700,"Barnstable Town, MA MSA",2021,6,112617,105278,7339,6.5
MT2514460000000,25,14460,"Boston-Cambridge-Newton, MA-NH MSA",2021,6,2699047,2564736,134311,5
MT2538340000000,25,38340,"Pittsfield, MA MSA",2021,6,62913,58928,3985,6.3
MT2544140000000,25,44140,"Springfield, MA MSA",2021,6,225466,209462,16004,7.1
MT2549340000000,25,49340,"Worcester, MA MSA",2021,6,448174,423385,24789,5.5
MT2611460000000,26,11460,"Ann Arbor, MI MSA",2021,6,191077,182833,8244,4.3
MT2612980000000,26,12980,"Battle Creek, MI MSA",2021,6,58457,54462,3995,6.8
MT2613020000000,26,13020,"Bay City, MI MSA",2021,6,47249,44290,2959,6.3
MT2619820000000,26,19820,"Detroit-Warren-Dearborn, MI MSA",2021,6,2105761,1966870,138891,6.6
MT2622420000000,26,22420,"Flint, MI MSA",2021,6,176786,163581,13205,7.5
MT2624340000000,26,24340,"Grand Rapids-Wyoming-Kentwood, MI MSA",2021,6,579199,551211,27988,4.8
MT2627100000000,26,27100,"Jackson, MI MSA",2021,6,70704,66443,4261,6
MT2628020000000,26,28020,"Kalamazoo-Portage, MI MSA",2021,6,129679,123151,6528,5
MT2629620000000,26,29620,"Lansing-East Lansing, MI MSA",2021,6,230429,217678,12751,5.5
MT2633220000000,26,33220,"Midland, MI MSA",2021,6,38182,36301,1881,4.9
MT2633780000000,26,33780,"Monroe, MI MSA",2021,6,71639,66842,4797,6.7
MT2634740000000,26,34740,"Muskegon-Norton Shores, MI MSA",2021,6,79188,73390,5798,7.3
MT2635660000000,26,35660,"Niles, MI MSA",2021,6,70925,66808,4117,5.8
MT2640980000000,26,40980,"Saginaw, MI MSA",2021,6,81482,75544,5938,7.3
MT2645900000000,26,45900,"Traverse City, MI MSA",2021,6,74814,70741,4073,5.4
MT2720260000000,27,20260,"Duluth, MN-WI MSA",2021,6,136911,131050,5861,4.3
MT2731860000000,27,31860,"Mankato, MN MSA",2021,6,57642,55695,1947,3.4
MT2733460000000,27,33460,"Minneapolis-St. Paul-Bloomington, MN-WI MSA",2021,6,2006919,1932351,74568,3.7
MT2740340000000,27,40340,"Rochester, MN MSA",2021,6,123688,119756,3932,3.2
MT2741060000000,27,41060,"St. Cloud, MN MSA",2021,6,107365,102807,4558,4.2
MT2825060000000,28,25060,"Gulfport-Biloxi, MS MSA",2021,6,182980,172731,10249,5.6
MT2825620000000,28,25620,"Hattiesburg, MS MSA",2021,6,69438,65735,3703,5.3
MT2827140000000,28,27140,"Jackson, MS MSA",2021,6,275168,260254,14914,5.4
MT2916020000000,29,16020,"Cape Girardeau, MO-IL MSA",2021,6,47386,45641,1745,3.7
MT2917860000000,29,17860,"Columbia, MO MSA",2021,6,111583,108414,3169,2.8
MT2927620000000,29,27620,"Jefferson City, MO MSA",2021,6,72694,70540,2154,3
MT2927900000000,29,27900,"Joplin, MO-KS MSA",2021,6,94275,90945,3330,3.5
MT2928140000000,29,28140,"Kansas City, MO-KS MSA",2021,6,1155276,1098154,57122,4.9
MT2941140000000,29,41140,"St. Joseph, MO-KS MSA",2021,6,55777,53624,2153,3.9
MT2941180000000,29,41180,"St. Louis, MO-IL MSA",2021,6,1440829,1372773,68056,4.7
MT2944180000000,29,44180,"Springfield, MO MSA",2021,6,231234,223357,7877,3.4
MT3013740000000,30,13740,"Billings, MT MSA",2021,6,95712,92579,3133,3.3
MT3014580000000,30,14580,"Bozeman, MT MSA",2021,6,70987,69092,1895,2.7
MT3024500000000,30,24500,"Great Falls, MT MSA",2021,6,38472,37134,1338,3.5
MT3025740000000,30,25740,"Helena, MT MSA",2021,6,44959,43521,1438,3.2
MT3033540000000,30,33540,"Missoula, MT MSA",2021,6,70362,68001,2361,3.4
MT3124260000000,31,24260,"Grand Island, NE MSA",2021,6,40734,39513,1221,3
MT3130700000000,31,30700,"Lincoln, NE MSA",2021,6,186400,181601,4799,2.6
MT3136540000000,31,36540,"Omaha, NE-IA MSA",2021,6,510643,494442,16201,3.2
MT3216180000000,32,16180,"Carson City, NV MSA",2021,6,27962,26713,1249,4.5
MT3229820000000,32,29820,"Las Vegas-Henderson-North Las Vegas, NV MSA",2021,6,1091692,1004430,87262,8
MT3239900000000,32,39900,"Reno, NV MSA",2021,6,279776,267488,12288,4.4
MT3331700000000,33,31700,"Manchester-Nashua, NH MSA",2021,6,235322,226476,8846,3.8
MT3412100000000,34,12100,"Atlantic City-Hammonton, NJ MSA",2021,6,178738,160491,18247,10.2
MT3445940000000,34,45940,"Trenton-Princeton, NJ MSA",2021,6,192769,180623,12146,6.3
MT3447220000000,34,47220,"Vineland, NJ MSA",2021,6,65267,59311,5956,9.1
MT3510740000000,35,10740,"Albuquerque, NM MSA",2021,6,438953,408715,30238,6.9
MT3522140000000,35,22140,"Farmington, NM MSA",2021,6,47895,43649,4246,8.9
MT3529740000000,35,29740,"Las Cruces, NM MSA",2021,6,96677,89554,7123,7.4
MT3542140000000,35,42140,"Santa Fe, NM MSA",2021,6,72885,67948,4937,6.8
MT3610580000000,36,10580,"Albany-Schenectady-Troy, NY MSA",2021,6,449084,428143,20941,4.7
MT3613780000000,36,13780,"Binghamton, NY MSA",2021,6,106334,100596,5738,5.4
MT3615380000000,36,15380,"Buffalo-Cheektowaga, NY MSA",2021,6,556012,524301,31711,5.7
MT3621300000000,36,21300,"Elmira, NY MSA",2021,6,36054,34093,1961,5.4
MT3624020000000,36,24020,"Glens Falls, NY MSA",2021,6,60050,56947,3103,5.2
MT3627060000000,36,27060,"Ithaca, NY MSA",2021,6,49015,47050,1965,4
MT3628740000000,36,28740,"Kingston, NY MSA",2021,6,85583,81237,4346,5.1
MT3628880000000,36,28880,"Kiryas Joel-Poughkeepsie-Newburgh, NY MSA",2021,6,326198,309947,16251,5
MT3635620000000,36,35620,"New York-Newark-Jersey City, NY-NJ MSA",2021,6,9754262,8961686,792576,8.1
MT3640380000000,36,40380,"Rochester, NY MSA",2021,6,510244,483297,26947,5.3
MT3645060000000,36,45060,"Syracuse, NY MSA",2021,6,309667,293243,16424,5.3
MT3646540000000,36,46540,"Utica-Rome, NY MSA",2021,6,129620,122455,7165,5.5
MT3648060000000,36,48060,"Watertown-Fort Drum, NY MSA",2021,6,44742,42218,2524,5.6
MT3711700000000,37,11700,"Asheville, NC MSA",2021,6,195834,187075,8759,4.5
MT3715500000000,37,15500,"Burlington, NC MSA",2021,6,80103,76044,4059,5.1
MT3716740000000,37,16740,"Charlotte-Concord-Gastonia, NC-SC MSA",2021,6,1358588,1292526,66062,4.9
MT3720500000000,37,20500,"Durham-Chapel Hill, NC MSA",2021,6,297160,284431,12729,4.3
MT3722180000000,37,22180,"Fayetteville, NC MSA",2021,6,148892,138793,10099,6.8
MT3724140000000,37,24140,"Goldsboro, NC MSA",2021,6,48836,46286,2550,5.2
MT3724660000000,37,24660,"Greensboro-High Point, NC MSA",2021,6,358960,338793,20167,5.6
MT3724780000000,37,24780,"Greenville, NC MSA",2021,6,78848,74525,4323,5.5
MT3725860000000,37,25860,"Hickory-Lenoir-Morganton, NC MSA",2021,6,164290,156033,8257,5
MT3727340000000,37,27340,"Jacksonville, NC MSA",2021,6,68467,65024,3443,5
MT3738240000000,37,38240,"Pinehurst-Southern Pines, NC MSA",2021,6,40894,38961,1933,4.7
MT3739580000000,37,39580,"Raleigh-Cary, NC MSA",2021,6,751949,720769,31180,4.1
MT3740580000000,37,40580,"Rocky Mount, NC MSA",2021,6,63300,58820,4480,7.1
MT3748900000000,37,48900,"Wilmington, NC MSA",2021,6,199774,189669,10105,5.1
MT3749180000000,37,49180,"Winston-Salem, NC MSA",2021,6,311044,295231,15813,5.1
MT3813900000000,38,13900,"Bismarck, ND MSA",2021,6,72141,70098,2043,2.8
MT3822020000000,38,22020,"Fargo, ND-MN MSA",2021,6,146206,142075,4131,2.8
MT3824220000000,38,24220,"Grand Forks, ND-MN MSA",2021,6,54192,52432,1760,3.2
MT3833500000000,38,33500,"Minot, ND MSA",2021,6,39304,37957,1347,3.4
MT3910420000000,39,10420,"Akron, OH MSA",2021,6,352754,332707,20047,5.7
MT3915940000000,39,15940,"Canton-Massillon, OH MSA",2021,6,191891,180486,11405,5.9
MT3917140000000,39,17140,"Cincinnati, OH-KY-IN MSA",2021,6,1127839,1074645,53194,4.7
MT3917410000000,39,17410,"Cleveland, OH MSA",2021,6,1064193,1000788,63405,6
MT3918140000000,39,18140,"Columbus, OH MSA",2021,6,1108965,1052863,56102,5.1
MT3919430000000,39,19430,"Dayton-Kettering-Beavercreek, OH MSA",2021,6,382473,360874,21599,5.6
MT3930620000000,39,30620,"Lima, OH MSA",2021,6,47984,45348,2636,5.5
MT3931900000000,39,31900,"Mansfield, OH MSA",2021,6,52888,49628,3260,6.2
MT3941780000000,39,41780,"Sandusky, OH MSA",2021,6,56438,52948,3490,6.2
MT3944220000000,39,44220,"Springfield, OH MSA",2021,6,61175,57428,3747,6.1
MT3945780000000,39,45780,"Toledo, OH MSA",2021,6,291060,272221,18839,6.5
MT3948260000000,39,48260,"Weirton-Steubenville, WV-OH MSA",2021,6,52608,49339,3269,6.2
MT3949660000000,39,49660,"Youngstown-Warren, OH MSA",2021,6,188247,175598,12649,6.7
MT4021420000000,40,21420,"Enid, OK MSA",2021,6,28181,27199,982,3.5
MT4030020000000,40,30020,"Lawton, OK MSA",2021,6,50885,48943,1942,3.8
MT4036420000000,40,36420,"Oklahoma City, OK MSA",2021,6,711194,681903,29291,4.1
MT4046140000000,40,46140,"Tulsa, OK MSA",2021,6,489516,469213,20303,4.1
MT4110540000000,41,10540,"Albany, OR MSA",2021,6,60484,56973,3511,5.8
MT4113460000000,41,13460,"Bend, OR MSA",2021,6,125551,118562,6989,5.6
MT4118700000000,41,18700,"Corvallis, OR MSA",2021,6,46888,44977,1911,4.1
MT4121660000000,41,21660,"Eugene-Springfield, OR MSA",2021,6,185320,174936,10384,5.6
MT4124420000000,41,24420,"Grants Pass, OR MSA",2021,6,35569,33192,2377,6.7
MT4132780000000,41,32780,"Medford, OR MSA",2021,6,106019,100054,5965,5.6
MT4138900000000,41,38900,"Portland-Vancouver-Hillsboro, OR-WA MSA",2021,6,1349534,1280863,68671,5.1
MT4141420000000,41,41420,"Salem, OR MSA",2021,6,211741,200925,10816,5.1
MT4210900000000,42,10900,"Allentown-Bethlehem-Easton, PA-NJ MSA",2021,6,440563,412396,28167,6.4
MT4211020000000,42,11020,"Altoona, PA MSA",2021,6,57488,54034,3454,6
MT4216540000000,42,16540,"Chambersburg, PA MSA",2021,6,76019,72154,3865,5.1
MT4221500000000,42,21500,"Erie, PA MSA",2021,6,126501,117669,8832,7
MT4223900000000,42,23900,"Gettysburg, PA MSA",2021,6,51635,49295,2340,4.5
MT4225420000000,42,25420,"Harrisburg-Carlisle, PA MSA",2021,6,301211,285287,15924,5.3
MT4227780000000,42,27780,"Johnstown, PA MSA",2021,6,57273,53381,3892,6.8
MT4229540000000,42,29540,"Lancaster, PA MSA",2021,6,284247,270783,13464,4.7
MT4230140000000,42,30140,"Lebanon, PA MSA",2021,6,70572,66739,3833,5.4
MT4237980000000,42,37980,"Philadelphia-Camden-Wilmington, PA-NJ-DE-MD MSA",2021,6,3178040,2977982,200058,6.3
MT4238300000000,42,38300,"Pittsburgh, PA MSA",2021,6,1225800,1149507,76293,6.2
MT4239740000000,42,39740,"Reading, PA MSA",2021,6,212432,199019,13413,6.3
MT4242540000000,42,42540,"Scranton--Wilkes-Barre, PA MSA",2021,6,272479,252799,19680,7.2
MT4244300000000,42,44300,"State College, PA MSA",2021,6,73803,70506,3297,4.5
MT4248700000000,42,48700,"Williamsport, PA MSA",2021,6,52729,49056,3673,7
MT4249620000000,42,49620,"York-Hanover, PA MSA",2021,6,233158,220762,12396,5.3
MT4439300000000,44,39300,"Providence-Warwick, RI-MA MSA",2021,6,866721,816251,50470,5.8
MT4516700000000,45,16700,"Charleston-North Charleston, SC MSA",2021,6,396712,382644,14068,3.5
MT4517900000000,45,17900,"Columbia, SC MSA",2021,6,393627,379084,14543,3.7
MT4522500000000,45,22500,"Florence, SC MSA",2021,6,88911,84879,4032,4.5
MT4524860000000,45,24860,"Greenville-Anderson-Greer, SC MSA",2021,6,442315,426812,15503,3.5
MT4525940000000,45,25940,"Hilton Head Island-Bluffton-Port Royal, SC MSA",2021,6,91295,88275,3020,3.3
MT4534820000000,45,34820,"Myrtle Beach-Conway-North Myrtle Beach, SC MSA",2021,6,154305,146461,7844,5.1
MT4543900000000,45,43900,"Spartanburg, SC MSA",2021,6,167179,160071,7108,4.3
MT4544940000000,45,44940,"Sumter, SC MSA",2021,6,42398,40470,1928,4.5
MT4639660000000,46,39660,"Rapid City, SD MSA",2021,6,76822,74710,2112,2.7
MT4643620000000,46,43620,"Sioux Falls, SD-MN MSA",2021,6,165051,161077,3974,2.4
MT4716860000000,47,16860,"Chattanooga, TN-GA MSA",2021,6,270765,259855,10910,4
MT4717300000000,47,17300,"Clarksville, TN-KY MSA",2021,6,131923,125548,6375,4.8
MT4717420000000,47,17420,"Cleveland, TN MSA",2021,6,57427,54813,2614,4.6
MT4727180000000,47,27180,"Jackson, TN MSA",2021,6,78624,74568,4056,5.2
MT4727740000000,47,27740,"Johnson City, TN MSA",2021,6,95780,91886,3894,4.1
MT4728700000000,47,28700,"Kingsport-Bristol, TN-VA MSA",2021,6,128812,122792,6020,4.7
MT4728940000000,47,28940,"Knoxville, TN MSA",2021,6,430464,413957,16507,3.8
MT4732820000000,47,32820,"Memphis, TN-MS-AR MSA",2021,6,643838,600343,43495,6.8
MT4734100000000,47,34100,"Morristown, TN MSA",2021,6,52342,49989,2353,4.5
MT4734980000000,47,34980,"Nashville-Davidson--Murfreesboro--Franklin, TN MSA",2021,6,1088504,1044868,43636,4
MT4810180000000,48,10180,"Abilene, TX MSA",2021,6,80385,76702,3683,4.6
MT4811100000000,48,11100,"Amarillo, TX MSA",2021,6,130827,125545,5282,4
MT4812420000000,48,12420,"Austin-Round Rock-San Marcos, TX MSA",2021,6,1304237,1248864,55373,4.2
MT4813140000000,48,13140,"Beaumont-Port Arthur, TX MSA",2021,6,170839,155003,15836,9.3
MT4815180000000,48,15180,"Brownsville-Harlingen, TX MSA",2021,6,179919,165298,14621,8.1
MT4817780000000,48,17780,"College Station-Bryan, TX MSA",2021,6,135000,128926,6074,4.5
MT4818580000000,48,18580,"Corpus Christi, TX MSA",2021,6,200648,185899,14749,7.4
MT4819100000000,48,19100,"Dallas-Fort Worth-Arlington, TX MSA",2021,6,4063045,3850150,212895,5.2
MT4820580000000,48,20580,"Eagle Pass, TX MSA",2021,6,23381,20360,3021,12.9
MT4821340000000,48,21340,"El Paso, TX MSA",2021,6,383689,360012,23677,6.2
MT4826420000000,48,26420,"Houston-Pasadena-The Woodlands, TX MSA",2021,6,3502760,3275625,227135,6.5
MT4828660000000,48,28660,"Killeen-Temple, TX MSA",2021,6,192287,181514,10773,5.6
MT4829700000000,48,29700,"Laredo, TX MSA",2021,6,110977,103669,7308,6.6
MT4830980000000,48,30980,"Longview, TX MSA",2021,6,124861,116728,8133,6.5
MT4831180000000,48,31180,"Lubbock, TX MSA",2021,6,173221,164729,8492,4.9
MT4832580000000,48,32580,"McAllen-Edinburg-Mission, TX MSA",2021,6,374456,339647,34809,9.3
MT4833260000000,48,33260,"Midland, TX MSA",2021,6,88488,82878,5610,6.3
MT4836220000000,48,36220,"Odessa, TX MSA",2021,6,77608,71104,6504,8.4
MT4841660000000,48,41660,"San Angelo, TX MSA",2021,6,57833,55144,2689,4.6
MT4841700000000,48,41700,"San Antonio-New Braunfels, TX MSA",2021,6,1219366,1154379,64987,5.3
MT4843300000000,48,43300,"Sherman-Denison, TX MSA",2021,6,65620,62583,3037,4.6
MT4845500000000,48,45500,"Texarkana, TX-AR MSA",2021,6,60821,57277,3544,5.8
MT4846340000000,48,46340,"Tyler, TX MSA",2021,6,109730,103854,5876,5.4
MT4847020000000,48,47020,"Victoria, TX MSA",2021,6,44028,41240,2788,6.3
MT4847380000000,48,47380,"Waco, TX MSA",2021,6,136481,129553,6928,5.1
MT4848660000000,48,48660,"Wichita Falls, TX MSA",2021,6,65332,61982,3350,5.1
MT4930860000000,49,30860,"Logan, UT-ID MSA",2021,6,76295,74724,1571,2.1
MT4936260000000,49,36260,"Ogden, UT MSA",2021,6,324456,315844,8612,2.7
MT4939340000000,49,39340,"Provo-Orem-Lehi, UT MSA",2021,6,338884,330683,8201,2.4
MT4941100000000,49,41100,"St. George, UT MSA",2021,6,82639,80132,2507,3
MT4941620000000,49,41620,"Salt Lake City-Murray, UT MSA",2021,6,682909,662871,20038,2.9
MT5015540000000,50,15540,"Burlington-South Burlington, VT MSA",2021,6,123019,119233,3786,3.1
MT5113980000000,51,13980,"Blacksburg-Christiansburg-Radford, VA MSA",2021,6,87336,84208,3128,3.6
MT5116820000000,51,16820,"Charlottesville, VA MSA",2021,6,111133,107238,3895,3.5
MT5125500000000,51,25500,"Harrisonburg, VA MSA",2021,6,68885,66624,2261,3.3
MT5131340000000,51,31340,"Lynchburg, VA MSA",2021,6,124582,119593,4989,4
MT5140060000000,51,40060,"Richmond, VA MSA",2021,6,676826,648017,28809,4.3
MT5140220000000,51,40220,"Roanoke, VA MSA",2021,6,150380,144319,6061,4
MT5144420000000,51,44420,"Staunton-Stuarts Draft, VA MSA",2021,6,61202,59075,2127,3.5
MT5147260000000,51,47260,"Virginia Beach-Chesapeake-Norfolk, VA-NC MSA",2021,6,840538,800948,39590,4.7
MT5149020000000,51,49020,"Winchester, VA-WV MSA",2021,6,71822,69406,2416,3.4
MT5313380000000,53,13380,"Bellingham, WA MSA",2021,6,113609,107378,6231,5.5
MT5314740000000,53,14740,"Bremerton-Silverdale-Port Orchard, WA MSA",2021,6,122282,116233,6049,4.9
MT5328420000000,53,28420,"Kennewick-Richland, WA MSA",2021,6,145145,136639,8506,5.9
MT5331020000000,53,31020,"Longview-Kelso, WA MSA",2021,6,47865,44962,2903,6.1
MT5334580000000,53,34580,"Mount Vernon-Anacortes, WA MSA",2021,6,59078,55398,3680,6.2
MT5336500000000,53,36500,"Olympia-Lacey-Tumwater, WA MSA",2021,6,138912,131795,7117,5.1
MT5342660000000,53,42660,"Seattle-Tacoma-Bellevue, WA MSA",2021,6,2160123,2047527,112596,5.2
MT5344060000000,53,44060,"Spokane-Spokane Valley, WA MSA",2021,6,281442,266759,14683,5.2
MT5347460000000,53,47460,"Walla Walla, WA MSA",2021,6,30184,28811,1373,4.5
MT5348300000000,53,48300,"Wenatchee-East Wenatchee, WA MSA",2021,6,62997,59574,3423,5.4
MT5349420000000,53,49420,"Yakima, WA MSA",2021,6,128344,119495,8849,6.9
MT5413220000000,54,13220,"Beckley, WV MSA",2021,6,45201,42456,2745,6.1
MT5416620000000,54,16620,"Charleston, WV MSA",2021,6,89980,84705,5275,5.9
MT5426580000000,54,26580,"Huntington-Ashland, WV-KY-OH MSA",2021,6,152878,144627,8251,5.4
MT5434060000000,54,34060,"Morgantown, WV MSA",2021,6,70094,67064,3030,4.3
MT5437620000000,54,37620,"Parkersburg-Vienna, WV MSA",2021,6,38900,36687,2213,5.7
MT5448540000000,54,48540,"Wheeling, WV-OH MSA",2021,6,59704,55785,3919,6.6
MT5511540000000,55,11540,"Appleton, WI MSA",2021,6,134379,130181,4198,3.1
MT5520740000000,55,20740,"Eau Claire, WI MSA",2021,6,92484,89176,3308,3.6
MT5522540000000,55,22540,"Fond du Lac, WI MSA",2021,6,56100,54234,1866,3.3
MT5524580000000,55,24580,"Green Bay, WI MSA",2021,6,175028,168929,6099,3.5
MT5527500000000,55,27500,"Janesville-Beloit, WI MSA",2021,6,84439,80309,4130,4.9
MT5528450000000,55,28450,"Kenosha, WI MSA",2021,6,91852,87786,4066,4.4
MT5529100000000,55,29100,"La Crosse-Onalaska, WI-MN MSA",2021,6,88583,85713,2870,3.2
MT5531540000000,55,31540,"Madison, WI MSA",2021,6,393477,381526,11951,3
MT5533340000000,55,33340,"Milwaukee-Waukesha, WI MSA",2021,6,813800,776205,37595,4.6
MT5536780000000,55,36780,"Oshkosh-Neenah, WI MSA",2021,6,91841,88812,3029,3.3
MT5539540000000,55,39540,"Racine-Mount Pleasant, WI MSA",2021,6,100231,95377,4854,4.8
MT5543100000000,55,43100,"Sheboygan, WI MSA",2021,6,62146,60127,2019,3.2
MT5548140000000,55,48140,"Wausau, WI MSA",2021,6,74557,72282,2275,3.1
MT5616220000000,56,16220,"Casper, WY MSA",2021,6,41160,38680,2480,6
MT5616940000000,56,16940,"Cheyenne, WY MSA",2021,6,48818,46709,2109,4.3
MT7210380000000,72,10380,"Aguadilla, PR MSA",2021,6,82095,74330,7765,9.5
MT7211640000000,72,11640,"Arecibo, PR MSA",2021,6,62851,57886,4965,7.9
MT7225020000000,72,25020,"Guayama, PR MSA",2021,6,19234,17264,1970,10.2
MT7232420000000,72,32420,"Mayaguez, PR MSA",2021,6,64715,58184,6531,10.1
MT7238660000000,72,38660,"Ponce, PR MSA",2021,6,87906,78507,9399,10.7
MT7241980000000,72,41980,"San Juan-Bayamon-Caguas, PR MSA",2021,6,787686,728663,59023,7.5
MT0111500000000,1,11500,"Anniston-Oxford, AL MSA",2021,7,49440,47577,1863,3.8
MT0112220000000,1,12220,"Auburn-Opelika, AL MSA",2021,7,89553,86958,2595,2.9
MT0113820000000,1,13820,"Birmingham, AL MSA",2021,7,550289,533519,16770,3
MT0119300000000,1,19300,"Daphne-Fairhope-Foley, AL MSA",2021,7,106845,103864,2981,2.8
MT0119460000000,1,19460,"Decatur, AL MSA",2021,7,71202,69269,1933,2.7
MT0120020000000,1,20020,"Dothan, AL MSA",2021,7,65308,63208,2100,3.2
MT0122520000000,1,22520,"Florence-Muscle Shoals, AL MSA",2021,7,66040,63770,2270,3.4
MT0123460000000,1,23460,"Gadsden, AL MSA",2021,7,41052,39490,1562,3.8
MT0126620000000,1,26620,"Huntsville, AL MSA",2021,7,249025,242892,6133,2.5
MT0133660000000,1,33660,"Mobile, AL MSA",2021,7,182653,173978,8675,4.7
MT0133860000000,1,33860,"Montgomery, AL MSA",2021,7,171194,164160,7034,4.1
MT0146220000000,1,46220,"Tuscaloosa, AL MSA",2021,7,118803,114398,4405,3.7
MT0211260000000,2,11260,"Anchorage, AK MSA",2021,7,197049,184862,12187,6.2
MT0221820000000,2,21820,"Fairbanks-College, AK MSA",2021,7,44794,42489,2305,5.1
MT0422380000000,4,22380,"Flagstaff, AZ MSA",2021,7,70557,66212,4345,6.2
MT0429420000000,4,29420,"Lake Havasu City-Kingman, AZ MSA",2021,7,84906,79883,5023,5.9
MT0438060000000,4,38060,"Phoenix-Mesa-Chandler, AZ MSA",2021,7,2527789,2412976,114813,4.5
MT0439150000000,4,39150,"Prescott Valley-Prescott, AZ MSA",2021,7,100696,96275,4421,4.4
MT0443420000000,4,43420,"Sierra Vista-Douglas, AZ MSA",2021,7,47432,44984,2448,5.2
MT0446060000000,4,46060,"Tucson, AZ MSA",2021,7,484893,460715,24178,5
MT0449740000000,4,49740,"Yuma, AZ MSA",2021,7,94187,81853,12334,13.1
MT0522220000000,5,22220,"Fayetteville-Springdale-Rogers, AR MSA",2021,7,275243,267366,7877,2.9
MT0522900000000,5,22900,"Fort Smith, AR-OK MSA",2021,7,98433,94753,3680,3.7
MT0526300000000,5,26300,"Hot Springs, AR MSA",2021,7,43240,41277,1963,4.5
MT0527860000000,5,27860,"Jonesboro, AR MSA",2021,7,62936,60780,2156,3.4
MT0530780000000,5,30780,"Little Rock-North Little Rock-Conway, AR MSA",2021,7,353077,338623,14454,4.1
MT0612540000000,6,12540,"Bakersfield-Delano, CA MSA",2021,7,388337,348087,40250,10.4
MT0617020000000,6,17020,"Chico, CA MSA",2021,7,90495,84056,6439,7.1
MT0620940000000,6,20940,"El Centro, CA MSA",2021,7,67459,54886,12573,18.6
MT0623420000000,6,23420,"Fresno, CA MSA",2021,7,503580,456724,46856,9.3
MT0625260000000,6,25260,"Hanford-Corcoran, CA MSA",2021,7,54011,48242,5769,10.7
MT0631080000000,6,31080,"Los Angeles-Long Beach-Anaheim, CA MSA",2021,7,6600337,6051558,548779,8.3
MT0632900000000,6,32900,"Merced, CA MSA",2021,7,114817,102852,11965,10.4
MT0633700000000,6,33700,"Modesto, CA MSA",2021,7,243347,222587,20760,8.5
MT0634900000000,6,34900,"Napa, CA MSA",2021,7,68859,64734,4125,6
MT0637100000000,6,37100,"Oxnard-Thousand Oaks-Ventura, CA MSA",2021,7,409111,383272,25839,6.3
MT0639820000000,6,39820,"Redding, CA MSA",2021,7,76302,71003,5299,6.9
MT0640140000000,6,40140,"Riverside-San Bernardino-Ontario, CA MSA",2021,7,2113033,1953141,159892,7.6
MT0640900000000,6,40900,"Sacramento-Roseville-Folsom, CA MSA",2021,7,1128730,1055391,73339,6.5
MT0641500000000,6,41500,"Salinas, CA MSA",2021,7,209907,191311,18596,8.9
MT0641740000000,6,41740,"San Diego-Chula Vista-Carlsbad, CA MSA",2021,7,1576055,1474785,101270,6.4
MT0641860000000,6,41860,"San Francisco-Oakland-Fremont, CA MSA",2021,7,2447917,2308558,139359,5.7
MT0641940000000,6,41940,"San Jose-Sunnyvale-Santa Clara, CA MSA",2021,7,1020361,968772,51589,5.1
MT0642020000000,6,42020,"San Luis Obispo-Paso Robles, CA MSA",2021,7,130348,123168,7180,5.5
MT0642100000000,6,42100,"Santa Cruz-Watsonville, CA MSA",2021,7,133359,124142,9217,6.9
MT0642200000000,6,42200,"Santa Maria-Santa Barbara, CA MSA",2021,7,216250,203545,12705,5.9
MT0642220000000,6,42220,"Santa Rosa-Petaluma, CA MSA",2021,7,241355,227823,13532,5.6
MT0644700000000,6,44700,"Stockton-Lodi, CA MSA",2021,7,349783,319508,30275,8.7
MT0646700000000,6,46700,"Vallejo, CA MSA",2021,7,208859,193469,15390,7.4
MT0647300000000,6,47300,"Visalia, CA MSA",2021,7,203777,181295,22482,11
MT0649700000000,6,49700,"Yuba City, CA MSA",2021,7,77074,69968,7106,9.2
MT0814500000000,8,14500,"Boulder, CO MSA",2021,7,189747,180762,8985,4.7
MT0817820000000,8,17820,"Colorado Springs, CO MSA",2021,7,378248,356379,21869,5.8
MT0819740000000,8,19740,"Denver-Aurora-Centennial, CO MSA",2021,7,1714136,1616491,97645,5.7
MT0822660000000,8,22660,"Fort Collins-Loveland, CO MSA",2021,7,199819,189663,10156,5.1
MT0824300000000,8,24300,"Grand Junction, CO MSA",2021,7,78808,74093,4715,6
MT0824540000000,8,24540,"Greeley, CO MSA",2021,7,167495,157370,10125,6
MT0839380000000,8,39380,"Pueblo, CO MSA",2021,7,75670,69161,6509,8.6
MT0914860000000,9,14860,"Bridgeport-Stamford-Danbury, CT MSA",2021,7,481169,451781,29388,6.1
MT0925540000000,9,25540,"Hartford-West Hartford-East Hartford, CT MSA",2021,7,588109,548843,39266,6.7
MT0935300000000,9,35300,"New Haven, CT MSA",2021,7,298244,278335,19909,6.7
MT0935980000000,9,35980,"Norwich-New London-Willimantic, CT MSA",2021,7,134259,124308,9951,7.4
MT0947930000000,9,47930,"Waterbury-Shelton, CT MSA",2021,7,230933,213966,16967,7.3
MT1020100000000,10,20100,"Dover, DE MSA",2021,7,85835,80275,5560,6.5
MT1147900000000,11,47900,"Washington-Arlington-Alexandria, DC-VA-MD-WV MSA",2021,7,3383767,3232132,151635,4.5
MT1215980000000,12,15980,"Cape Coral-Fort Myers, FL MSA",2021,7,349073,333624,15449,4.4
MT1218880000000,12,18880,"Crestview-Fort Walton Beach-Destin, FL MSA",2021,7,134396,129646,4750,3.5
MT1219660000000,12,19660,"Deltona-Daytona Beach-Ormond Beach, FL MSA",2021,7,298427,283772,14655,4.9
MT1223540000000,12,23540,"Gainesville, FL MSA",2021,7,162709,156097,6612,4.1
MT1226140000000,12,26140,"Homosassa Springs, FL MSA",2021,7,50513,47663,2850,5.6
MT1227260000000,12,27260,"Jacksonville, FL MSA",2021,7,795413,762294,33119,4.2
MT1229460000000,12,29460,"Lakeland-Winter Haven, FL MSA",2021,7,334985,316943,18042,5.4
MT1233100000000,12,33100,"Miami-Fort Lauderdale-West Palm Beach, FL MSA",2021,7,3075844,2922615,153229,5
MT1234940000000,12,34940,"Naples-Marco Island, FL MSA",2021,7,168867,162213,6654,3.9
MT1235840000000,12,35840,"North Port-Bradenton-Sarasota, FL MSA",2021,7,361863,346839,15024,4.2
MT1236100000000,12,36100,"Ocala, FL MSA",2021,7,146422,138974,7448,5.1
MT1236740000000,12,36740,"Orlando-Kissimmee-Sanford, FL MSA",2021,7,1369557,1301057,68500,5
MT1237340000000,12,37340,"Palm Bay-Melbourne-Titusville, FL MSA",2021,7,288223,276205,12018,4.2
MT1237460000000,12,37460,"Panama City-Panama City Beach, FL MSA",2021,7,95071,91120,3951,4.2
MT1237860000000,12,37860,"Pensacola-Ferry Pass-Brent, FL MSA",2021,7,229665,219739,9926,4.3
MT1238940000000,12,38940,"Port St. Lucie, FL MSA",2021,7,222627,212315,10312,4.6
MT1239460000000,12,39460,"Punta Gorda, FL MSA",2021,7,69323,65974,3349,4.8
MT1242680000000,12,42680,"Sebastian-Vero Beach-West Vero Corridor, FL MSA",2021,7,62973,59839,3134,5
MT1242700000000,12,42700,"Sebring, FL MSA",2021,7,34516,32420,2096,6.1
MT1245220000000,12,45220,"Tallahassee, FL MSA",2021,7,194724,186291,8433,4.3
MT1245300000000,12,45300,"Tampa-St. Petersburg-Clearwater, FL MSA",2021,7,1575401,1506296,69105,4.4
MT1248680000000,12,48680,"Wildwood-The Villages, FL MSA",2021,7,29890,27950,1940,6.5
MT1310500000000,13,10500,"Albany, GA MSA",2021,7,63565,60265,3300,5.2
MT1312020000000,13,12020,"Athens-Clarke County, GA MSA",2021,7,102530,99307,3223,3.1
MT1312060000000,13,12060,"Atlanta-Sandy Springs-Roswell, GA MSA",2021,7,3127763,3009439,118324,3.8
MT1312260000000,13,12260,"Augusta-Richmond County, GA-SC MSA",2021,7,264524,254198,10326,3.9
MT1315260000000,13,15260,"Brunswick-St. Simons, GA MSA",2021,7,51405,49521,1884,3.7
MT1317980000000,13,17980,"Columbus, GA-AL MSA",2021,7,130275,124656,5619,4.3
MT1319140000000,13,19140,"Dalton, GA MSA",2021,7,65882,63464,2418,3.7
MT1323580000000,13,23580,"Gainesville, GA MSA",2021,7,99827,97124,2703,2.7
MT1325980000000,13,25980,"Hinesville, GA MSA",2021,7,30680,29429,1251,4.1
MT1331420000000,13,31420,"Macon-Bibb County, GA MSA",2021,7,98845,94438,4407,4.5
MT1340660000000,13,40660,"Rome, GA MSA",2021,7,43679,42108,1571,3.6
MT1342340000000,13,42340,"Savannah, GA MSA",2021,7,200874,193220,7654,3.8
MT1346660000000,13,46660,"Valdosta, GA MSA",2021,7,61617,59101,2516,4.1
MT1347580000000,13,47580,"Warner Robins, GA MSA",2021,7,88500,85358,3142,3.6
MT1527980000000,15,27980,"Kahului-Wailuku, HI MSA",2021,7,83414,77688,5726,6.9
MT1546520000000,15,46520,"Urban Honolulu, HI MSA",2021,7,462419,439741,22678,4.9
MT1614260000000,16,14260,"Boise City, ID MSA",2021,7,409709,395749,13960,3.4
MT1617660000000,16,17660,"Coeur d'Alene, ID MSA",2021,7,84987,81328,3659,4.3
MT1626820000000,16,26820,"Idaho Falls, ID MSA",2021,7,77547,75321,2226,2.9
MT1630300000000,16,30300,"Lewiston, ID-WA MSA",2021,7,30284,29208,1076,3.6
MT1638540000000,16,38540,"Pocatello, ID MSA",2021,7,38359,36838,1521,4
MT1646300000000,16,46300,"Twin Falls, ID MSA",2021,7,57873,55924,1949,3.4
MT1714010000000,17,14010,"Bloomington, IL MSA",2021,7,88718,84714,4004,4.5
MT1716580000000,17,16580,"Champaign-Urbana, IL MSA",2021,7,121355,115276,6079,5
MT1716980000000,17,16980,"Chicago-Naperville-Elgin, IL-IN MSA",2021,7,4748877,4444592,304285,6.4
MT1719340000000,17,19340,"Davenport-Moline-Rock Island, IA-IL MSA",2021,7,189078,179091,9987,5.3
MT1719500000000,17,19500,"Decatur, IL MSA",2021,7,46026,42458,3568,7.8
MT1728100000000,17,28100,"Kankakee, IL MSA",2021,7,50906,47371,3535,6.9
MT1737900000000,17,37900,"Peoria, IL MSA",2021,7,172728,162300,10428,6
MT1740420000000,17,40420,"Rockford, IL MSA",2021,7,160280,146285,13995,8.7
MT1744100000000,17,44100,"Springfield, IL MSA",2021,7,100964,95111,5853,5.8
MT1814020000000,18,14020,"Bloomington, IN MSA",2021,7,83110,80738,2372,2.9
MT1818020000000,18,18020,"Columbus, IN MSA",2021,7,38201,36877,1324,3.5
MT1821140000000,18,21140,"Elkhart-Goshen, IN MSA",2021,7,105132,101990,3142,3
MT1821780000000,18,21780,"Evansville, IN MSA",2021,7,133177,128337,4840,3.6
MT1823060000000,18,23060,"Fort Wayne, IN MSA",2021,7,224293,216150,8143,3.6
MT1826900000000,18,26900,"Indianapolis-Carmel-Greenwood, IN MSA",2021,7,1073673,1033694,39979,3.7
MT1829020000000,18,29020,"Kokomo, IN MSA",2021,7,36496,34621,1875,5.1
MT1829200000000,18,29200,"Lafayette-West Lafayette, IN MSA",2021,7,113387,109600,3787,3.3
MT1833140000000,18,33140,"Michigan City-La Porte, IN MSA",2021,7,50270,47713,2557,5.1
MT1834620000000,18,34620,"Muncie, IN MSA",2021,7,51454,49252,2202,4.3
MT1843780000000,18,43780,"South Bend-Mishawaka, IN-MI MSA",2021,7,152984,145895,7089,4.6
MT1845460000000,18,45460,"Terre Haute, IN MSA",2021,7,76297,73102,3195,4.2
MT1911180000000,19,11180,"Ames, IA MSA",2021,7,67800,65702,2098,3.1
MT1916300000000,19,16300,"Cedar Rapids, IA MSA",2021,7,148486,141808,6678,4.5
MT1919780000000,19,19780,"Des Moines-West Des Moines, IA MSA",2021,7,389665,374399,15266,3.9
MT1920220000000,19,20220,"Dubuque, IA MSA",2021,7,53266,50959,2307,4.3
MT1926980000000,19,26980,"Iowa City, IA MSA",2021,7,97181,93804,3377,3.5
MT1943580000000,19,43580,"Sioux City, IA-NE-SD MSA",2021,7,75188,72235,2953,3.9
MT1947940000000,19,47940,"Waterloo-Cedar Falls, IA MSA",2021,7,89124,85628,3496,3.9
MT2029940000000,20,29940,"Lawrence, KS MSA",2021,7,67756,65627,2129,3.1
MT2031740000000,20,31740,"Manhattan, KS MSA",2021,7,62304,60422,1882,3
MT2045820000000,20,45820,"Topeka, KS MSA",2021,7,116227,112204,4023,3.5
MT2048620000000,20,48620,"Wichita, KS MSA",2021,7,324773,310120,14653,4.5
MT2114540000000,21,14540,"Bowling Green, KY MSA",2021,7,86430,83044,3386,3.9
MT2121060000000,21,21060,"Elizabethtown, KY MSA",2021,7,53130,50624,2506,4.7
MT2130460000000,21,30460,"Lexington-Fayette, KY MSA",2021,7,262676,252736,9940,3.8
MT2131140000000,21,31140,"Louisville/Jefferson County, KY-IN MSA",2021,7,674316,646983,27333,4.1
MT2136980000000,21,36980,"Owensboro, KY MSA",2021,7,51134,49011,2123,4.2
MT2137140000000,21,37140,"Paducah, KY-IL MSA",2021,7,44841,42577,2264,5
MT2210780000000,22,10780,"Alexandria, LA MSA",2021,7,64651,62109,2542,3.9
MT2212940000000,22,12940,"Baton Rouge, LA MSA",2021,7,412674,391015,21659,5.2
MT2225220000000,22,25220,"Hammond, LA MSA",2021,7,58479,54812,3667,6.3
MT2226380000000,22,26380,"Houma-Bayou Cane-Thibodaux, LA MSA",2021,7,87631,83314,4317,4.9
MT2229180000000,22,29180,"Lafayette, LA MSA",2021,7,193213,184259,8954,4.6
MT2229340000000,22,29340,"Lake Charles, LA MSA",2021,7,102954,96909,6045,5.9
MT2233740000000,22,33740,"Monroe, LA MSA",2021,7,95612,90361,5251,5.5
MT2235380000000,22,35380,"New Orleans-Metairie, LA MSA",2021,7,473849,443928,29921,6.3
MT2243340000000,22,43340,"Shreveport-Bossier City, LA MSA",2021,7,166176,157073,9103,5.5
MT2243640000000,22,43640,"Slidell-Mandeville-Covington, LA MSA",2021,7,123340,118728,4612,3.7
MT2312620000000,23,12620,"Bangor, ME MSA",2021,7,73642,69681,3961,5.4
MT2330340000000,23,30340,"Lewiston-Auburn, ME MSA",2021,7,55595,52551,3044,5.5
MT2338860000000,23,38860,"Portland-South Portland, ME MSA",2021,7,303695,290334,13361,4.4
MT2412580000000,24,12580,"Baltimore-Columbia-Towson, MD MSA",2021,7,1447354,1375967,71387,4.9
MT2425180000000,24,25180,"Hagerstown-Martinsburg, MD-WV MSA",2021,7,140681,134586,6095,4.3
MT2430500000000,24,30500,"Lexington Park, MD MSA",2021,7,105676,101296,4380,4.1
MT2441540000000,24,41540,"Salisbury, MD MSA",2021,7,60183,57085,3098,5.1
MT2511200000000,25,11200,"Amherst Town-Northampton, MA MSA",2021,7,83237,79380,3857,4.6
MT2512700000000,25,12700,"Barnstable Town, MA MSA",2021,7,112555,105442,7113,6.3
MT2514460000000,25,14460,"Boston-Cambridge-Newton, MA-NH MSA",2021,7,2701259,2573464,127795,4.7
MT2538340000000,25,38340,"Pittsfield, MA MSA",2021,7,62936,59121,3815,6.1
MT2544140000000,25,44140,"Springfield, MA MSA",2021,7,225249,209974,15275,6.8
MT2549340000000,25,49340,"Worcester, MA MSA",2021,7,448810,424972,23838,5.3
MT2611460000000,26,11460,"Ann Arbor, MI MSA",2021,7,191535,183650,7885,4.1
MT2612980000000,26,12980,"Battle Creek, MI MSA",2021,7,58403,54530,3873,6.6
MT2613020000000,26,13020,"Bay City, MI MSA",2021,7,47361,44460,2901,6.1
MT2619820000000,26,19820,"Detroit-Warren-Dearborn, MI MSA",2021,7,2107862,1972769,135093,6.4
MT2622420000000,26,22420,"Flint, MI MSA",2021,7,176888,163995,12893,7.3
MT2624340000000,26,24340,"Grand Rapids-Wyoming-Kentwood, MI MSA",2021,7,580648,553685,26963,4.6
MT2627100000000,26,27100,"Jackson, MI MSA",2021,7,70801,66667,4134,5.8
MT2628020000000,26,28020,"Kalamazoo-Portage, MI MSA",2021,7,129836,123537,6299,4.9
MT2629620000000,26,29620,"Lansing-East Lansing, MI MSA",2021,7,230820,218277,12543,5.4
MT2633220000000,26,33220,"Midland, MI MSA",2021,7,38274,36439,1835,4.8
MT2633780000000,26,33780,"Monroe, MI MSA",2021,7,71646,66990,4656,6.5
MT2634740000000,26,34740,"Muskegon-Norton Shores, MI MSA",2021,7,79335,73755,5580,7
MT2635660000000,26,35660,"Niles, MI MSA",2021,7,70872,66868,4004,5.6
MT2640980000000,26,40980,"Saginaw, MI MSA",2021,7,81584,75736,5848,7.2
MT2645900000000,26,45900,"Traverse City, MI MSA",2021,7,74975,70998,3977,5.3
MT2720260000000,27,20260,"Duluth, MN-WI MSA",2021,7,137035,131319,5716,4.2
MT2731860000000,27,31860,"Mankato, MN MSA",2021,7,57480,55606,1874,3.3
MT2733460000000,27,33460,"Minneapolis-St. Paul-Bloomington, MN-WI MSA",2021,7,2006711,1935328,71383,3.6
MT2740340000000,27,40340,"Rochester, MN MSA",2021,7,123576,119780,3796,3.1
MT2741060000000,27,41060,"St. Cloud, MN MSA",2021,7,107165,102774,4391,4.1
MT2825060000000,28,25060,"Gulfport-Biloxi, MS MSA",2021,7,183324,173581,9743,5.3
MT2825620000000,28,25620,"Hattiesburg, MS MSA",2021,7,69543,66031,3512,5.1
MT2827140000000,28,27140,"Jackson, MS MSA",2021,7,275144,260985,14159,5.1
MT2916020000000,29,16020,"Cape Girardeau, MO-IL MSA",2021,7,47325,45655,1670,3.5
MT2917860000000,29,17860,"Columbia, MO MSA",2021,7,111750,108709,3041,2.7
MT2927620000000,29,27620,"Jefferson City, MO MSA",2021,7,72597,70529,2068,2.8
MT2927900000000,29,27900,"Joplin, MO-KS MSA",2021,7,94293,91120,3173,3.4
MT2928140000000,29,28140,"Kansas City, MO-KS MSA",2021,7,1144615,1100242,44373,3.9
MT2941140000000,29,41140,"St. Joseph, MO-KS MSA",2021,7,55733,53665,2068,3.7
MT2941180000000,29,41180,"St. Louis, MO-IL MSA",2021,7,1440704,1375483,65221,4.5
MT2944180000000,29,44180,"Springfield, MO MSA",2021,7,231371,223836,7535,3.3
MT3013740000000,30,13740,"Billings, MT MSA",2021,7,95977,92985,2992,3.1
MT3014580000000,30,14580,"Bozeman, MT MSA",2021,7,71190,69374,1816,2.6
MT3024500000000,30,24500,"Great Falls, MT MSA",2021,7,38508,37226,1282,3.3
MT3025740000000,30,25740,"Helena, MT MSA",2021,7,45001,43616,1385,3.1
MT3033540000000,30,33540,"Missoula, MT MSA",2021,7,70509,68234,2275,3.2
MT3124260000000,31,24260,"Grand Island, NE MSA",2021,7,40758,39579,1179,2.9
MT3130700000000,31,30700,"Lincoln, NE MSA",2021,7,186684,182134,4550,2.4
MT3136540000000,31,36540,"Omaha, NE-IA MSA",2021,7,511332,495807,15525,3
MT3216180000000,32,16180,"Carson City, NV MSA",2021,7,27745,26540,1205,4.3
MT3229820000000,32,29820,"Las Vegas-Henderson-North Las Vegas, NV MSA",2021,7,1093958,1011720,82238,7.5
MT3239900000000,32,39900,"Reno, NV MSA",2021,7,278875,267114,11761,4.2
MT3331700000000,33,31700,"Manchester-Nashua, NH MSA",2021,7,235249,226842,8407,3.6
MT3412100000000,34,12100,"Atlantic City-Hammonton, NJ MSA",2021,7,178475,160649,17826,10
MT3445940000000,34,45940,"Trenton-Princeton, NJ MSA",2021,7,192657,180818,11839,6.1
MT3447220000000,34,47220,"Vineland, NJ MSA",2021,7,65195,59315,5880,9
MT3510740000000,35,10740,"Albuquerque, NM MSA",2021,7,443640,414693,28947,6.5
MT3522140000000,35,22140,"Farmington, NM MSA",2021,7,47985,43934,4051,8.4
MT3529740000000,35,29740,"Las Cruces, NM MSA",2021,7,97127,90188,6939,7.1
MT3542140000000,35,42140,"Santa Fe, NM MSA",2021,7,73122,68425,4697,6.4
MT3610580000000,36,10580,"Albany-Schenectady-Troy, NY MSA",2021,7,449265,429426,19839,4.4
MT3613780000000,36,13780,"Binghamton, NY MSA",2021,7,106213,100715,5498,5.2
MT3615380000000,36,15380,"Buffalo-Cheektowaga, NY MSA",2021,7,554936,524936,30000,5.4
MT3621300000000,36,21300,"Elmira, NY MSA",2021,7,36023,34154,1869,5.2
MT3624020000000,36,24020,"Glens Falls, NY MSA",2021,7,59981,56993,2988,5
MT3627060000000,36,27060,"Ithaca, NY MSA",2021,7,48935,47050,1885,3.9
MT3628740000000,36,28740,"Kingston, NY MSA",2021,7,85614,81496,4118,4.8
MT3628880000000,36,28880,"Kiryas Joel-Poughkeepsie-Newburgh, NY MSA",2021,7,326340,310921,15419,4.7
MT3635620000000,36,35620,"New York-Newark-Jersey City, NY-NJ MSA",2021,7,9755148,8998391,756757,7.8
MT3640380000000,36,40380,"Rochester, NY MSA",2021,7,509616,484163,25453,5
MT3645060000000,36,45060,"Syracuse, NY MSA",2021,7,309198,293568,15630,5.1
MT3646540000000,36,46540,"Utica-Rome, NY MSA",2021,7,129281,122434,6847,5.3
MT3648060000000,36,48060,"Watertown-Fort Drum, NY MSA",2021,7,44751,42287,2464,5.5
MT3711700000000,37,11700,"Asheville, NC MSA",2021,7,197164,188763,8401,4.3
MT3715500000000,37,15500,"Burlington, NC MSA",2021,7,80479,76534,3945,4.9
MT3716740000000,37,16740,"Charlotte-Concord-Gastonia, NC-SC MSA",2021,7,1364492,1300690,63802,4.7
MT3720500000000,37,20500,"Durham-Chapel Hill, NC MSA",2021,7,299199,286862,12337,4.1
MT3722180000000,37,22180,"Fayetteville, NC MSA",2021,7,149574,139820,9754,6.5
MT3724140000000,37,24140,"Goldsboro, NC MSA",2021,7,48980,46502,2478,5.1
MT3724660000000,37,24660,"Greensboro-High Point, NC MSA",2021,7,360524,341033,19491,5.4
MT3724780000000,37,24780,"Greenville, NC MSA",2021,7,79194,75010,4184,5.3
MT3725860000000,37,25860,"Hickory-Lenoir-Morganton, NC MSA",2021,7,164963,156996,7967,4.8
MT3727340000000,37,27340,"Jacksonville, NC MSA",2021,7,68897,65569,3328,4.8
MT3738240000000,37,38240,"Pinehurst-Southern Pines, NC MSA",2021,7,41083,39194,1889,4.6
MT3739580000000,37,39580,"Raleigh-Cary, NC MSA",2021,7,757139,727008,30131,4
MT3740580000000,37,40580,"Rocky Mount, NC MSA",2021,7,63624,59247,4377,6.9
MT3748900000000,37,48900,"Wilmington, NC MSA",2021,7,200987,191244,9743,4.8
MT3749180000000,37,49180,"Winston-Salem, NC MSA",2021,7,312023,296733,15290,4.9
MT3813900000000,38,13900,"Bismarck, ND MSA",2021,7,72194,70252,1942,2.7
MT3822020000000,38,22020,"Fargo, ND-MN MSA",2021,7,145930,142522,3408,2.3
MT3824220000000,38,24220,"Grand Forks, ND-MN MSA",2021,7,54183,52503,1680,3.1
MT3833500000000,38,33500,"Minot, ND MSA",2021,7,39393,38119,1274,3.2
MT3910420000000,39,10420,"Akron, OH MSA",2021,7,352003,333170,18833,5.4
MT3915940000000,39,15940,"Canton-Massillon, OH MSA",2021,7,191388,180649,10739,5.6
MT3917140000000,39,17140,"Cincinnati, OH-KY-IN MSA",2021,7,1128993,1077915,51078,4.5
MT3917410000000,39,17410,"Cleveland, OH MSA",2021,7,1063986,1002804,61182,5.8
MT3918140000000,39,18140,"Columbus, OH MSA",2021,7,1108566,1056641,51925,4.7
MT3919430000000,39,19430,"Dayton-Kettering-Beavercreek, OH MSA",2021,7,381868,361572,20296,5.3
MT3930620000000,39,30620,"Lima, OH MSA",2021,7,47844,45322,2522,5.3
MT3931900000000,39,31900,"Mansfield, OH MSA",2021,7,52823,49686,3137,5.9
MT3941780000000,39,41780,"Sandusky, OH MSA",2021,7,56546,53165,3381,6
MT3944220000000,39,44220,"Springfield, OH MSA",2021,7,61121,57562,3559,5.8
MT3945780000000,39,45780,"Toledo, OH MSA",2021,7,290404,272652,17752,6.1
MT3948260000000,39,48260,"Weirton-Steubenville, WV-OH MSA",2021,7,52595,49442,3153,6
MT3949660000000,39,49660,"Youngstown-Warren, OH MSA",2021,7,187957,176100,11857,6.3
MT4021420000000,40,21420,"Enid, OK MSA",2021,7,28102,27183,919,3.3
MT4030020000000,40,30020,"Lawton, OK MSA",2021,7,50858,49039,1819,3.6
MT4036420000000,40,36420,"Oklahoma City, OK MSA",2021,7,711710,684511,27199,3.8
MT4046140000000,40,46140,"Tulsa, OK MSA",2021,7,488994,470366,18628,3.8
MT4110540000000,41,10540,"Albany, OR MSA",2021,7,60425,57105,3320,5.5
MT4113460000000,41,13460,"Bend, OR MSA",2021,7,125159,118622,6537,5.2
MT4118700000000,41,18700,"Corvallis, OR MSA",2021,7,47035,45241,1794,3.8
MT4121660000000,41,21660,"Eugene-Springfield, OR MSA",2021,7,185270,175527,9743,5.3
MT4124420000000,41,24420,"Grants Pass, OR MSA",2021,7,35405,33147,2258,6.4
MT4132780000000,41,32780,"Medford, OR MSA",2021,7,105616,99967,5649,5.3
MT4138900000000,41,38900,"Portland-Vancouver-Hillsboro, OR-WA MSA",2021,7,1349988,1285754,64234,4.8
MT4141420000000,41,41420,"Salem, OR MSA",2021,7,211242,201053,10189,4.8
MT4210900000000,42,10900,"Allentown-Bethlehem-Easton, PA-NJ MSA",2021,7,440541,413412,27129,6.2
MT4211020000000,42,11020,"Altoona, PA MSA",2021,7,57370,54015,3355,5.8
MT4216540000000,42,16540,"Chambersburg, PA MSA",2021,7,75972,72274,3698,4.9
MT4221500000000,42,21500,"Erie, PA MSA",2021,7,126158,117737,8421,6.7
MT4223900000000,42,23900,"Gettysburg, PA MSA",2021,7,51650,49381,2269,4.4
MT4225420000000,42,25420,"Harrisburg-Carlisle, PA MSA",2021,7,300936,285618,15318,5.1
MT4227780000000,42,27780,"Johnstown, PA MSA",2021,7,57196,53405,3791,6.6
MT4229540000000,42,29540,"Lancaster, PA MSA",2021,7,284286,271305,12981,4.6
MT4230140000000,42,30140,"Lebanon, PA MSA",2021,7,70549,66865,3684,5.2
MT4237980000000,42,37980,"Philadelphia-Camden-Wilmington, PA-NJ-DE-MD MSA",2021,7,3177164,2985337,191827,6
MT4238300000000,42,38300,"Pittsburgh, PA MSA",2021,7,1224608,1151221,73387,6
MT4239740000000,42,39740,"Reading, PA MSA",2021,7,212293,199456,12837,6
MT4242540000000,42,42540,"Scranton--Wilkes-Barre, PA MSA",2021,7,272268,253384,18884,6.9
MT4244300000000,42,44300,"State College, PA MSA",2021,7,73917,70685,3232,4.4
MT4248700000000,42,48700,"Williamsport, PA MSA",2021,7,52483,48926,3557,6.8
MT4249620000000,42,49620,"York-Hanover, PA MSA",2021,7,232934,221054,11880,5.1
MT4439300000000,44,39300,"Providence-Warwick, RI-MA MSA",2021,7,867019,818739,48280,5.6
MT4516700000000,45,16700,"Charleston-North Charleston, SC MSA",2021,7,397610,384096,13514,3.4
MT4517900000000,45,17900,"Columbia, SC MSA",2021,7,393224,379244,13980,3.6
MT4522500000000,45,22500,"Florence, SC MSA",2021,7,88980,85095,3885,4.4
MT4524860000000,45,24860,"Greenville-Anderson-Greer, SC MSA",2021,7,443101,428135,14966,3.4
MT4525940000000,45,25940,"Hilton Head Island-Bluffton-Port Royal, SC MSA",2021,7,91336,88406,2930,3.2
MT4534820000000,45,34820,"Myrtle Beach-Conway-North Myrtle Beach, SC MSA",2021,7,154635,147015,7620,4.9
MT4543900000000,45,43900,"Spartanburg, SC MSA",2021,7,166977,160135,6842,4.1
MT4544940000000,45,44940,"Sumter, SC MSA",2021,7,42230,40366,1864,4.4
MT4639660000000,46,39660,"Rapid City, SD MSA",2021,7,76940,74892,2048,2.7
MT4643620000000,46,43620,"Sioux Falls, SD-MN MSA",2021,7,165292,161441,3851,2.3
MT4716860000000,47,16860,"Chattanooga, TN-GA MSA",2021,7,270762,260318,10444,3.9
MT4717300000000,47,17300,"Clarksville, TN-KY MSA",2021,7,132013,125861,6152,4.7
MT4717420000000,47,17420,"Cleveland, TN MSA",2021,7,57211,54719,2492,4.4
MT4727180000000,47,27180,"Jackson, TN MSA",2021,7,78539,74682,3857,4.9
MT4727740000000,47,27740,"Johnson City, TN MSA",2021,7,95859,92127,3732,3.9
MT4728700000000,47,28700,"Kingsport-Bristol, TN-VA MSA",2021,7,128716,122998,5718,4.4
MT4728940000000,47,28940,"Knoxville, TN MSA",2021,7,431122,415429,15693,3.6
MT4732820000000,47,32820,"Memphis, TN-MS-AR MSA",2021,7,643955,602670,41285,6.4
MT4734100000000,47,34100,"Morristown, TN MSA",2021,7,52372,50094,2278,4.3
MT4734980000000,47,34980,"Nashville-Davidson--Murfreesboro--Franklin, TN MSA",2021,7,1092757,1051412,41345,3.8
MT4810180000000,48,10180,"Abilene, TX MSA",2021,7,80520,76955,3565,4.4
MT4811100000000,48,11100,"Amarillo, TX MSA",2021,7,131072,125944,5128,3.9
MT4812420000000,48,12420,"Austin-Round Rock-San Marcos, TX MSA",2021,7,1313334,1260167,53167,4
MT4813140000000,48,13140,"Beaumont-Port Arthur, TX MSA",2021,7,170465,155365,15100,8.9
MT4815180000000,48,15180,"Brownsville-Harlingen, TX MSA",2021,7,179946,165943,14003,7.8
MT4817780000000,48,17780,"College Station-Bryan, TX MSA",2021,7,135500,129630,5870,4.3
MT4818580000000,48,18580,"Corpus Christi, TX MSA",2021,7,200647,186559,14088,7
MT4819100000000,48,19100,"Dallas-Fort Worth-Arlington, TX MSA",2021,7,4075252,3871418,203834,5
MT4820580000000,48,20580,"Eagle Pass, TX MSA",2021,7,23891,21019,2872,12
MT4821340000000,48,21340,"El Paso, TX MSA",2021,7,384307,361723,22584,5.9
MT4826420000000,48,26420,"Houston-Pasadena-The Woodlands, TX MSA",2021,7,3510483,3293260,217223,6.2
MT4828660000000,48,28660,"Killeen-Temple, TX MSA",2021,7,192590,182116,10474,5.4
MT4829700000000,48,29700,"Laredo, TX MSA",2021,7,111217,104228,6989,6.3
MT4830980000000,48,30980,"Longview, TX MSA",2021,7,125013,117231,7782,6.2
MT4831180000000,48,31180,"Lubbock, TX MSA",2021,7,173356,165172,8184,4.7
MT4832580000000,48,32580,"McAllen-Edinburg-Mission, TX MSA",2021,7,374989,341715,33274,8.9
MT4833260000000,48,33260,"Midland, TX MSA",2021,7,88808,83541,5267,5.9
MT4836220000000,48,36220,"Odessa, TX MSA",2021,7,77649,71613,6036,7.8
MT4841660000000,48,41660,"San Angelo, TX MSA",2021,7,57963,55368,2595,4.5
MT4841700000000,48,41700,"San Antonio-New Braunfels, TX MSA",2021,7,1222773,1160301,62472,5.1
MT4843300000000,48,43300,"Sherman-Denison, TX MSA",2021,7,65680,62717,2963,4.5
MT4845500000000,48,45500,"Texarkana, TX-AR MSA",2021,7,60728,57340,3388,5.6
MT4846340000000,48,46340,"Tyler, TX MSA",2021,7,109765,104158,5607,5.1
MT4847020000000,48,47020,"Victoria, TX MSA",2021,7,44039,41371,2668,6.1
MT4847380000000,48,47380,"Waco, TX MSA",2021,7,136941,130246,6695,4.9
MT4848660000000,48,48660,"Wichita Falls, TX MSA",2021,7,65338,62120,3218,4.9
MT4930860000000,49,30860,"Logan, UT-ID MSA",2021,7,76448,74921,1527,2
MT4936260000000,49,36260,"Ogden, UT MSA",2021,7,324829,316635,8194,2.5
MT4939340000000,49,39340,"Provo-Orem-Lehi, UT MSA",2021,7,339938,332042,7896,2.3
MT4941100000000,49,41100,"St. George, UT MSA",2021,7,82819,80417,2402,2.9
MT4941620000000,49,41620,"Salt Lake City-Murray, UT MSA",2021,7,684217,665103,19114,2.8
MT5015540000000,50,15540,"Burlington-South Burlington, VT MSA",2021,7,123178,119523,3655,3
MT5113980000000,51,13980,"Blacksburg-Christiansburg-Radford, VA MSA",2021,7,87726,84726,3000,3.4
MT5116820000000,51,16820,"Charlottesville, VA MSA",2021,7,111516,107773,3743,3.4
MT5125500000000,51,25500,"Harrisonburg, VA MSA",2021,7,69184,66997,2187,3.2
MT5131340000000,51,31340,"Lynchburg, VA MSA",2021,7,124699,119924,4775,3.8
MT5140060000000,51,40060,"Richmond, VA MSA",2021,7,678058,650632,27426,4
MT5140220000000,51,40220,"Roanoke, VA MSA",2021,7,150470,144627,5843,3.9
MT5144420000000,51,44420,"Staunton-Stuarts Draft, VA MSA",2021,7,61433,59387,2046,3.3
MT5147260000000,51,47260,"Virginia Beach-Chesapeake-Norfolk, VA-NC MSA",2021,7,840798,803107,37691,4.5
MT5149020000000,51,49020,"Winchester, VA-WV MSA",2021,7,71983,69660,2323,3.2
MT5313380000000,53,13380,"Bellingham, WA MSA",2021,7,113970,107936,6034,5.3
MT5314740000000,53,14740,"Bremerton-Silverdale-Port Orchard, WA MSA",2021,7,122541,116643,5898,4.8
MT5328420000000,53,28420,"Kennewick-Richland, WA MSA",2021,7,145368,136971,8397,5.8
MT5331020000000,53,31020,"Longview-Kelso, WA MSA",2021,7,47886,45050,2836,5.9
MT5334580000000,53,34580,"Mount Vernon-Anacortes, WA MSA",2021,7,59171,55584,3587,6.1
MT5336500000000,53,36500,"Olympia-Lacey-Tumwater, WA MSA",2021,7,139274,132311,6963,5
MT5342660000000,53,42660,"Seattle-Tacoma-Bellevue, WA MSA",2021,7,2161416,2054468,106948,4.9
MT5344060000000,53,44060,"Spokane-Spokane Valley, WA MSA",2021,7,282499,268096,14403,5.1
MT5347460000000,53,47460,"Walla Walla, WA MSA",2021,7,30231,28885,1346,4.5
MT5348300000000,53,48300,"Wenatchee-East Wenatchee, WA MSA",2021,7,62854,59497,3357,5.3
MT5349420000000,53,49420,"Yakima, WA MSA",2021,7,128428,119705,8723,6.8
MT5413220000000,54,13220,"Beckley, WV MSA",2021,7,45208,42634,2574,5.7
MT5416620000000,54,16620,"Charleston, WV MSA",2021,7,89803,84890,4913,5.5
MT5426580000000,54,26580,"Huntington-Ashland, WV-KY-OH MSA",2021,7,153090,145110,7980,5.2
MT5434060000000,54,34060,"Morgantown, WV MSA",2021,7,70319,67366,2953,4.2
MT5437620000000,54,37620,"Parkersburg-Vienna, WV MSA",2021,7,38820,36740,2080,5.4
MT5448540000000,54,48540,"Wheeling, WV-OH MSA",2021,7,59605,55855,3750,6.3
MT5511540000000,55,11540,"Appleton, WI MSA",2021,7,134418,130393,4025,3
MT5520740000000,55,20740,"Eau Claire, WI MSA",2021,7,92510,89351,3159,3.4
MT5522540000000,55,22540,"Fond du Lac, WI MSA",2021,7,56091,54316,1775,3.2
MT5524580000000,55,24580,"Green Bay, WI MSA",2021,7,174947,169094,5853,3.3
MT5527500000000,55,27500,"Janesville-Beloit, WI MSA",2021,7,84363,80387,3976,4.7
MT5528450000000,55,28450,"Kenosha, WI MSA",2021,7,91813,87919,3894,4.2
MT5529100000000,55,29100,"La Crosse-Onalaska, WI-MN MSA",2021,7,88602,85848,2754,3.1
MT5531540000000,55,31540,"Madison, WI MSA",2021,7,394023,382665,11358,2.9
MT5533340000000,55,33340,"Milwaukee-Waukesha, WI MSA",2021,7,814301,778697,35604,4.4
MT5536780000000,55,36780,"Oshkosh-Neenah, WI MSA",2021,7,91844,88945,2899,3.2
MT5539540000000,55,39540,"Racine-Mount Pleasant, WI MSA",2021,7,100284,95663,4621,4.6
MT5543100000000,55,43100,"Sheboygan, WI MSA",2021,7,62069,60133,1936,3.1
MT5548140000000,55,48140,"Wausau, WI MSA",2021,7,74445,72252,2193,2.9
MT5616220000000,56,16220,"Casper, WY MSA",2021,7,41021,38736,2285,5.6
MT5616940000000,56,16940,"Cheyenne, WY MSA",2021,7,48823,46817,2006,4.1
MT7210380000000,72,10380,"Aguadilla, PR MSA",2021,7,82850,74850,8000,9.7
MT7211640000000,72,11640,"Arecibo, PR MSA",2021,7,63299,58204,5095,8
MT7225020000000,72,25020,"Guayama, PR MSA",2021,7,19316,17301,2015,10.4
MT7232420000000,72,32420,"Mayaguez, PR MSA",2021,7,65097,58376,6721,10.3
MT7238660000000,72,38660,"Ponce, PR MSA",2021,7,88518,78842,9676,10.9
MT7241980000000,72,41980,"San Juan-Bayamon-Caguas, PR MSA",2021,7,789659,731187,58472,7.4
MT0111500000000,1,11500,"Anniston-Oxford, AL MSA",2021,8,49431,47662,1769,3.6
MT0112220000000,1,12220,"Auburn-Opelika, AL MSA",2021,8,89663,87156,2507,2.8
MT0113820000000,1,13820,"Birmingham, AL MSA",2021,8,550621,534759,15862,2.9
MT0119300000000,1,19300,"Daphne-Fairhope-Foley, AL MSA",2021,8,107269,104466,2803,2.6
MT0119460000000,1,19460,"Decatur, AL MSA",2021,8,71265,69423,1842,2.6
MT0120020000000,1,20020,"Dothan, AL MSA",2021,8,65382,63396,1986,3
MT0122520000000,1,22520,"Florence-Muscle Shoals, AL MSA",2021,8,66068,63907,2161,3.3
MT0123460000000,1,23460,"Gadsden, AL MSA",2021,8,40966,39481,1485,3.6
MT0126620000000,1,26620,"Huntsville, AL MSA",2021,8,249204,243341,5863,2.4
MT0133660000000,1,33660,"Mobile, AL MSA",2021,8,182549,174406,8143,4.5
MT0133860000000,1,33860,"Montgomery, AL MSA",2021,8,171412,164804,6608,3.9
MT0146220000000,1,46220,"Tuscaloosa, AL MSA",2021,8,118776,114573,4203,3.5
MT0211260000000,2,11260,"Anchorage, AK MSA",2021,8,197310,185753,11557,5.9
MT0221820000000,2,21820,"Fairbanks-College, AK MSA",2021,8,44769,42532,2237,5
MT0422380000000,4,22380,"Flagstaff, AZ MSA",2021,8,70580,66580,4000,5.7
MT0429420000000,4,29420,"Lake Havasu City-Kingman, AZ MSA",2021,8,84691,80038,4653,5.5
MT0438060000000,4,38060,"Phoenix-Mesa-Chandler, AZ MSA",2021,8,2528334,2423490,104844,4.1
MT0439150000000,4,39150,"Prescott Valley-Prescott, AZ MSA",2021,8,100673,96591,4082,4.1
MT0443420000000,4,43420,"Sierra Vista-Douglas, AZ MSA",2021,8,47330,44977,2353,5
MT0446060000000,4,46060,"Tucson, AZ MSA",2021,8,484655,462441,22214,4.6
MT0449740000000,4,49740,"Yuma, AZ MSA",2021,8,93931,82059,11872,12.6
MT0522220000000,5,22220,"Fayetteville-Springdale-Rogers, AR MSA",2021,8,275935,268557,7378,2.7
MT0522900000000,5,22900,"Fort Smith, AR-OK MSA",2021,8,98287,94853,3434,3.5
MT0526300000000,5,26300,"Hot Springs, AR MSA",2021,8,43233,41420,1813,4.2
MT0527860000000,5,27860,"Jonesboro, AR MSA",2021,8,63003,60999,2004,3.2
MT0530780000000,5,30780,"Little Rock-North Little Rock-Conway, AR MSA",2021,8,353441,340032,13409,3.8
MT0612540000000,6,12540,"Bakersfield-Delano, CA MSA",2021,8,388700,349971,38729,10
MT0617020000000,6,17020,"Chico, CA MSA",2021,8,90455,84339,6116,6.8
MT0620940000000,6,20940,"El Centro, CA MSA",2021,8,67264,55255,12009,17.9
MT0623420000000,6,23420,"Fresno, CA MSA",2021,8,504433,459144,45289,9
MT0625260000000,6,25260,"Hanford-Corcoran, CA MSA",2021,8,53943,48394,5549,10.3
MT0631080000000,6,31080,"Los Angeles-Long Beach-Anaheim, CA MSA",2021,8,6607307,6094231,513076,7.8
MT0632900000000,6,32900,"Merced, CA MSA",2021,8,114908,103270,11638,10.1
MT0633700000000,6,33700,"Modesto, CA MSA",2021,8,243169,223316,19853,8.2
MT0634900000000,6,34900,"Napa, CA MSA",2021,8,68929,65080,3849,5.6
MT0637100000000,6,37100,"Oxnard-Thousand Oaks-Ventura, CA MSA",2021,8,409846,385582,24264,5.9
MT0639820000000,6,39820,"Redding, CA MSA",2021,8,76212,71138,5074,6.7
MT0640140000000,6,40140,"Riverside-San Bernardino-Ontario, CA MSA",2021,8,2114433,1964196,150237,7.1
MT0640900000000,6,40900,"Sacramento-Roseville-Folsom, CA MSA",2021,8,1130136,1060698,69438,6.1
MT0641500000000,6,41500,"Salinas, CA MSA",2021,8,210503,192562,17941,8.5
MT0641740000000,6,41740,"San Diego-Chula Vista-Carlsbad, CA MSA",2021,8,1580196,1485315,94881,6
MT0641860000000,6,41860,"San Francisco-Oakland-Fremont, CA MSA",2021,8,2454824,2324571,130253,5.3
MT0641940000000,6,41940,"San Jose-Sunnyvale-Santa Clara, CA MSA",2021,8,1022032,973577,48455,4.7
MT0642020000000,6,42020,"San Luis Obispo-Paso Robles, CA MSA",2021,8,130803,124049,6754,5.2
MT0642100000000,6,42100,"Santa Cruz-Watsonville, CA MSA",2021,8,133523,124702,8821,6.6
MT0642200000000,6,42200,"Santa Maria-Santa Barbara, CA MSA",2021,8,216660,204711,11949,5.5
MT0642220000000,6,42220,"Santa Rosa-Petaluma, CA MSA",2021,8,241862,229136,12726,5.3
MT0644700000000,6,44700,"Stockton-Lodi, CA MSA",2021,8,350172,321421,28751,8.2
MT0646700000000,6,46700,"Vallejo, CA MSA",2021,8,208987,194430,14557,7
MT0647300000000,6,47300,"Visalia, CA MSA",2021,8,204310,182715,21595,10.6
MT0649700000000,6,49700,"Yuba City, CA MSA",2021,8,77184,70330,6854,8.9
MT0814500000000,8,14500,"Boulder, CO MSA",2021,8,190076,181580,8496,4.5
MT0817820000000,8,17820,"Colorado Springs, CO MSA",2021,8,378851,357942,20909,5.5
MT0819740000000,8,19740,"Denver-Aurora-Centennial, CO MSA",2021,8,1717412,1624826,92586,5.4
MT0822660000000,8,22660,"Fort Collins-Loveland, CO MSA",2021,8,200321,190667,9654,4.8
MT0824300000000,8,24300,"Grand Junction, CO MSA",2021,8,78812,74312,4500,5.7
MT0824540000000,8,24540,"Greeley, CO MSA",2021,8,167896,158267,9629,5.7
MT0839380000000,8,39380,"Pueblo, CO MSA",2021,8,75670,69425,6245,8.3
MT0914860000000,9,14860,"Bridgeport-Stamford-Danbury, CT MSA",2021,8,489421,461156,28265,5.8
MT0925540000000,9,25540,"Hartford-West Hartford-East Hartford, CT MSA",2021,8,592962,555376,37586,6.3
MT0935300000000,9,35300,"New Haven, CT MSA",2021,8,302870,283810,19060,6.3
MT0935980000000,9,35980,"Norwich-New London-Willimantic, CT MSA",2021,8,134418,124925,9493,7.1
MT0947930000000,9,47930,"Waterbury-Shelton, CT MSA",2021,8,234608,218343,16265,6.9
MT1020100000000,10,20100,"Dover, DE MSA",2021,8,85328,80335,4993,5.9
MT1147900000000,11,47900,"Washington-Arlington-Alexandria, DC-VA-MD-WV MSA",2021,8,3386332,3244852,141480,4.2
MT1215980000000,12,15980,"Cape Coral-Fort Myers, FL MSA",2021,8,350394,335568,14826,4.2
MT1218880000000,12,18880,"Crestview-Fort Walton Beach-Destin, FL MSA",2021,8,134708,130129,4579,3.4
MT1219660000000,12,19660,"Deltona-Daytona Beach-Ormond Beach, FL MSA",2021,8,299845,285783,14062,4.7
MT1223540000000,12,23540,"Gainesville, FL MSA",2021,8,162861,156458,6403,3.9
MT1226140000000,12,26140,"Homosassa Springs, FL MSA",2021,8,50590,47852,2738,5.4
MT1227260000000,12,27260,"Jacksonville, FL MSA",2021,8,798406,766416,31990,4
MT1229460000000,12,29460,"Lakeland-Winter Haven, FL MSA",2021,8,336042,318903,17139,5.1
MT1233100000000,12,33100,"Miami-Fort Lauderdale-West Palm Beach, FL MSA",2021,8,3084482,2941664,142818,4.6
MT1234940000000,12,34940,"Naples-Marco Island, FL MSA",2021,8,169477,163170,6307,3.7
MT1235840000000,12,35840,"North Port-Bradenton-Sarasota, FL MSA",2021,8,363134,348717,14417,4
MT1236100000000,12,36100,"Ocala, FL MSA",2021,8,146764,139585,7179,4.9
MT1236740000000,12,36740,"Orlando-Kissimmee-Sanford, FL MSA",2021,8,1379487,1314482,65005,4.7
MT1237340000000,12,37340,"Palm Bay-Melbourne-Titusville, FL MSA",2021,8,288479,276923,11556,4
MT1237460000000,12,37460,"Panama City-Panama City Beach, FL MSA",2021,8,95102,91332,3770,4
MT1237860000000,12,37860,"Pensacola-Ferry Pass-Brent, FL MSA",2021,8,230078,220502,9576,4.2
MT1238940000000,12,38940,"Port St. Lucie, FL MSA",2021,8,223081,213199,9882,4.4
MT1239460000000,12,39460,"Punta Gorda, FL MSA",2021,8,69677,66451,3226,4.6
MT1242680000000,12,42680,"Sebastian-Vero Beach-West Vero Corridor, FL MSA",2021,8,63261,60257,3004,4.7
MT1242700000000,12,42700,"Sebring, FL MSA",2021,8,34550,32539,2011,5.8
MT1245220000000,12,45220,"Tallahassee, FL MSA",2021,8,195270,187085,8185,4.2
MT1245300000000,12,45300,"Tampa-St. Petersburg-Clearwater, FL MSA",2021,8,1581836,1515641,66195,4.2
MT1248680000000,12,48680,"Wildwood-The Villages, FL MSA",2021,8,30012,28125,1887,6.3
MT1310500000000,13,10500,"Albany, GA MSA",2021,8,63258,60184,3074,4.9
MT1312020000000,13,12020,"Athens-Clarke County, GA MSA",2021,8,102495,99374,3121,3
MT1312060000000,13,12060,"Atlanta-Sandy Springs-Roswell, GA MSA",2021,8,3132712,3020581,112131,3.6
MT1312260000000,13,12260,"Augusta-Richmond County, GA-SC MSA",2021,8,264146,254247,9899,3.7
MT1315260000000,13,15260,"Brunswick-St. Simons, GA MSA",2021,8,51446,49657,1789,3.5
MT1317980000000,13,17980,"Columbus, GA-AL MSA",2021,8,130139,124778,5361,4.1
MT1319140000000,13,19140,"Dalton, GA MSA",2021,8,65783,63495,2288,3.5
MT1323580000000,13,23580,"Gainesville, GA MSA",2021,8,99890,97261,2629,2.6
MT1325980000000,13,25980,"Hinesville, GA MSA",2021,8,30611,29404,1207,3.9
MT1331420000000,13,31420,"Macon-Bibb County, GA MSA",2021,8,98673,94522,4151,4.2
MT1340660000000,13,40660,"Rome, GA MSA",2021,8,43638,42117,1521,3.5
MT1342340000000,13,42340,"Savannah, GA MSA",2021,8,201201,193953,7248,3.6
MT1346660000000,13,46660,"Valdosta, GA MSA",2021,8,61430,59047,2383,3.9
MT1347580000000,13,47580,"Warner Robins, GA MSA",2021,8,88369,85348,3021,3.4
MT1527980000000,15,27980,"Kahului-Wailuku, HI MSA",2021,8,83191,78350,4841,5.8
MT1546520000000,15,46520,"Urban Honolulu, HI MSA",2021,8,460272,440847,19425,4.2
MT1614260000000,16,14260,"Boise City, ID MSA",2021,8,411073,397808,13265,3.2
MT1617660000000,16,17660,"Coeur d'Alene, ID MSA",2021,8,85194,81686,3508,4.1
MT1626820000000,16,26820,"Idaho Falls, ID MSA",2021,8,77771,75647,2124,2.7
MT1630300000000,16,30300,"Lewiston, ID-WA MSA",2021,8,30294,29257,1037,3.4
MT1638540000000,16,38540,"Pocatello, ID MSA",2021,8,38483,37040,1443,3.7
MT1646300000000,16,46300,"Twin Falls, ID MSA",2021,8,57889,56035,1854,3.2
MT1714010000000,17,14010,"Bloomington, IL MSA",2021,8,88975,85118,3857,4.3
MT1716580000000,17,16580,"Champaign-Urbana, IL MSA",2021,8,121494,115620,5874,4.8
MT1716980000000,17,16980,"Chicago-Naperville-Elgin, IL-IN MSA",2021,8,4757467,4471619,285848,6
MT1719340000000,17,19340,"Davenport-Moline-Rock Island, IA-IL MSA",2021,8,189002,179655,9347,4.9
MT1719500000000,17,19500,"Decatur, IL MSA",2021,8,45901,42463,3438,7.5
MT1728100000000,17,28100,"Kankakee, IL MSA",2021,8,50676,47264,3412,6.7
MT1737900000000,17,37900,"Peoria, IL MSA",2021,8,172634,162661,9973,5.8
MT1740420000000,17,40420,"Rockford, IL MSA",2021,8,159982,146555,13427,8.4
MT1744100000000,17,44100,"Springfield, IL MSA",2021,8,101176,95581,5595,5.5
MT1814020000000,18,14020,"Bloomington, IN MSA",2021,8,83019,80759,2260,2.7
MT1818020000000,18,18020,"Columbus, IN MSA",2021,8,38080,36832,1248,3.3
MT1821140000000,18,21140,"Elkhart-Goshen, IN MSA",2021,8,105289,102346,2943,2.8
MT1821780000000,18,21780,"Evansville, IN MSA",2021,8,132985,128402,4583,3.4
MT1823060000000,18,23060,"Fort Wayne, IN MSA",2021,8,218554,210883,7671,3.5
MT1826900000000,18,26900,"Indianapolis-Carmel-Greenwood, IN MSA",2021,8,1074579,1037031,37548,3.5
MT1829020000000,18,29020,"Kokomo, IN MSA",2021,8,36247,34470,1777,4.9
MT1829200000000,18,29200,"Lafayette-West Lafayette, IN MSA",2021,8,113402,109779,3623,3.2
MT1833140000000,18,33140,"Michigan City-La Porte, IN MSA",2021,8,50210,47830,2380,4.7
MT1834620000000,18,34620,"Muncie, IN MSA",2021,8,51300,49187,2113,4.1
MT1843780000000,18,43780,"South Bend-Mishawaka, IN-MI MSA",2021,8,152591,145958,6633,4.3
MT1845460000000,18,45460,"Terre Haute, IN MSA",2021,8,76003,72973,3030,4
MT1911180000000,19,11180,"Ames, IA MSA",2021,8,67794,65788,2006,3
MT1916300000000,19,16300,"Cedar Rapids, IA MSA",2021,8,148092,142144,5948,4
MT1919780000000,19,19780,"Des Moines-West Des Moines, IA MSA",2021,8,389875,376177,13698,3.5
MT1920220000000,19,20220,"Dubuque, IA MSA",2021,8,53267,51092,2175,4.1
MT1926980000000,19,26980,"Iowa City, IA MSA",2021,8,97104,94060,3044,3.1
MT1943580000000,19,43580,"Sioux City, IA-NE-SD MSA",2021,8,75291,72520,2771,3.7
MT1947940000000,19,47940,"Waterloo-Cedar Falls, IA MSA",2021,8,89137,85854,3283,3.7
MT2029940000000,20,29940,"Lawrence, KS MSA",2021,8,67906,65873,2033,3
MT2031740000000,20,31740,"Manhattan, KS MSA",2021,8,62440,60623,1817,2.9
MT2045820000000,20,45820,"Topeka, KS MSA",2021,8,116092,112232,3860,3.3
MT2048620000000,20,48620,"Wichita, KS MSA",2021,8,324426,310732,13694,4.2
MT2114540000000,21,14540,"Bowling Green, KY MSA",2021,8,86764,83414,3350,3.9
MT2121060000000,21,21060,"Elizabethtown, KY MSA",2021,8,53200,50718,2482,4.7
MT2130460000000,21,30460,"Lexington-Fayette, KY MSA",2021,8,263595,253809,9786,3.7
MT2131140000000,21,31140,"Louisville/Jefferson County, KY-IN MSA",2021,8,675736,648818,26918,4
MT2136980000000,21,36980,"Owensboro, KY MSA",2021,8,51324,49230,2094,4.1
MT2137140000000,21,37140,"Paducah, KY-IL MSA",2021,8,44870,42625,2245,5
MT2210780000000,22,10780,"Alexandria, LA MSA",2021,8,64612,62218,2394,3.7
MT2212940000000,22,12940,"Baton Rouge, LA MSA",2021,8,411749,391718,20031,4.9
MT2225220000000,22,25220,"Hammond, LA MSA",2021,8,58349,54910,3439,5.9
MT2226380000000,22,26380,"Houma-Bayou Cane-Thibodaux, LA MSA",2021,8,87463,83316,4147,4.7
MT2229180000000,22,29180,"Lafayette, LA MSA",2021,8,193440,185157,8283,4.3
MT2229340000000,22,29340,"Lake Charles, LA MSA",2021,8,102938,97435,5503,5.3
MT2233740000000,22,33740,"Monroe, LA MSA",2021,8,95632,90743,4889,5.1
MT2235380000000,22,35380,"New Orleans-Metairie, LA MSA",2021,8,472916,445142,27774,5.9
MT2243340000000,22,43340,"Shreveport-Bossier City, LA MSA",2021,8,166121,157736,8385,5
MT2243640000000,22,43640,"Slidell-Mandeville-Covington, LA MSA",2021,8,123401,119070,4331,3.5
MT2312620000000,23,12620,"Bangor, ME MSA",2021,8,73784,69929,3855,5.2
MT2330340000000,23,30340,"Lewiston-Auburn, ME MSA",2021,8,55624,52664,2960,5.3
MT2338860000000,23,38860,"Portland-South Portland, ME MSA",2021,8,303805,291061,12744,4.2
MT2412580000000,24,12580,"Baltimore-Columbia-Towson, MD MSA",2021,8,1447434,1379982,67452,4.7
MT2425180000000,24,25180,"Hagerstown-Martinsburg, MD-WV MSA",2021,8,140556,134796,5760,4.1
MT2430500000000,24,30500,"Lexington Park, MD MSA",2021,8,105846,101635,4211,4
MT2441540000000,24,41540,"Salisbury, MD MSA",2021,8,60189,57176,3013,5
MT2511200000000,25,11200,"Amherst Town-Northampton, MA MSA",2021,8,83476,79771,3705,4.4
MT2512700000000,25,12700,"Barnstable Town, MA MSA",2021,8,112457,105640,6817,6.1
MT2514460000000,25,14460,"Boston-Cambridge-Newton, MA-NH MSA",2021,8,2703751,2583162,120589,4.5
MT2538340000000,25,38340,"Pittsfield, MA MSA",2021,8,63006,59386,3620,5.7
MT2544140000000,25,44140,"Springfield, MA MSA",2021,8,224894,210461,14433,6.4
MT2549340000000,25,49340,"Worcester, MA MSA",2021,8,449152,426434,22718,5.1
MT2611460000000,26,11460,"Ann Arbor, MI MSA",2021,8,192161,184704,7457,3.9
MT2612980000000,26,12980,"Battle Creek, MI MSA",2021,8,58384,54697,3687,6.3
MT2613020000000,26,13020,"Bay City, MI MSA",2021,8,47447,44645,2802,5.9
MT2619820000000,26,19820,"Detroit-Warren-Dearborn, MI MSA",2021,8,2109843,1980579,129264,6.1
MT2622420000000,26,22420,"Flint, MI MSA",2021,8,177075,164704,12371,7
MT2624340000000,26,24340,"Grand Rapids-Wyoming-Kentwood, MI MSA",2021,8,582727,557119,25608,4.4
MT2627100000000,26,27100,"Jackson, MI MSA",2021,8,70943,66986,3957,5.6
MT2628020000000,26,28020,"Kalamazoo-Portage, MI MSA",2021,8,130075,124080,5995,4.6
MT2629620000000,26,29620,"Lansing-East Lansing, MI MSA",2021,8,231162,219094,12068,5.2
MT2633220000000,26,33220,"Midland, MI MSA",2021,8,38417,36646,1771,4.6
MT2633780000000,26,33780,"Monroe, MI MSA",2021,8,71624,67254,4370,6.1
MT2634740000000,26,34740,"Muskegon-Norton Shores, MI MSA",2021,8,79540,74274,5266,6.6
MT2635660000000,26,35660,"Niles, MI MSA",2021,8,70933,67088,3845,5.4
MT2640980000000,26,40980,"Saginaw, MI MSA",2021,8,81685,76049,5636,6.9
MT2645900000000,26,45900,"Traverse City, MI MSA",2021,8,75282,71459,3823,5.1
MT2720260000000,27,20260,"Duluth, MN-WI MSA",2021,8,137293,131744,5549,4
MT2731860000000,27,31860,"Mankato, MN MSA",2021,8,57418,55626,1792,3.1
MT2733460000000,27,33460,"Minneapolis-St. Paul-Bloomington, MN-WI MSA",2021,8,2008046,1940191,67855,3.4
MT2740340000000,27,40340,"Rochester, MN MSA",2021,8,123513,119853,3660,3
MT2741060000000,27,41060,"St. Cloud, MN MSA",2021,8,107046,102854,4192,3.9
MT2825060000000,28,25060,"Gulfport-Biloxi, MS MSA",2021,8,183787,174651,9136,5
MT2825620000000,28,25620,"Hattiesburg, MS MSA",2021,8,69687,66403,3284,4.7
MT2827140000000,28,27140,"Jackson, MS MSA",2021,8,275282,262025,13257,4.8
MT2916020000000,29,16020,"Cape Girardeau, MO-IL MSA",2021,8,47273,45671,1602,3.4
MT2917860000000,29,17860,"Columbia, MO MSA",2021,8,111794,108845,2949,2.6
MT2927620000000,29,27620,"Jefferson City, MO MSA",2021,8,72570,70549,2021,2.8
MT2927900000000,29,27900,"Joplin, MO-KS MSA",2021,8,94265,91242,3023,3.2
MT2928140000000,29,28140,"Kansas City, MO-KS MSA",2021,8,1146407,1103110,43297,3.8
MT2941140000000,29,41140,"St. Joseph, MO-KS MSA",2021,8,55701,53720,1981,3.6
MT2941180000000,29,41180,"St. Louis, MO-IL MSA",2021,8,1441558,1379786,61772,4.3
MT2944180000000,29,44180,"Springfield, MO MSA",2021,8,231559,224366,7193,3.1
MT3013740000000,30,13740,"Billings, MT MSA",2021,8,96123,93281,2842,3
MT3014580000000,30,14580,"Bozeman, MT MSA",2021,8,71423,69702,1721,2.4
MT3024500000000,30,24500,"Great Falls, MT MSA",2021,8,38553,37337,1216,3.2
MT3025740000000,30,25740,"Helena, MT MSA",2021,8,45058,43727,1331,3
MT3033540000000,30,33540,"Missoula, MT MSA",2021,8,70602,68434,2168,3.1
MT3124260000000,31,24260,"Grand Island, NE MSA",2021,8,40801,39677,1124,2.8
MT3130700000000,31,30700,"Lincoln, NE MSA",2021,8,187057,182727,4330,2.3
MT3136540000000,31,36540,"Omaha, NE-IA MSA",2021,8,511965,497225,14740,2.9
MT3216180000000,32,16180,"Carson City, NV MSA",2021,8,27572,26420,1152,4.2
MT3229820000000,32,29820,"Las Vegas-Henderson-North Las Vegas, NV MSA",2021,8,1095587,1018605,76982,7
MT3239900000000,32,39900,"Reno, NV MSA",2021,8,278035,266846,11189,4
MT3331700000000,33,31700,"Manchester-Nashua, NH MSA",2021,8,235343,227439,7904,3.4
MT3412100000000,34,12100,"Atlantic City-Hammonton, NJ MSA",2021,8,177921,160872,17049,9.6
MT3445940000000,34,45940,"Trenton-Princeton, NJ MSA",2021,8,192503,181017,11486,6
MT3447220000000,34,47220,"Vineland, NJ MSA",2021,8,64973,59253,5720,8.8
MT3510740000000,35,10740,"Albuquerque, NM MSA",2021,8,442933,415453,27480,6.2
MT3522140000000,35,22140,"Farmington, NM MSA",2021,8,48089,44230,3859,8
MT3529740000000,35,29740,"Las Cruces, NM MSA",2021,8,97438,90738,6700,6.9
MT3542140000000,35,42140,"Santa Fe, NM MSA",2021,8,73181,68741,4440,6.1
MT3610580000000,36,10580,"Albany-Schenectady-Troy, NY MSA",2021,8,449542,430924,18618,4.1
MT3613780000000,36,13780,"Binghamton, NY MSA",2021,8,106090,100902,5188,4.9
MT3615380000000,36,15380,"Buffalo-Cheektowaga, NY MSA",2021,8,553620,525663,27957,5
MT3621300000000,36,21300,"Elmira, NY MSA",2021,8,36006,34249,1757,4.9
MT3624020000000,36,24020,"Glens Falls, NY MSA",2021,8,59839,57017,2822,4.7
MT3627060000000,36,27060,"Ithaca, NY MSA",2021,8,48880,47075,1805,3.7
MT3628740000000,36,28740,"Kingston, NY MSA",2021,8,85547,81681,3866,4.5
MT3628880000000,36,28880,"Kiryas Joel-Poughkeepsie-Newburgh, NY MSA",2021,8,326489,311999,14490,4.4
MT3635620000000,36,35620,"New York-Newark-Jersey City, NY-NJ MSA",2021,8,9755651,9039335,716316,7.3
MT3640380000000,36,40380,"Rochester, NY MSA",2021,8,508992,485246,23746,4.7
MT3645060000000,36,45060,"Syracuse, NY MSA",2021,8,308658,294001,14657,4.7
MT3646540000000,36,46540,"Utica-Rome, NY MSA",2021,8,128915,122461,6454,5
MT3648060000000,36,48060,"Watertown-Fort Drum, NY MSA",2021,8,44731,42383,2348,5.2
MT3711700000000,37,11700,"Asheville, NC MSA",2021,8,198843,190825,8018,4
MT3715500000000,37,15500,"Burlington, NC MSA",2021,8,80895,77077,3818,4.7
MT3716740000000,37,16740,"Charlotte-Concord-Gastonia, NC-SC MSA",2021,8,1372451,1311094,61357,4.5
MT3720500000000,37,20500,"Durham-Chapel Hill, NC MSA",2021,8,301403,289499,11904,3.9
MT3722180000000,37,22180,"Fayetteville, NC MSA",2021,8,150452,141074,9378,6.2
MT3724140000000,37,24140,"Goldsboro, NC MSA",2021,8,49121,46721,2400,4.9
MT3724660000000,37,24660,"Greensboro-High Point, NC MSA",2021,8,362686,343918,18768,5.2
MT3724780000000,37,24780,"Greenville, NC MSA",2021,8,79578,75511,4067,5.1
MT3725860000000,37,25860,"Hickory-Lenoir-Morganton, NC MSA",2021,8,165924,158307,7617,4.6
MT3727340000000,37,27340,"Jacksonville, NC MSA",2021,8,69419,66232,3187,4.6
MT3738240000000,37,38240,"Pinehurst-Southern Pines, NC MSA",2021,8,41298,39469,1829,4.4
MT3739580000000,37,39580,"Raleigh-Cary, NC MSA",2021,8,762637,733633,29004,3.8
MT3740580000000,37,40580,"Rocky Mount, NC MSA",2021,8,63978,59720,4258,6.7
MT3748900000000,37,48900,"Wilmington, NC MSA",2021,8,202544,193224,9320,4.6
MT3749180000000,37,49180,"Winston-Salem, NC MSA",2021,8,313388,298680,14708,4.7
MT3813900000000,38,13900,"Bismarck, ND MSA",2021,8,72256,70422,1834,2.5
MT3822020000000,38,22020,"Fargo, ND-MN MSA",2021,8,146419,143076,3343,2.3
MT3824220000000,38,24220,"Grand Forks, ND-MN MSA",2021,8,54166,52577,1589,2.9
MT3833500000000,38,33500,"Minot, ND MSA",2021,8,39440,38241,1199,3
MT3910420000000,39,10420,"Akron, OH MSA",2021,8,351268,333751,17517,5
MT3915940000000,39,15940,"Canton-Massillon, OH MSA",2021,8,190881,180907,9974,5.2
MT3917140000000,39,17140,"Cincinnati, OH-KY-IN MSA",2021,8,1130510,1081969,48541,4.3
MT3917410000000,39,17410,"Cleveland, OH MSA",2021,8,1064295,1005204,59091,5.6
MT3918140000000,39,18140,"Columbus, OH MSA",2021,8,1108915,1060986,47929,4.3
MT3919430000000,39,19430,"Dayton-Kettering-Beavercreek, OH MSA",2021,8,381229,362343,18886,5
MT3930620000000,39,30620,"Lima, OH MSA",2021,8,47670,45289,2381,5
MT3931900000000,39,31900,"Mansfield, OH MSA",2021,8,52731,49775,2956,5.6
MT3941780000000,39,41780,"Sandusky, OH MSA",2021,8,56599,53347,3252,5.7
MT3944220000000,39,44220,"Springfield, OH MSA",2021,8,61121,57742,3379,5.5
MT3945780000000,39,45780,"Toledo, OH MSA",2021,8,289716,273287,16429,5.7
MT3948260000000,39,48260,"Weirton-Steubenville, WV-OH MSA",2021,8,52627,49606,3021,5.7
MT3949660000000,39,49660,"Youngstown-Warren, OH MSA",2021,8,187766,176745,11021,5.9
MT4021420000000,40,21420,"Enid, OK MSA",2021,8,28059,27204,855,3
MT4030020000000,40,30020,"Lawton, OK MSA",2021,8,50793,49099,1694,3.3
MT4036420000000,40,36420,"Oklahoma City, OK MSA",2021,8,712011,687323,24688,3.5
MT4046140000000,40,46140,"Tulsa, OK MSA",2021,8,488465,471487,16978,3.5
MT4110540000000,41,10540,"Albany, OR MSA",2021,8,60384,57261,3123,5.2
MT4113460000000,41,13460,"Bend, OR MSA",2021,8,124909,118811,6098,4.9
MT4118700000000,41,18700,"Corvallis, OR MSA",2021,8,47177,45479,1698,3.6
MT4121660000000,41,21660,"Eugene-Springfield, OR MSA",2021,8,185171,176057,9114,4.9
MT4124420000000,41,24420,"Grants Pass, OR MSA",2021,8,35253,33120,2133,6.1
MT4132780000000,41,32780,"Medford, OR MSA",2021,8,105176,99824,5352,5.1
MT4138900000000,41,38900,"Portland-Vancouver-Hillsboro, OR-WA MSA",2021,8,1350746,1290732,60014,4.4
MT4141420000000,41,41420,"Salem, OR MSA",2021,8,210755,201160,9595,4.6
MT4210900000000,42,10900,"Allentown-Bethlehem-Easton, PA-NJ MSA",2021,8,440382,414557,25825,5.9
MT4211020000000,42,11020,"Altoona, PA MSA",2021,8,57253,54038,3215,5.6
MT4216540000000,42,16540,"Chambersburg, PA MSA",2021,8,75974,72471,3503,4.6
MT4221500000000,42,21500,"Erie, PA MSA",2021,8,125780,117823,7957,6.3
MT4223900000000,42,23900,"Gettysburg, PA MSA",2021,8,51679,49500,2179,4.2
MT4225420000000,42,25420,"Harrisburg-Carlisle, PA MSA",2021,8,300907,286307,14600,4.9
MT4227780000000,42,27780,"Johnstown, PA MSA",2021,8,57089,53451,3638,6.4
MT4229540000000,42,29540,"Lancaster, PA MSA",2021,8,284526,272093,12433,4.4
MT4230140000000,42,30140,"Lebanon, PA MSA",2021,8,70555,67047,3508,5
MT4237980000000,42,37980,"Philadelphia-Camden-Wilmington, PA-NJ-DE-MD MSA",2021,8,3175393,2993108,182285,5.7
MT4238300000000,42,38300,"Pittsburgh, PA MSA",2021,8,1222730,1153040,69690,5.7
MT4239740000000,42,39740,"Reading, PA MSA",2021,8,212285,200119,12166,5.7
MT4242540000000,42,42540,"Scranton--Wilkes-Barre, PA MSA",2021,8,272346,254299,18047,6.6
MT4244300000000,42,44300,"State College, PA MSA",2021,8,73986,70863,3123,4.2
MT4248700000000,42,48700,"Williamsport, PA MSA",2021,8,52227,48839,3388,6.5
MT4249620000000,42,49620,"York-Hanover, PA MSA",2021,8,232748,221452,11296,4.9
MT4439300000000,44,39300,"Providence-Warwick, RI-MA MSA",2021,8,867202,821594,45608,5.3
MT4516700000000,45,16700,"Charleston-North Charleston, SC MSA",2021,8,398409,385469,12940,3.2
MT4517900000000,45,17900,"Columbia, SC MSA",2021,8,393156,379729,13427,3.4
MT4522500000000,45,22500,"Florence, SC MSA",2021,8,88984,85269,3715,4.2
MT4524860000000,45,24860,"Greenville-Anderson-Greer, SC MSA",2021,8,444191,429826,14365,3.2
MT4525940000000,45,25940,"Hilton Head Island-Bluffton-Port Royal, SC MSA",2021,8,91391,88556,2835,3.1
MT4534820000000,45,34820,"Myrtle Beach-Conway-North Myrtle Beach, SC MSA",2021,8,154910,147621,7289,4.7
MT4543900000000,45,43900,"Spartanburg, SC MSA",2021,8,166711,160181,6530,3.9
MT4544940000000,45,44940,"Sumter, SC MSA",2021,8,42050,40255,1795,4.3
MT4639660000000,46,39660,"Rapid City, SD MSA",2021,8,76990,75031,1959,2.5
MT4643620000000,46,43620,"Sioux Falls, SD-MN MSA",2021,8,165476,161781,3695,2.2
MT4716860000000,47,16860,"Chattanooga, TN-GA MSA",2021,8,270650,260751,9899,3.7
MT4717300000000,47,17300,"Clarksville, TN-KY MSA",2021,8,132158,126280,5878,4.4
MT4717420000000,47,17420,"Cleveland, TN MSA",2021,8,57001,54660,2341,4.1
MT4727180000000,47,27180,"Jackson, TN MSA",2021,8,78505,74891,3614,4.6
MT4727740000000,47,27740,"Johnson City, TN MSA",2021,8,95927,92385,3542,3.7
MT4728700000000,47,28700,"Kingsport-Bristol, TN-VA MSA",2021,8,128679,123324,5355,4.2
MT4728940000000,47,28940,"Knoxville, TN MSA",2021,8,431857,417048,14809,3.4
MT4732820000000,47,32820,"Memphis, TN-MS-AR MSA",2021,8,643214,604851,38363,6
MT4734100000000,47,34100,"Morristown, TN MSA",2021,8,52376,50202,2174,4.2
MT4734980000000,47,34980,"Nashville-Davidson--Murfreesboro--Franklin, TN MSA",2021,8,1096693,1057904,38789,3.5
MT4810180000000,48,10180,"Abilene, TX MSA",2021,8,80720,77255,3465,4.3
MT4811100000000,48,11100,"Amarillo, TX MSA",2021,8,131389,126394,4995,3.8
MT4812420000000,48,12420,"Austin-Round Rock-San Marcos, TX MSA",2021,8,1322249,1271184,51065,3.9
MT4813140000000,48,13140,"Beaumont-Port Arthur, TX MSA",2021,8,170035,155758,14277,8.4
MT4815180000000,48,15180,"Brownsville-Harlingen, TX MSA",2021,8,179928,166589,13339,7.4
MT4817780000000,48,17780,"College Station-Bryan, TX MSA",2021,8,136017,130332,5685,4.2
MT4818580000000,48,18580,"Corpus Christi, TX MSA",2021,8,200619,187209,13410,6.7
MT4819100000000,48,19100,"Dallas-Fort Worth-Arlington, TX MSA",2021,8,4089624,3894934,194690,4.8
MT4820580000000,48,20580,"Eagle Pass, TX MSA",2021,8,23738,21026,2712,11.4
MT4821340000000,48,21340,"El Paso, TX MSA",2021,8,384961,363478,21483,5.6
MT4826420000000,48,26420,"Houston-Pasadena-The Woodlands, TX MSA",2021,8,3518747,3312265,206482,5.9
MT4828660000000,48,28660,"Killeen-Temple, TX MSA",2021,8,192895,182716,10179,5.3
MT4829700000000,48,29700,"Laredo, TX MSA",2021,8,111399,104733,6666,6
MT4830980000000,48,30980,"Longview, TX MSA",2021,8,125141,117719,7422,5.9
MT4831180000000,48,31180,"Lubbock, TX MSA",2021,8,173763,165884,7879,4.5
MT4832580000000,48,32580,"McAllen-Edinburg-Mission, TX MSA",2021,8,375217,343550,31667,8.4
MT4833260000000,48,33260,"Midland, TX MSA",2021,8,89138,84208,4930,5.5
MT4836220000000,48,36220,"Odessa, TX MSA",2021,8,77702,72121,5581,7.2
MT4841660000000,48,41660,"San Angelo, TX MSA",2021,8,58101,55595,2506,4.3
MT4841700000000,48,41700,"San Antonio-New Braunfels, TX MSA",2021,8,1226114,1166236,59878,4.9
MT4843300000000,48,43300,"Sherman-Denison, TX MSA",2021,8,65747,62845,2902,4.4
MT4845500000000,48,45500,"Texarkana, TX-AR MSA",2021,8,60595,57359,3236,5.3
MT4846340000000,48,46340,"Tyler, TX MSA",2021,8,109833,104497,5336,4.9
MT4847020000000,48,47020,"Victoria, TX MSA",2021,8,44123,41563,2560,5.8
MT4847380000000,48,47380,"Waco, TX MSA",2021,8,137571,131100,6471,4.7
MT4848660000000,48,48660,"Wichita Falls, TX MSA",2021,8,65374,62281,3093,4.7
MT4930860000000,49,30860,"Logan, UT-ID MSA",2021,8,76602,75108,1494,2
MT4936260000000,49,36260,"Ogden, UT MSA",2021,8,325434,317653,7781,2.4
MT4939340000000,49,39340,"Provo-Orem-Lehi, UT MSA",2021,8,341061,333440,7621,2.2
MT4941100000000,49,41100,"St. George, UT MSA",2021,8,83002,80698,2304,2.8
MT4941620000000,49,41620,"Salt Lake City-Murray, UT MSA",2021,8,685578,667450,18128,2.6
MT5015540000000,50,15540,"Burlington-South Burlington, VT MSA",2021,8,123482,119971,3511,2.8
MT5113980000000,51,13980,"Blacksburg-Christiansburg-Radford, VA MSA",2021,8,87966,85135,2831,3.2
MT5116820000000,51,16820,"Charlottesville, VA MSA",2021,8,111820,108245,3575,3.2
MT5125500000000,51,25500,"Harrisonburg, VA MSA",2021,8,69438,67322,2116,3
MT5131340000000,51,31340,"Lynchburg, VA MSA",2021,8,124793,120236,4557,3.7
MT5140060000000,51,40060,"Richmond, VA MSA",2021,8,679195,653224,25971,3.8
MT5140220000000,51,40220,"Roanoke, VA MSA",2021,8,150579,144978,5601,3.7
MT5144420000000,51,44420,"Staunton-Stuarts Draft, VA MSA",2021,8,61668,59711,1957,3.2
MT5147260000000,51,47260,"Virginia Beach-Chesapeake-Norfolk, VA-NC MSA",2021,8,841543,805837,35706,4.2
MT5149020000000,51,49020,"Winchester, VA-WV MSA",2021,8,72163,69926,2237,3.1
MT5313380000000,53,13380,"Bellingham, WA MSA",2021,8,114187,108358,5829,5.1
MT5314740000000,53,14740,"Bremerton-Silverdale-Port Orchard, WA MSA",2021,8,122690,116951,5739,4.7
MT5328420000000,53,28420,"Kennewick-Richland, WA MSA",2021,8,145384,137184,8200,5.6
MT5331020000000,53,31020,"Longview-Kelso, WA MSA",2021,8,47876,45120,2756,5.8
MT5334580000000,53,34580,"Mount Vernon-Anacortes, WA MSA",2021,8,59195,55723,3472,5.9
MT5336500000000,53,36500,"Olympia-Lacey-Tumwater, WA MSA",2021,8,139526,132743,6783,4.9
MT5342660000000,53,42660,"Seattle-Tacoma-Bellevue, WA MSA",2021,8,2164499,2062939,101560,4.7
MT5344060000000,53,44060,"Spokane-Spokane Valley, WA MSA",2021,8,283268,269248,14020,4.9
MT5347460000000,53,47460,"Walla Walla, WA MSA",2021,8,30246,28930,1316,4.4
MT5348300000000,53,48300,"Wenatchee-East Wenatchee, WA MSA",2021,8,62666,59396,3270,5.2
MT5349420000000,53,49420,"Yakima, WA MSA",2021,8,128500,119984,8516,6.6
MT5413220000000,54,13220,"Beckley, WV MSA",2021,8,45169,42789,2380,5.3
MT5416620000000,54,16620,"Charleston, WV MSA",2021,8,89587,85066,4521,5
MT5426580000000,54,26580,"Huntington-Ashland, WV-KY-OH MSA",2021,8,153320,145642,7678,5
MT5434060000000,54,34060,"Morgantown, WV MSA",2021,8,70477,67608,2869,4.1
MT5437620000000,54,37620,"Parkersburg-Vienna, WV MSA",2021,8,38718,36779,1939,5
MT5448540000000,54,48540,"Wheeling, WV-OH MSA",2021,8,59537,56019,3518,5.9
MT5511540000000,55,11540,"Appleton, WI MSA",2021,8,134404,130569,3835,2.9
MT5520740000000,55,20740,"Eau Claire, WI MSA",2021,8,92551,89541,3010,3.3
MT5522540000000,55,22540,"Fond du Lac, WI MSA",2021,8,56078,54393,1685,3
MT5524580000000,55,24580,"Green Bay, WI MSA",2021,8,174852,169269,5583,3.2
MT5527500000000,55,27500,"Janesville-Beloit, WI MSA",2021,8,84218,80455,3763,4.5
MT5528450000000,55,28450,"Kenosha, WI MSA",2021,8,91879,88194,3685,4
MT5529100000000,55,29100,"La Crosse-Onalaska, WI-MN MSA",2021,8,88520,85885,2635,3
MT5531540000000,55,31540,"Madison, WI MSA",2021,8,394068,383367,10701,2.7
MT5533340000000,55,33340,"Milwaukee-Waukesha, WI MSA",2021,8,813918,780668,33250,4.1
MT5536780000000,55,36780,"Oshkosh-Neenah, WI MSA",2021,8,91778,89020,2758,3
MT5539540000000,55,39540,"Racine-Mount Pleasant, WI MSA",2021,8,100237,95891,4346,4.3
MT5543100000000,55,43100,"Sheboygan, WI MSA",2021,8,62010,60173,1837,3
MT5548140000000,55,48140,"Wausau, WI MSA",2021,8,74324,72226,2098,2.8
MT5616220000000,56,16220,"Casper, WY MSA",2021,8,40905,38810,2095,5.1
MT5616940000000,56,16940,"Cheyenne, WY MSA",2021,8,48850,46955,1895,3.9
MT7210380000000,72,10380,"Aguadilla, PR MSA",2021,8,83446,75469,7977,9.6
MT7211640000000,72,11640,"Arecibo, PR MSA",2021,8,63691,58593,5098,8
MT7225020000000,72,25020,"Guayama, PR MSA",2021,8,19382,17384,1998,10.3
MT7232420000000,72,32420,"Mayaguez, PR MSA",2021,8,65477,58764,6713,10.3
MT7238660000000,72,38660,"Ponce, PR MSA",2021,8,89002,79325,9677,10.9
MT7241980000000,72,41980,"San Juan-Bayamon-Caguas, PR MSA",2021,8,792856,735626,57230,7.2
MT0111500000000,1,11500,"Anniston-Oxford, AL MSA",2021,9,49463,47792,1671,3.4
MT0112220000000,1,12220,"Auburn-Opelika, AL MSA",2021,9,89905,87480,2425,2.7
MT0113820000000,1,13820,"Birmingham, AL MSA",2021,9,551551,536512,15039,2.7
MT0119300000000,1,19300,"Daphne-Fairhope-Foley, AL MSA",2021,9,107876,105265,2611,2.4
MT0119460000000,1,19460,"Decatur, AL MSA",2021,9,71396,69647,1749,2.4
MT0120020000000,1,20020,"Dothan, AL MSA",2021,9,65502,63636,1866,2.8
MT0122520000000,1,22520,"Florence-Muscle Shoals, AL MSA",2021,9,66199,64150,2049,3.1
MT0123460000000,1,23460,"Gadsden, AL MSA",2021,9,40939,39536,1403,3.4
MT0126620000000,1,26620,"Huntsville, AL MSA",2021,9,249571,243964,5607,2.2
MT0133660000000,1,33660,"Mobile, AL MSA",2021,9,182502,174920,7582,4.2
MT0133860000000,1,33860,"Montgomery, AL MSA",2021,9,171795,165645,6150,3.6
MT0146220000000,1,46220,"Tuscaloosa, AL MSA",2021,9,118904,114912,3992,3.4
MT0211260000000,2,11260,"Anchorage, AK MSA",2021,9,197695,186665,11030,5.6
MT0221820000000,2,21820,"Fairbanks-College, AK MSA",2021,9,44733,42544,2189,4.9
MT0422380000000,4,22380,"Flagstaff, AZ MSA",2021,9,70657,66981,3676,5.2
MT0429420000000,4,29420,"Lake Havasu City-Kingman, AZ MSA",2021,9,84484,80195,4289,5.1
MT0438060000000,4,38060,"Phoenix-Mesa-Chandler, AZ MSA",2021,9,2529432,2433880,95552,3.8
MT0439150000000,4,39150,"Prescott Valley-Prescott, AZ MSA",2021,9,100698,96921,3777,3.8
MT0443420000000,4,43420,"Sierra Vista-Douglas, AZ MSA",2021,9,47231,44963,2268,4.8
MT0446060000000,4,46060,"Tucson, AZ MSA",2021,9,484267,463868,20399,4.2
MT0449740000000,4,49740,"Yuma, AZ MSA",2021,9,93752,82287,11465,12.2
MT0522220000000,5,22220,"Fayetteville-Springdale-Rogers, AR MSA",2021,9,276867,269906,6961,2.5
MT0522900000000,5,22900,"Fort Smith, AR-OK MSA",2021,9,98331,95129,3202,3.3
MT0526300000000,5,26300,"Hot Springs, AR MSA",2021,9,43259,41579,1680,3.9
MT0527860000000,5,27860,"Jonesboro, AR MSA",2021,9,63125,61255,1870,3
MT0530780000000,5,30780,"Little Rock-North Little Rock-Conway, AR MSA",2021,9,354365,341926,12439,3.5
MT0612540000000,6,12540,"Bakersfield-Delano, CA MSA",2021,9,389202,352344,36858,9.5
MT0617020000000,6,17020,"Chico, CA MSA",2021,9,90317,84555,5762,6.4
MT0620940000000,6,20940,"El Centro, CA MSA",2021,9,67095,55657,11438,17
MT0623420000000,6,23420,"Fresno, CA MSA",2021,9,505095,461654,43441,8.6
MT0625260000000,6,25260,"Hanford-Corcoran, CA MSA",2021,9,53832,48565,5267,9.8
MT0631080000000,6,31080,"Los Angeles-Long Beach-Anaheim, CA MSA",2021,9,6612928,6135653,477275,7.2
MT0632900000000,6,32900,"Merced, CA MSA",2021,9,114975,103718,11257,9.8
MT0633700000000,6,33700,"Modesto, CA MSA",2021,9,243043,224240,18803,7.7
MT0634900000000,6,34900,"Napa, CA MSA",2021,9,69073,65518,3555,5.1
MT0637100000000,6,37100,"Oxnard-Thousand Oaks-Ventura, CA MSA",2021,9,410332,387726,22606,5.5
MT0639820000000,6,39820,"Redding, CA MSA",2021,9,76130,71327,4803,6.3
MT0640140000000,6,40140,"Riverside-San Bernardino-Ontario, CA MSA",2021,9,2115834,1975688,140146,6.6
MT0640900000000,6,40900,"Sacramento-Roseville-Folsom, CA MSA",2021,9,1131058,1065905,65153,5.8
MT0641500000000,6,41500,"Salinas, CA MSA",2021,9,211178,194112,17066,8.1
MT0641740000000,6,41740,"San Diego-Chula Vista-Carlsbad, CA MSA",2021,9,1584089,1495981,88108,5.6
MT0641860000000,6,41860,"San Francisco-Oakland-Fremont, CA MSA",2021,9,2461570,2340636,120934,4.9
MT0641940000000,6,41940,"San Jose-Sunnyvale-Santa Clara, CA MSA",2021,9,1023849,978615,45234,4.4
MT0642020000000,6,42020,"San Luis Obispo-Paso Robles, CA MSA",2021,9,131172,124863,6309,4.8
MT0642100000000,6,42100,"Santa Cruz-Watsonville, CA MSA",2021,9,133602,125239,8363,6.3
MT0642200000000,6,42200,"Santa Maria-Santa Barbara, CA MSA",2021,9,216928,205785,11143,5.1
MT0642220000000,6,42220,"Santa Rosa-Petaluma, CA MSA",2021,9,242328,230448,11880,4.9
MT0644700000000,6,44700,"Stockton-Lodi, CA MSA",2021,9,350610,323609,27001,7.7
MT0646700000000,6,46700,"Vallejo, CA MSA",2021,9,209020,195379,13641,6.5
MT0647300000000,6,47300,"Visalia, CA MSA",2021,9,204669,184119,20550,10
MT0649700000000,6,49700,"Yuba City, CA MSA",2021,9,77261,70738,6523,8.4
MT0814500000000,8,14500,"Boulder, CO MSA",2021,9,190297,182328,7969,4.2
MT0817820000000,8,17820,"Colorado Springs, CO MSA",2021,9,379299,359536,19763,5.2
MT0819740000000,8,19740,"Denver-Aurora-Centennial, CO MSA",2021,9,1720963,1634257,86706,5
MT0822660000000,8,22660,"Fort Collins-Loveland, CO MSA",2021,9,200772,191675,9097,4.5
MT0824300000000,8,24300,"Grand Junction, CO MSA",2021,9,78774,74526,4248,5.4
MT0824540000000,8,24540,"Greeley, CO MSA",2021,9,168349,159287,9062,5.4
MT0839380000000,8,39380,"Pueblo, CO MSA",2021,9,75582,69684,5898,7.8
MT0914860000000,9,14860,"Bridgeport-Stamford-Danbury, CT MSA",2021,9,495205,468167,27038,5.5
MT0925540000000,9,25540,"Hartford-West Hartford-East Hartford, CT MSA",2021,9,598468,562694,35774,6
MT0935300000000,9,35300,"New Haven, CT MSA",2021,9,306119,287976,18143,5.9
MT0935980000000,9,35980,"Norwich-New London-Willimantic, CT MSA",2021,9,137691,128683,9008,6.5
MT0947930000000,9,47930,"Waterbury-Shelton, CT MSA",2021,9,237152,221679,15473,6.5
MT1020100000000,10,20100,"Dover, DE MSA",2021,9,85019,80391,4628,5.4
MT1147900000000,11,47900,"Washington-Arlington-Alexandria, DC-VA-MD-WV MSA",2021,9,3388768,3257690,131078,3.9
MT1215980000000,12,15980,"Cape Coral-Fort Myers, FL MSA",2021,9,351672,337462,14210,4
MT1218880000000,12,18880,"Crestview-Fort Walton Beach-Destin, FL MSA",2021,9,135173,130787,4386,3.2
MT1219660000000,12,19660,"Deltona-Daytona Beach-Ormond Beach, FL MSA",2021,9,301361,287923,13438,4.5
MT1223540000000,12,23540,"Gainesville, FL MSA",2021,9,163026,156856,6170,3.8
MT1226140000000,12,26140,"Homosassa Springs, FL MSA",2021,9,50709,48080,2629,5.2
MT1227260000000,12,27260,"Jacksonville, FL MSA",2021,9,802366,771497,30869,3.8
MT1229460000000,12,29460,"Lakeland-Winter Haven, FL MSA",2021,9,337168,320925,16243,4.8
MT1233100000000,12,33100,"Miami-Fort Lauderdale-West Palm Beach, FL MSA",2021,9,3092686,2960127,132559,4.3
MT1234940000000,12,34940,"Naples-Marco Island, FL MSA",2021,9,169856,163829,6027,3.5
MT1235840000000,12,35840,"North Port-Bradenton-Sarasota, FL MSA",2021,9,364443,350627,13816,3.8
MT1236100000000,12,36100,"Ocala, FL MSA",2021,9,147238,140356,6882,4.7
MT1236740000000,12,36740,"Orlando-Kissimmee-Sanford, FL MSA",2021,9,1389396,1327942,61454,4.4
MT1237340000000,12,37340,"Palm Bay-Melbourne-Titusville, FL MSA",2021,9,288788,277711,11077,3.8
MT1237460000000,12,37460,"Panama City-Panama City Beach, FL MSA",2021,9,95214,91624,3590,3.8
MT1237860000000,12,37860,"Pensacola-Ferry Pass-Brent, FL MSA",2021,9,230557,221361,9196,4
MT1238940000000,12,38940,"Port St. Lucie, FL MSA",2021,9,223578,214107,9471,4.2
MT1239460000000,12,39460,"Punta Gorda, FL MSA",2021,9,70003,66896,3107,4.4
MT1242680000000,12,42680,"Sebastian-Vero Beach-West Vero Corridor, FL MSA",2021,9,63541,60643,2898,4.6
MT1242700000000,12,42700,"Sebring, FL MSA",2021,9,34570,32651,1919,5.6
MT1245220000000,12,45220,"Tallahassee, FL MSA",2021,9,195812,187904,7908,4
MT1245300000000,12,45300,"Tampa-St. Petersburg-Clearwater, FL MSA",2021,9,1589581,1526450,63131,4
MT1248680000000,12,48680,"Wildwood-The Villages, FL MSA",2021,9,30131,28298,1833,6.1
MT1310500000000,13,10500,"Albany, GA MSA",2021,9,62972,60108,2864,4.5
MT1312020000000,13,12020,"Athens-Clarke County, GA MSA",2021,9,102487,99437,3050,3
MT1312060000000,13,12060,"Atlanta-Sandy Springs-Roswell, GA MSA",2021,9,3139516,3032884,106632,3.4
MT1312260000000,13,12260,"Augusta-Richmond County, GA-SC MSA",2021,9,263813,254280,9533,3.6
MT1315260000000,13,15260,"Brunswick-St. Simons, GA MSA",2021,9,51551,49846,1705,3.3
MT1317980000000,13,17980,"Columbus, GA-AL MSA",2021,9,130167,125056,5111,3.9
MT1319140000000,13,19140,"Dalton, GA MSA",2021,9,65777,63632,2145,3.3
MT1323580000000,13,23580,"Gainesville, GA MSA",2021,9,100129,97545,2584,2.6
MT1325980000000,13,25980,"Hinesville, GA MSA",2021,9,30575,29403,1172,3.8
MT1331420000000,13,31420,"Macon-Bibb County, GA MSA",2021,9,98593,94668,3925,4
MT1340660000000,13,40660,"Rome, GA MSA",2021,9,43613,42134,1479,3.4
MT1342340000000,13,42340,"Savannah, GA MSA",2021,9,201569,194689,6880,3.4
MT1346660000000,13,46660,"Valdosta, GA MSA",2021,9,61308,59048,2260,3.7
MT1347580000000,13,47580,"Warner Robins, GA MSA",2021,9,88320,85395,2925,3.3
MT1527980000000,15,27980,"Kahului-Wailuku, HI MSA",2021,9,82987,78902,4085,4.9
MT1546520000000,15,46520,"Urban Honolulu, HI MSA",2021,9,459048,441997,17051,3.7
MT1614260000000,16,14260,"Boise City, ID MSA",2021,9,412453,399888,12565,3
MT1617660000000,16,17660,"Coeur d'Alene, ID MSA",2021,9,85404,82056,3348,3.9
MT1626820000000,16,26820,"Idaho Falls, ID MSA",2021,9,78014,75986,2028,2.6
MT1630300000000,16,30300,"Lewiston, ID-WA MSA",2021,9,30295,29295,1000,3.3
MT1638540000000,16,38540,"Pocatello, ID MSA",2021,9,38595,37228,1367,3.5
MT1646300000000,16,46300,"Twin Falls, ID MSA",2021,9,57914,56153,1761,3
MT1714010000000,17,14010,"Bloomington, IL MSA",2021,9,89163,85470,3693,4.1
MT1716580000000,17,16580,"Champaign-Urbana, IL MSA",2021,9,121757,116129,5628,4.6
MT1716980000000,17,16980,"Chicago-Naperville-Elgin, IL-IN MSA",2021,9,4768913,4503766,265147,5.6
MT1719340000000,17,19340,"Davenport-Moline-Rock Island, IA-IL MSA",2021,9,188893,180206,8687,4.6
MT1719500000000,17,19500,"Decatur, IL MSA",2021,9,45754,42458,3296,7.2
MT1728100000000,17,28100,"Kankakee, IL MSA",2021,9,50490,47220,3270,6.5
MT1737900000000,17,37900,"Peoria, IL MSA",2021,9,172601,163121,9480,5.5
MT1740420000000,17,40420,"Rockford, IL MSA",2021,9,160026,147193,12833,8
MT1744100000000,17,44100,"Springfield, IL MSA",2021,9,101396,96079,5317,5.2
MT1814020000000,18,14020,"Bloomington, IN MSA",2021,9,79278,77111,2167,2.7
MT1818020000000,18,18020,"Columbus, IN MSA",2021,9,38032,36861,1171,3.1
MT1821140000000,18,21140,"Elkhart-Goshen, IN MSA",2021,9,105452,102693,2759,2.6
MT1821780000000,18,21780,"Evansville, IN MSA",2021,9,132872,128534,4338,3.3
MT1823060000000,18,23060,"Fort Wayne, IN MSA",2021,9,220293,213102,7191,3.3
MT1826900000000,18,26900,"Indianapolis-Carmel-Greenwood, IN MSA",2021,9,1076270,1041030,35240,3.3
MT1829020000000,18,29020,"Kokomo, IN MSA",2021,9,36055,34373,1682,4.7
MT1829200000000,18,29200,"Lafayette-West Lafayette, IN MSA",2021,9,113487,110011,3476,3.1
MT1833140000000,18,33140,"Michigan City-La Porte, IN MSA",2021,9,50165,47975,2190,4.4
MT1834620000000,18,34620,"Muncie, IN MSA",2021,9,51173,49155,2018,3.9
MT1843780000000,18,43780,"South Bend-Mishawaka, IN-MI MSA",2021,9,152261,146087,6174,4.1
MT1845460000000,18,45460,"Terre Haute, IN MSA",2021,9,75804,72943,2861,3.8
MT1911180000000,19,11180,"Ames, IA MSA",2021,9,67765,65864,1901,2.8
MT1916300000000,19,16300,"Cedar Rapids, IA MSA",2021,9,147836,142406,5430,3.7
MT1919780000000,19,19780,"Des Moines-West Des Moines, IA MSA",2021,9,390265,377706,12559,3.2
MT1920220000000,19,20220,"Dubuque, IA MSA",2021,9,53224,51194,2030,3.8
MT1926980000000,19,26980,"Iowa City, IA MSA",2021,9,97081,94276,2805,2.9
MT1943580000000,19,43580,"Sioux City, IA-NE-SD MSA",2021,9,75339,72767,2572,3.4
MT1947940000000,19,47940,"Waterloo-Cedar Falls, IA MSA",2021,9,89023,85958,3065,3.4
MT2029940000000,20,29940,"Lawrence, KS MSA",2021,9,68002,66092,1910,2.8
MT2031740000000,20,31740,"Manhattan, KS MSA",2021,9,62508,60776,1732,2.8
MT2045820000000,20,45820,"Topeka, KS MSA",2021,9,115918,112284,3634,3.1
MT2048620000000,20,48620,"Wichita, KS MSA",2021,9,324023,311435,12588,3.9
MT2114540000000,21,14540,"Bowling Green, KY MSA",2021,9,87167,83859,3308,3.8
MT2121060000000,21,21060,"Elizabethtown, KY MSA",2021,9,53271,50838,2433,4.6
MT2130460000000,21,30460,"Lexington-Fayette, KY MSA",2021,9,264515,254930,9585,3.6
MT2131140000000,21,31140,"Louisville/Jefferson County, KY-IN MSA",2021,9,678088,651334,26754,3.9
MT2136980000000,21,36980,"Owensboro, KY MSA",2021,9,51465,49422,2043,4
MT2137140000000,21,37140,"Paducah, KY-IL MSA",2021,9,44922,42721,2201,4.9
MT2210780000000,22,10780,"Alexandria, LA MSA",2021,9,64625,62353,2272,3.5
MT2212940000000,22,12940,"Baton Rouge, LA MSA",2021,9,419674,401223,18451,4.4
MT2225220000000,22,25220,"Hammond, LA MSA",2021,9,58281,55080,3201,5.5
MT2226380000000,22,26380,"Houma-Bayou Cane-Thibodaux, LA MSA",2021,9,82634,78638,3996,4.8
MT2229180000000,22,29180,"Lafayette, LA MSA",2021,9,193572,185942,7630,3.9
MT2229340000000,22,29340,"Lake Charles, LA MSA",2021,9,102799,97809,4990,4.9
MT2233740000000,22,33740,"Monroe, LA MSA",2021,9,95711,91166,4545,4.7
MT2235380000000,22,35380,"New Orleans-Metairie, LA MSA",2021,9,454538,428840,25698,5.7
MT2243340000000,22,43340,"Shreveport-Bossier City, LA MSA",2021,9,166172,158476,7696,4.6
MT2243640000000,22,43640,"Slidell-Mandeville-Covington, LA MSA",2021,9,123465,119386,4079,3.3
MT2312620000000,23,12620,"Bangor, ME MSA",2021,9,73872,70175,3697,5
MT2330340000000,23,30340,"Lewiston-Auburn, ME MSA",2021,9,55577,52755,2822,5.1
MT2338860000000,23,38860,"Portland-South Portland, ME MSA",2021,9,303742,291710,12032,4
MT2412580000000,24,12580,"Baltimore-Columbia-Towson, MD MSA",2021,9,1448268,1384810,63458,4.4
MT2425180000000,24,25180,"Hagerstown-Martinsburg, MD-WV MSA",2021,9,140439,135044,5395,3.8
MT2430500000000,24,30500,"Lexington Park, MD MSA",2021,9,105912,101905,4007,3.8
MT2441540000000,24,41540,"Salisbury, MD MSA",2021,9,60208,57323,2885,4.8
MT2511200000000,25,11200,"Amherst Town-Northampton, MA MSA",2021,9,83587,80051,3536,4.2
MT2512700000000,25,12700,"Barnstable Town, MA MSA",2021,9,112373,105900,6473,5.8
MT2514460000000,25,14460,"Boston-Cambridge-Newton, MA-NH MSA",2021,9,2707004,2593730,113274,4.2
MT2538340000000,25,38340,"Pittsfield, MA MSA",2021,9,63126,59710,3416,5.4
MT2544140000000,25,44140,"Springfield, MA MSA",2021,9,224460,210876,13584,6.1
MT2549340000000,25,49340,"Worcester, MA MSA",2021,9,449370,427846,21524,4.8
MT2611460000000,26,11460,"Ann Arbor, MI MSA",2021,9,192908,185835,7073,3.7
MT2612980000000,26,12980,"Battle Creek, MI MSA",2021,9,58411,54938,3473,5.9
MT2613020000000,26,13020,"Bay City, MI MSA",2021,9,47508,44820,2688,5.7
MT2619820000000,26,19820,"Detroit-Warren-Dearborn, MI MSA",2021,9,2110953,1990177,120776,5.7
MT2622420000000,26,22420,"Flint, MI MSA",2021,9,177307,165553,11754,6.6
MT2624340000000,26,24340,"Grand Rapids-Wyoming-Kentwood, MI MSA",2021,9,585039,560850,24189,4.1
MT2627100000000,26,27100,"Jackson, MI MSA",2021,9,71148,67376,3772,5.3
MT2628020000000,26,28020,"Kalamazoo-Portage, MI MSA",2021,9,130395,124724,5671,4.3
MT2629620000000,26,29620,"Lansing-East Lansing, MI MSA",2021,9,231358,219869,11489,5
MT2633220000000,26,33220,"Midland, MI MSA",2021,9,38605,36900,1705,4.4
MT2633780000000,26,33780,"Monroe, MI MSA",2021,9,71668,67638,4030,5.6
MT2634740000000,26,34740,"Muskegon-Norton Shores, MI MSA",2021,9,79787,74869,4918,6.2
MT2635660000000,26,35660,"Niles, MI MSA",2021,9,71120,67452,3668,5.2
MT2640980000000,26,40980,"Saginaw, MI MSA",2021,9,81816,76462,5354,6.5
MT2645900000000,26,45900,"Traverse City, MI MSA",2021,9,75662,72022,3640,4.8
MT2720260000000,27,20260,"Duluth, MN-WI MSA",2021,9,137649,132269,5380,3.9
MT2731860000000,27,31860,"Mankato, MN MSA",2021,9,57499,55796,1703,3
MT2733460000000,27,33460,"Minneapolis-St. Paul-Bloomington, MN-WI MSA",2021,9,2011299,1946970,64329,3.2
MT2740340000000,27,40340,"Rochester, MN MSA",2021,9,123546,120027,3519,2.8
MT2741060000000,27,41060,"St. Cloud, MN MSA",2021,9,107058,103083,3975,3.7
MT2825060000000,28,25060,"Gulfport-Biloxi, MS MSA",2021,9,184368,175839,8529,4.6
MT2825620000000,28,25620,"Hattiesburg, MS MSA",2021,9,69849,66791,3058,4.4
MT2827140000000,28,27140,"Jackson, MS MSA",2021,9,275572,263219,12353,4.5
MT2916020000000,29,16020,"Cape Girardeau, MO-IL MSA",2021,9,47257,45719,1538,3.3
MT2917860000000,29,17860,"Columbia, MO MSA",2021,9,111724,108839,2885,2.6
MT2927620000000,29,27620,"Jefferson City, MO MSA",2021,9,72616,70622,1994,2.7
MT2927900000000,29,27900,"Joplin, MO-KS MSA",2021,9,94260,91375,2885,3.1
MT2928140000000,29,28140,"Kansas City, MO-KS MSA",2021,9,1148091,1106703,41388,3.6
MT2941140000000,29,41140,"St. Joseph, MO-KS MSA",2021,9,55657,53762,1895,3.4
MT2941180000000,29,41180,"St. Louis, MO-IL MSA",2021,9,1443290,1385131,58159,4
MT2944180000000,29,44180,"Springfield, MO MSA",2021,9,231821,224958,6863,3
MT3013740000000,30,13740,"Billings, MT MSA",2021,9,96197,93501,2696,2.8
MT3014580000000,30,14580,"Bozeman, MT MSA",2021,9,71709,70086,1623,2.3
MT3024500000000,30,24500,"Great Falls, MT MSA",2021,9,38625,37480,1145,3
MT3025740000000,30,25740,"Helena, MT MSA",2021,9,45152,43872,1280,2.8
MT3033540000000,30,33540,"Missoula, MT MSA",2021,9,70682,68626,2056,2.9
MT3124260000000,31,24260,"Grand Island, NE MSA",2021,9,40856,39796,1060,2.6
MT3130700000000,31,30700,"Lincoln, NE MSA",2021,9,187412,183292,4120,2.2
MT3136540000000,31,36540,"Omaha, NE-IA MSA",2021,9,512526,498637,13889,2.7
MT3216180000000,32,16180,"Carson City, NV MSA",2021,9,27442,26345,1097,4
MT3229820000000,32,29820,"Las Vegas-Henderson-North Las Vegas, NV MSA",2021,9,1096855,1024797,72058,6.6
MT3239900000000,32,39900,"Reno, NV MSA",2021,9,277383,266715,10668,3.8
MT3331700000000,33,31700,"Manchester-Nashua, NH MSA",2021,9,235526,228145,7381,3.1
MT3412100000000,34,12100,"Atlantic City-Hammonton, NJ MSA",2021,9,177316,161288,16028,9
MT3445940000000,34,45940,"Trenton-Princeton, NJ MSA",2021,9,192326,181233,11093,5.8
MT3447220000000,34,47220,"Vineland, NJ MSA",2021,9,64657,59159,5498,8.5
MT3510740000000,35,10740,"Albuquerque, NM MSA",2021,9,442342,416337,26005,5.9
MT3522140000000,35,22140,"Farmington, NM MSA",2021,9,48207,44529,3678,7.6
MT3529740000000,35,29740,"Las Cruces, NM MSA",2021,9,97595,91160,6435,6.6
MT3542140000000,35,42140,"Santa Fe, NM MSA",2021,9,73110,68915,4195,5.7
MT3610580000000,36,10580,"Albany-Schenectady-Troy, NY MSA",2021,9,449874,432525,17349,3.9
MT3613780000000,36,13780,"Binghamton, NY MSA",2021,9,106022,101192,4830,4.6
MT3615380000000,36,15380,"Buffalo-Cheektowaga, NY MSA",2021,9,552503,526720,25783,4.7
MT3621300000000,36,21300,"Elmira, NY MSA",2021,9,36013,34381,1632,4.5
MT3624020000000,36,24020,"Glens Falls, NY MSA",2021,9,59672,57058,2614,4.4
MT3627060000000,36,27060,"Ithaca, NY MSA",2021,9,48844,47129,1715,3.5
MT3628740000000,36,28740,"Kingston, NY MSA",2021,9,85437,81836,3601,4.2
MT3628880000000,36,28880,"Kiryas Joel-Poughkeepsie-Newburgh, NY MSA",2021,9,326828,313309,13519,4.1
MT3635620000000,36,35620,"New York-Newark-Jersey City, NY-NJ MSA",2021,9,9759434,9084336,675098,6.9
MT3640380000000,36,40380,"Rochester, NY MSA",2021,9,508673,486713,21960,4.3
MT3645060000000,36,45060,"Syracuse, NY MSA",2021,9,308183,294617,13566,4.4
MT3646540000000,36,46540,"Utica-Rome, NY MSA",2021,9,128550,122558,5992,4.7
MT3648060000000,36,48060,"Watertown-Fort Drum, NY MSA",2021,9,44710,42524,2186,4.9
MT3711700000000,37,11700,"Asheville, NC MSA",2021,9,200702,193084,7618,3.8
MT3715500000000,37,15500,"Burlington, NC MSA",2021,9,81341,77666,3675,4.5
MT3716740000000,37,16740,"Charlotte-Concord-Gastonia, NC-SC MSA",2021,9,1382293,1323472,58821,4.3
MT3720500000000,37,20500,"Durham-Chapel Hill, NC MSA",2021,9,303706,292268,11438,3.8
MT3722180000000,37,22180,"Fayetteville, NC MSA",2021,9,151420,142446,8974,5.9
MT3724140000000,37,24140,"Goldsboro, NC MSA",2021,9,49238,46927,2311,4.7
MT3724660000000,37,24660,"Greensboro-High Point, NC MSA",2021,9,365232,347238,17994,4.9
MT3724780000000,37,24780,"Greenville, NC MSA",2021,9,79995,76031,3964,5
MT3725860000000,37,25860,"Hickory-Lenoir-Morganton, NC MSA",2021,9,167065,159845,7220,4.3
MT3727340000000,37,27340,"Jacksonville, NC MSA",2021,9,69971,66936,3035,4.3
MT3738240000000,37,38240,"Pinehurst-Southern Pines, NC MSA",2021,9,41536,39778,1758,4.2
MT3739580000000,37,39580,"Raleigh-Cary, NC MSA",2021,9,768582,740725,27857,3.6
MT3740580000000,37,40580,"Rocky Mount, NC MSA",2021,9,64313,60196,4117,6.4
MT3748900000000,37,48900,"Wilmington, NC MSA",2021,9,204356,195488,8868,4.3
MT3749180000000,37,49180,"Winston-Salem, NC MSA",2021,9,315109,301024,14085,4.5
MT3813900000000,38,13900,"Bismarck, ND MSA",2021,9,72354,70627,1727,2.4
MT3822020000000,38,22020,"Fargo, ND-MN MSA",2021,9,146944,143710,3234,2.2
MT3824220000000,38,24220,"Grand Forks, ND-MN MSA",2021,9,54157,52663,1494,2.8
MT3833500000000,38,33500,"Minot, ND MSA",2021,9,39466,38345,1121,2.8
MT3910420000000,39,10420,"Akron, OH MSA",2021,9,350706,334448,16258,4.6
MT3915940000000,39,15940,"Canton-Massillon, OH MSA",2021,9,190452,181236,9216,4.8
MT3917140000000,39,17140,"Cincinnati, OH-KY-IN MSA",2021,9,1132237,1086483,45754,4
MT3917410000000,39,17410,"Cleveland, OH MSA",2021,9,1063464,1007031,56433,5.3
MT3918140000000,39,18140,"Columbus, OH MSA",2021,9,1109975,1065541,44434,4
MT3919430000000,39,19430,"Dayton-Kettering-Beavercreek, OH MSA",2021,9,380625,363133,17492,4.6
MT3930620000000,39,30620,"Lima, OH MSA",2021,9,47495,45263,2232,4.7
MT3931900000000,39,31900,"Mansfield, OH MSA",2021,9,52620,49875,2745,5.2
MT3941780000000,39,41780,"Sandusky, OH MSA",2021,9,56585,53453,3132,5.5
MT3944220000000,39,44220,"Springfield, OH MSA",2021,9,61228,57970,3258,5.3
MT3945780000000,39,45780,"Toledo, OH MSA",2021,9,289059,274003,15056,5.2
MT3948260000000,39,48260,"Weirton-Steubenville, WV-OH MSA",2021,9,52690,49801,2889,5.5
MT3949660000000,39,49660,"Youngstown-Warren, OH MSA",2021,9,187722,177478,10244,5.5
MT4021420000000,40,21420,"Enid, OK MSA",2021,9,28076,27280,796,2.8
MT4030020000000,40,30020,"Lawton, OK MSA",2021,9,50694,49105,1589,3.1
MT4036420000000,40,36420,"Oklahoma City, OK MSA",2021,9,712558,690355,22203,3.1
MT4046140000000,40,46140,"Tulsa, OK MSA",2021,9,488191,472579,15612,3.2
MT4110540000000,41,10540,"Albany, OR MSA",2021,9,60420,57478,2942,4.9
MT4113460000000,41,13460,"Bend, OR MSA",2021,9,124968,119262,5706,4.6
MT4118700000000,41,18700,"Corvallis, OR MSA",2021,9,47346,45716,1630,3.4
MT4121660000000,41,21660,"Eugene-Springfield, OR MSA",2021,9,185171,176600,8571,4.6
MT4124420000000,41,24420,"Grants Pass, OR MSA",2021,9,35166,33146,2020,5.7
MT4132780000000,41,32780,"Medford, OR MSA",2021,9,104839,99736,5103,4.9
MT4138900000000,41,38900,"Portland-Vancouver-Hillsboro, OR-WA MSA",2021,9,1352569,1296101,56468,4.2
MT4141420000000,41,41420,"Salem, OR MSA",2021,9,210593,201495,9098,4.3
MT4210900000000,42,10900,"Allentown-Bethlehem-Easton, PA-NJ MSA",2021,9,440054,415692,24362,5.5
MT4211020000000,42,11020,"Altoona, PA MSA",2021,9,57152,54110,3042,5.3
MT4216540000000,42,16540,"Chambersburg, PA MSA",2021,9,76007,72708,3299,4.3
MT4221500000000,42,21500,"Erie, PA MSA",2021,9,125406,117935,7471,6
MT4223900000000,42,23900,"Gettysburg, PA MSA",2021,9,51689,49612,2077,4
MT4225420000000,42,25420,"Harrisburg-Carlisle, PA MSA",2021,9,301100,287297,13803,4.6
MT4227780000000,42,27780,"Johnstown, PA MSA",2021,9,56964,53516,3448,6.1
MT4229540000000,42,29540,"Lancaster, PA MSA",2021,9,284877,273037,11840,4.2
MT4230140000000,42,30140,"Lebanon, PA MSA",2021,9,70568,67254,3314,4.7
MT4237980000000,42,37980,"Philadelphia-Camden-Wilmington, PA-NJ-DE-MD MSA",2021,9,3173697,3001565,172132,5.4
MT4238300000000,42,38300,"Pittsburgh, PA MSA",2021,9,1220435,1154971,65464,5.4
MT4239740000000,42,39740,"Reading, PA MSA",2021,9,212345,200900,11445,5.4
MT4242540000000,42,42540,"Scranton--Wilkes-Barre, PA MSA",2021,9,272712,255515,17197,6.3
MT4244300000000,42,44300,"State College, PA MSA",2021,9,74056,71081,2975,4
MT4248700000000,42,48700,"Williamsport, PA MSA",2021,9,51995,48817,3178,6.1
MT4249620000000,42,49620,"York-Hanover, PA MSA",2021,9,232660,221987,10673,4.6
MT4439300000000,44,39300,"Providence-Warwick, RI-MA MSA",2021,9,867350,824660,42690,4.9
MT4516700000000,45,16700,"Charleston-North Charleston, SC MSA",2021,9,399232,386789,12443,3.1
MT4517900000000,45,17900,"Columbia, SC MSA",2021,9,393523,380540,12983,3.3
MT4522500000000,45,22500,"Florence, SC MSA",2021,9,88954,85402,3552,4
MT4524860000000,45,24860,"Greenville-Anderson-Greer, SC MSA",2021,9,445599,431766,13833,3.1
MT4525940000000,45,25940,"Hilton Head Island-Bluffton-Port Royal, SC MSA",2021,9,91505,88747,2758,3
MT4534820000000,45,34820,"Myrtle Beach-Conway-North Myrtle Beach, SC MSA",2021,9,155232,148306,6926,4.5
MT4543900000000,45,43900,"Spartanburg, SC MSA",2021,9,166490,160256,6234,3.7
MT4544940000000,45,44940,"Sumter, SC MSA",2021,9,41920,40193,1727,4.1
MT4639660000000,46,39660,"Rapid City, SD MSA",2021,9,76997,75147,1850,2.4
MT4643620000000,46,43620,"Sioux Falls, SD-MN MSA",2021,9,165652,162136,3516,2.1
MT4716860000000,47,16860,"Chattanooga, TN-GA MSA",2021,9,270648,261216,9432,3.5
MT4717300000000,47,17300,"Clarksville, TN-KY MSA",2021,9,132438,126842,5596,4.2
MT4717420000000,47,17420,"Cleveland, TN MSA",2021,9,56861,54659,2202,3.9
MT4727180000000,47,27180,"Jackson, TN MSA",2021,9,78533,75168,3365,4.3
MT4727740000000,47,27740,"Johnson City, TN MSA",2021,9,95999,92643,3356,3.5
MT4728700000000,47,28700,"Kingsport-Bristol, TN-VA MSA",2021,9,128750,123768,4982,3.9
MT4728940000000,47,28940,"Knoxville, TN MSA",2021,9,432880,418870,14010,3.2
MT4732820000000,47,32820,"Memphis, TN-MS-AR MSA",2021,9,641920,606779,35141,5.5
MT4734100000000,47,34100,"Morristown, TN MSA",2021,9,52379,50314,2065,3.9
MT4734980000000,47,34980,"Nashville-Davidson--Murfreesboro--Franklin, TN MSA",2021,9,1100619,1064291,36328,3.3
MT4810180000000,48,10180,"Abilene, TX MSA",2021,9,80974,77590,3384,4.2
MT4811100000000,48,11100,"Amarillo, TX MSA",2021,9,131704,126823,4881,3.7
MT4812420000000,48,12420,"Austin-Round Rock-San Marcos, TX MSA",2021,9,1331050,1281833,49217,3.7
MT4813140000000,48,13140,"Beaumont-Port Arthur, TX MSA",2021,9,169674,156238,13436,7.9
MT4815180000000,48,15180,"Brownsville-Harlingen, TX MSA",2021,9,179910,167220,12690,7.1
MT4817780000000,48,17780,"College Station-Bryan, TX MSA",2021,9,136589,131059,5530,4
MT4818580000000,48,18580,"Corpus Christi, TX MSA",2021,9,200642,187858,12784,6.4
MT4819100000000,48,19100,"Dallas-Fort Worth-Arlington, TX MSA",2021,9,4106599,3920422,186177,4.5
MT4820580000000,48,20580,"Eagle Pass, TX MSA",2021,9,23598,21043,2555,10.8
MT4821340000000,48,21340,"El Paso, TX MSA",2021,9,385629,365163,20466,5.3
MT4826420000000,48,26420,"Houston-Pasadena-The Woodlands, TX MSA",2021,9,3527794,3331836,195958,5.6
MT4828660000000,48,28660,"Killeen-Temple, TX MSA",2021,9,193207,183309,9898,5.1
MT4829700000000,48,29700,"Laredo, TX MSA",2021,9,111511,105154,6357,5.7
MT4830980000000,48,30980,"Longview, TX MSA",2021,9,125252,118170,7082,5.7
MT4831180000000,48,31180,"Lubbock, TX MSA",2021,9,174440,166837,7603,4.4
MT4832580000000,48,32580,"McAllen-Edinburg-Mission, TX MSA",2021,9,375229,345066,30163,8
MT4833260000000,48,33260,"Midland, TX MSA",2021,9,89506,84885,4621,5.2
MT4836220000000,48,36220,"Odessa, TX MSA",2021,9,77796,72632,5164,6.6
MT4841660000000,48,41660,"San Angelo, TX MSA",2021,9,58246,55819,2427,4.2
MT4841700000000,48,41700,"San Antonio-New Braunfels, TX MSA",2021,9,1229965,1172580,57385,4.7
MT4843300000000,48,43300,"Sherman-Denison, TX MSA",2021,9,65829,62982,2847,4.3
MT4845500000000,48,45500,"Texarkana, TX-AR MSA",2021,9,60468,57359,3109,5.1
MT4846340000000,48,46340,"Tyler, TX MSA",2021,9,109963,104875,5088,4.6
MT4847020000000,48,47020,"Victoria, TX MSA",2021,9,44245,41783,2462,5.6
MT4847380000000,48,47380,"Waco, TX MSA",2021,9,138292,132019,6273,4.5
MT4848660000000,48,48660,"Wichita Falls, TX MSA",2021,9,65418,62435,2983,4.6
MT4930860000000,49,30860,"Logan, UT-ID MSA",2021,9,76808,75331,1477,1.9
MT4936260000000,49,36260,"Ogden, UT MSA",2021,9,326263,318846,7417,2.3
MT4939340000000,49,39340,"Provo-Orem-Lehi, UT MSA",2021,9,342245,334856,7389,2.2
MT4941100000000,49,41100,"St. George, UT MSA",2021,9,83236,81017,2219,2.7
MT4941620000000,49,41620,"Salt Lake City-Murray, UT MSA",2021,9,687044,669831,17213,2.5
MT5015540000000,50,15540,"Burlington-South Burlington, VT MSA",2021,9,123914,120552,3362,2.7
MT5113980000000,51,13980,"Blacksburg-Christiansburg-Radford, VA MSA",2021,9,88068,85423,2645,3
MT5116820000000,51,16820,"Charlottesville, VA MSA",2021,9,112061,108666,3395,3
MT5125500000000,51,25500,"Harrisonburg, VA MSA",2021,9,69624,67581,2043,2.9
MT5131340000000,51,31340,"Lynchburg, VA MSA",2021,9,124894,120560,4334,3.5
MT5140060000000,51,40060,"Richmond, VA MSA",2021,9,680586,655965,24621,3.6
MT5140220000000,51,40220,"Roanoke, VA MSA",2021,9,150696,145373,5323,3.5
MT5144420000000,51,44420,"Staunton-Stuarts Draft, VA MSA",2021,9,61878,60016,1862,3
MT5147260000000,51,47260,"Virginia Beach-Chesapeake-Norfolk, VA-NC MSA",2021,9,842604,808978,33626,4
MT5149020000000,51,49020,"Winchester, VA-WV MSA",2021,9,72371,70193,2178,3
MT5313380000000,53,13380,"Bellingham, WA MSA",2021,9,114265,108672,5593,4.9
MT5314740000000,53,14740,"Bremerton-Silverdale-Port Orchard, WA MSA",2021,9,122700,117151,5549,4.5
MT5328420000000,53,28420,"Kennewick-Richland, WA MSA",2021,9,145252,137360,7892,5.4
MT5331020000000,53,31020,"Longview-Kelso, WA MSA",2021,9,47845,45191,2654,5.5
MT5334580000000,53,34580,"Mount Vernon-Anacortes, WA MSA",2021,9,59136,55815,3321,5.6
MT5336500000000,53,36500,"Olympia-Lacey-Tumwater, WA MSA",2021,9,139629,133071,6558,4.7
MT5342660000000,53,42660,"Seattle-Tacoma-Bellevue, WA MSA",2021,9,2168812,2073127,95685,4.4
MT5344060000000,53,44060,"Spokane-Spokane Valley, WA MSA",2021,9,283570,270078,13492,4.8
MT5347460000000,53,47460,"Walla Walla, WA MSA",2021,9,30212,28930,1282,4.2
MT5348300000000,53,48300,"Wenatchee-East Wenatchee, WA MSA",2021,9,62484,59325,3159,5.1
MT5349420000000,53,49420,"Yakima, WA MSA",2021,9,128429,120221,8208,6.4
MT5413220000000,54,13220,"Beckley, WV MSA",2021,9,45103,42912,2191,4.9
MT5416620000000,54,16620,"Charleston, WV MSA",2021,9,89408,85244,4164,4.7
MT5426580000000,54,26580,"Huntington-Ashland, WV-KY-OH MSA",2021,9,153640,146241,7399,4.8
MT5434060000000,54,34060,"Morgantown, WV MSA",2021,9,70598,67807,2791,4
MT5437620000000,54,37620,"Parkersburg-Vienna, WV MSA",2021,9,38637,36824,1813,4.7
MT5448540000000,54,48540,"Wheeling, WV-OH MSA",2021,9,59491,56226,3265,5.5
MT5511540000000,55,11540,"Appleton, WI MSA",2021,9,134378,130730,3648,2.7
MT5520740000000,55,20740,"Eau Claire, WI MSA",2021,9,92601,89727,2874,3.1
MT5522540000000,55,22540,"Fond du Lac, WI MSA",2021,9,56093,54486,1607,2.9
MT5524580000000,55,24580,"Green Bay, WI MSA",2021,9,174793,169476,5317,3
MT5527500000000,55,27500,"Janesville-Beloit, WI MSA",2021,9,84040,80521,3519,4.2
MT5528450000000,55,28450,"Kenosha, WI MSA",2021,9,92024,88547,3477,3.8
MT5529100000000,55,29100,"La Crosse-Onalaska, WI-MN MSA",2021,9,88389,85866,2523,2.9
MT5531540000000,55,31540,"Madison, WI MSA",2021,9,393770,383697,10073,2.6
MT5533340000000,55,33340,"Milwaukee-Waukesha, WI MSA",2021,9,812876,781940,30936,3.8
MT5536780000000,55,36780,"Oshkosh-Neenah, WI MSA",2021,9,91686,89066,2620,2.9
MT5539540000000,55,39540,"Racine-Mount Pleasant, WI MSA",2021,9,100126,96052,4074,4.1
MT5543100000000,55,43100,"Sheboygan, WI MSA",2021,9,61978,60241,1737,2.8
MT5548140000000,55,48140,"Wausau, WI MSA",2021,9,74243,72238,2005,2.7
MT5616220000000,56,16220,"Casper, WY MSA",2021,9,40820,38888,1932,4.7
MT5616940000000,56,16940,"Cheyenne, WY MSA",2021,9,48902,47108,1794,3.7
MT7210380000000,72,10380,"Aguadilla, PR MSA",2021,9,83950,76209,7741,9.2
MT7211640000000,72,11640,"Arecibo, PR MSA",2021,9,64052,59039,5013,7.8
MT7225020000000,72,25020,"Guayama, PR MSA",2021,9,19444,17516,1928,9.9
MT7232420000000,72,32420,"Mayaguez, PR MSA",2021,9,65901,59370,6531,9.9
MT7238660000000,72,38660,"Ponce, PR MSA",2021,9,89401,79992,9409,10.5
MT7241980000000,72,41980,"San Juan-Bayamon-Caguas, PR MSA",2021,9,797971,742613,55358,6.9
MT0111500000000,1,11500,"Anniston-Oxford, AL MSA",2021,10,49525,47943,1582,3.2
MT0112220000000,1,12220,"Auburn-Opelika, AL MSA",2021,10,90256,87900,2356,2.6
MT0113820000000,1,13820,"Birmingham, AL MSA",2021,10,552997,538587,14410,2.6
MT0119300000000,1,19300,"Daphne-Fairhope-Foley, AL MSA",2021,10,108617,106175,2442,2.2
MT0119460000000,1,19460,"Decatur, AL MSA",2021,10,71586,69917,1669,2.3
MT0120020000000,1,20020,"Dothan, AL MSA",2021,10,65660,63900,1760,2.7
MT0122520000000,1,22520,"Florence-Muscle Shoals, AL MSA",2021,10,66427,64480,1947,2.9
MT0123460000000,1,23460,"Gadsden, AL MSA",2021,10,40976,39650,1326,3.2
MT0126620000000,1,26620,"Huntsville, AL MSA",2021,10,250262,244855,5407,2.2
MT0133660000000,1,33660,"Mobile, AL MSA",2021,10,182623,175550,7073,3.9
MT0133860000000,1,33860,"Montgomery, AL MSA",2021,10,172233,166499,5734,3.3
MT0146220000000,1,46220,"Tuscaloosa, AL MSA",2021,10,119164,115365,3799,3.2
MT0211260000000,2,11260,"Anchorage, AK MSA",2021,10,198206,187587,10619,5.4
MT0221820000000,2,21820,"Fairbanks-College, AK MSA",2021,10,44724,42567,2157,4.8
MT0422380000000,4,22380,"Flagstaff, AZ MSA",2021,10,70846,67444,3402,4.8
MT0429420000000,4,29420,"Lake Havasu City-Kingman, AZ MSA",2021,10,84389,80407,3982,4.7
MT0438060000000,4,38060,"Phoenix-Mesa-Chandler, AZ MSA",2021,10,2531828,2443794,88034,3.5
MT0439150000000,4,39150,"Prescott Valley-Prescott, AZ MSA",2021,10,100783,97242,3541,3.5
MT0443420000000,4,43420,"Sierra Vista-Douglas, AZ MSA",2021,10,47166,44971,2195,4.7
MT0446060000000,4,46060,"Tucson, AZ MSA",2021,10,484048,465112,18936,3.9
MT0449740000000,4,49740,"Yuma, AZ MSA",2021,10,93806,82598,11208,11.9
MT0522220000000,5,22220,"Fayetteville-Springdale-Rogers, AR MSA",2021,10,278097,271428,6669,2.4
MT0522900000000,5,22900,"Fort Smith, AR-OK MSA",2021,10,98592,95575,3017,3.1
MT0526300000000,5,26300,"Hot Springs, AR MSA",2021,10,43321,41744,1577,3.6
MT0527860000000,5,27860,"Jonesboro, AR MSA",2021,10,63283,61514,1769,2.8
MT0530780000000,5,30780,"Little Rock-North Little Rock-Conway, AR MSA",2021,10,355920,344240,11680,3.3
MT0612540000000,6,12540,"Bakersfield-Delano, CA MSA",2021,10,390058,355211,34847,8.9
MT0617020000000,6,17020,"Chico, CA MSA",2021,10,90146,84743,5403,6
MT0620940000000,6,20940,"El Centro, CA MSA",2021,10,66996,56041,10955,16.4
MT0623420000000,6,23420,"Fresno, CA MSA",2021,10,505799,464339,41460,8.2
MT0625260000000,6,25260,"Hanford-Corcoran, CA MSA",2021,10,53743,48774,4969,9.2
MT0631080000000,6,31080,"Los Angeles-Long Beach-Anaheim, CA MSA",2021,10,6618961,6174687,444274,6.7
MT0632900000000,6,32900,"Merced, CA MSA",2021,10,115052,104206,10846,9.4
MT0633700000000,6,33700,"Modesto, CA MSA",2021,10,243122,225424,17698,7.3
MT0634900000000,6,34900,"Napa, CA MSA",2021,10,69291,66010,3281,4.7
MT0637100000000,6,37100,"Oxnard-Thousand Oaks-Ventura, CA MSA",2021,10,410741,389699,21042,5.1
MT0639820000000,6,39820,"Redding, CA MSA",2021,10,76082,71578,4504,5.9
MT0640140000000,6,40140,"Riverside-San Bernardino-Ontario, CA MSA",2021,10,2118744,1988168,130576,6.2
MT0640900000000,6,40900,"Sacramento-Roseville-Folsom, CA MSA",2021,10,1131703,1070851,60852,5.4
MT0641500000000,6,41500,"Salinas, CA MSA",2021,10,211912,195799,16113,7.6
MT0641740000000,6,41740,"San Diego-Chula Vista-Carlsbad, CA MSA",2021,10,1588000,1506347,81653,5.1
MT0641860000000,6,41860,"San Francisco-Oakland-Fremont, CA MSA",2021,10,2468668,2356365,112303,4.5
MT0641940000000,6,41940,"San Jose-Sunnyvale-Santa Clara, CA MSA",2021,10,1025912,983703,42209,4.1
MT0642020000000,6,42020,"San Luis Obispo-Paso Robles, CA MSA",2021,10,131364,125481,5883,4.5
MT0642100000000,6,42100,"Santa Cruz-Watsonville, CA MSA",2021,10,133593,125686,7907,5.9
MT0642200000000,6,42200,"Santa Maria-Santa Barbara, CA MSA",2021,10,217109,206739,10370,4.8
MT0642220000000,6,42220,"Santa Rosa-Petaluma, CA MSA",2021,10,242753,231688,11065,4.6
MT0644700000000,6,44700,"Stockton-Lodi, CA MSA",2021,10,351331,326125,25206,7.2
MT0646700000000,6,46700,"Vallejo, CA MSA",2021,10,209059,196333,12726,6.1
MT0647300000000,6,47300,"Visalia, CA MSA",2021,10,204847,185356,19491,9.5
MT0649700000000,6,49700,"Yuba City, CA MSA",2021,10,77342,71200,6142,7.9
MT0814500000000,8,14500,"Boulder, CO MSA",2021,10,190510,183037,7473,3.9
MT0817820000000,8,17820,"Colorado Springs, CO MSA",2021,10,379679,361124,18555,4.9
MT0819740000000,8,19740,"Denver-Aurora-Centennial, CO MSA",2021,10,1725151,1644420,80731,4.7
MT0822660000000,8,22660,"Fort Collins-Loveland, CO MSA",2021,10,201180,192631,8549,4.2
MT0824300000000,8,24300,"Grand Junction, CO MSA",2021,10,78705,74723,3982,5.1
MT0824540000000,8,24540,"Greeley, CO MSA",2021,10,168898,160410,8488,5
MT0839380000000,8,39380,"Pueblo, CO MSA",2021,10,75433,69925,5508,7.3
MT0914860000000,9,14860,"Bridgeport-Stamford-Danbury, CT MSA",2021,10,499709,473911,25798,5.2
MT0925540000000,9,25540,"Hartford-West Hartford-East Hartford, CT MSA",2021,10,604247,570260,33987,5.6
MT0935300000000,9,35300,"New Haven, CT MSA",2021,10,308779,291541,17238,5.6
MT0935980000000,9,35980,"Norwich-New London-Willimantic, CT MSA",2021,10,139596,131067,8529,6.1
MT0947930000000,9,47930,"Waterbury-Shelton, CT MSA",2021,10,239146,224470,14676,6.1
MT1020100000000,10,20100,"Dover, DE MSA",2021,10,84896,80491,4405,5.2
MT1147900000000,11,47900,"Washington-Arlington-Alexandria, DC-VA-MD-WV MSA",2021,10,3392234,3270762,121472,3.6
MT1215980000000,12,15980,"Cape Coral-Fort Myers, FL MSA",2021,10,352957,339283,13674,3.9
MT1218880000000,12,18880,"Crestview-Fort Walton Beach-Destin, FL MSA",2021,10,135787,131593,4194,3.1
MT1219660000000,12,19660,"Deltona-Daytona Beach-Ormond Beach, FL MSA",2021,10,302912,290052,12860,4.2
MT1223540000000,12,23540,"Gainesville, FL MSA",2021,10,163241,157300,5941,3.6
MT1226140000000,12,26140,"Homosassa Springs, FL MSA",2021,10,50877,48346,2531,5
MT1227260000000,12,27260,"Jacksonville, FL MSA",2021,10,806972,777152,29820,3.7
MT1229460000000,12,29460,"Lakeland-Winter Haven, FL MSA",2021,10,338299,322835,15464,4.6
MT1233100000000,12,33100,"Miami-Fort Lauderdale-West Palm Beach, FL MSA",2021,10,3101971,2978604,123367,4
MT1234940000000,12,34940,"Naples-Marco Island, FL MSA",2021,10,170086,164234,5852,3.4
MT1235840000000,12,35840,"North Port-Bradenton-Sarasota, FL MSA",2021,10,365728,352432,13296,3.6
MT1236100000000,12,36100,"Ocala, FL MSA",2021,10,147855,141267,6588,4.5
MT1236740000000,12,36740,"Orlando-Kissimmee-Sanford, FL MSA",2021,10,1399365,1341126,58239,4.2
MT1237340000000,12,37340,"Palm Bay-Melbourne-Titusville, FL MSA",2021,10,289237,278616,10621,3.7
MT1237460000000,12,37460,"Panama City-Panama City Beach, FL MSA",2021,10,95397,91968,3429,3.6
MT1237860000000,12,37860,"Pensacola-Ferry Pass-Brent, FL MSA",2021,10,231058,222244,8814,3.8
MT1238940000000,12,38940,"Port St. Lucie, FL MSA",2021,10,224153,215023,9130,4.1
MT1239460000000,12,39460,"Punta Gorda, FL MSA",2021,10,70290,67280,3010,4.3
MT1242680000000,12,42680,"Sebastian-Vero Beach-West Vero Corridor, FL MSA",2021,10,63797,60976,2821,4.4
MT1242700000000,12,42700,"Sebring, FL MSA",2021,10,34630,32794,1836,5.3
MT1245220000000,12,45220,"Tallahassee, FL MSA",2021,10,196313,188694,7619,3.9
MT1245300000000,12,45300,"Tampa-St. Petersburg-Clearwater, FL MSA",2021,10,1598079,1537840,60239,3.8
MT1248680000000,12,48680,"Wildwood-The Villages, FL MSA",2021,10,30271,28488,1783,5.9
MT1310500000000,13,10500,"Albany, GA MSA",2021,10,62764,60065,2699,4.3
MT1312020000000,13,12020,"Athens-Clarke County, GA MSA",2021,10,102486,99464,3022,2.9
MT1312060000000,13,12060,"Atlanta-Sandy Springs-Roswell, GA MSA",2021,10,3148804,3046253,102551,3.3
MT1312260000000,13,12260,"Augusta-Richmond County, GA-SC MSA",2021,10,263558,254276,9282,3.5
MT1315260000000,13,15260,"Brunswick-St. Simons, GA MSA",2021,10,51717,50071,1646,3.2
MT1317980000000,13,17980,"Columbus, GA-AL MSA",2021,10,130304,125406,4898,3.8
MT1319140000000,13,19140,"Dalton, GA MSA",2021,10,65877,63852,2025,3.1
MT1323580000000,13,23580,"Gainesville, GA MSA",2021,10,100525,97950,2575,2.6
MT1325980000000,13,25980,"Hinesville, GA MSA",2021,10,30577,29427,1150,3.8
MT1331420000000,13,31420,"Macon-Bibb County, GA MSA",2021,10,98567,94809,3758,3.8
MT1340660000000,13,40660,"Rome, GA MSA",2021,10,43628,42181,1447,3.3
MT1342340000000,13,42340,"Savannah, GA MSA",2021,10,202057,195456,6601,3.3
MT1346660000000,13,46660,"Valdosta, GA MSA",2021,10,61274,59104,2170,3.5
MT1347580000000,13,47580,"Warner Robins, GA MSA",2021,10,88352,85497,2855,3.2
MT1527980000000,15,27980,"Kahului-Wailuku, HI MSA",2021,10,82823,79321,3502,4.2
MT1546520000000,15,46520,"Urban Honolulu, HI MSA",2021,10,458535,443205,15330,3.3
MT1614260000000,16,14260,"Boise City, ID MSA",2021,10,413853,401946,11907,2.9
MT1617660000000,16,17660,"Coeur d'Alene, ID MSA",2021,10,85597,82417,3180,3.7
MT1626820000000,16,26820,"Idaho Falls, ID MSA",2021,10,78316,76364,1952,2.5
MT1630300000000,16,30300,"Lewiston, ID-WA MSA",2021,10,30301,29337,964,3.2
MT1638540000000,16,38540,"Pocatello, ID MSA",2021,10,38668,37370,1298,3.4
MT1646300000000,16,46300,"Twin Falls, ID MSA",2021,10,57995,56319,1676,2.9
MT1714010000000,17,14010,"Bloomington, IL MSA",2021,10,89376,85838,3538,4
MT1716580000000,17,16580,"Champaign-Urbana, IL MSA",2021,10,122146,116768,5378,4.4
MT1716980000000,17,16980,"Chicago-Naperville-Elgin, IL-IN MSA",2021,10,4785641,4539247,246394,5.1
MT1719340000000,17,19340,"Davenport-Moline-Rock Island, IA-IL MSA",2021,10,188891,180776,8115,4.3
MT1719500000000,17,19500,"Decatur, IL MSA",2021,10,45630,42473,3157,6.9
MT1728100000000,17,28100,"Kankakee, IL MSA",2021,10,50382,47258,3124,6.2
MT1737900000000,17,37900,"Peoria, IL MSA",2021,10,172672,163657,9015,5.2
MT1740420000000,17,40420,"Rockford, IL MSA",2021,10,160444,148154,12290,7.7
MT1744100000000,17,44100,"Springfield, IL MSA",2021,10,101563,96501,5062,5
MT1814020000000,18,14020,"Bloomington, IN MSA",2021,10,80581,78484,2097,2.6
MT1818020000000,18,18020,"Columbus, IN MSA",2021,10,38081,36981,1100,2.9
MT1821140000000,18,21140,"Elkhart-Goshen, IN MSA",2021,10,105657,103046,2611,2.5
MT1821780000000,18,21780,"Evansville, IN MSA",2021,10,132937,128796,4141,3.1
MT1823060000000,18,23060,"Fort Wayne, IN MSA",2021,10,221600,214850,6750,3
MT1826900000000,18,26900,"Indianapolis-Carmel-Greenwood, IN MSA",2021,10,1078994,1045639,33355,3.1
MT1829020000000,18,29020,"Kokomo, IN MSA",2021,10,35950,34342,1608,4.5
MT1829200000000,18,29200,"Lafayette-West Lafayette, IN MSA",2021,10,113762,110399,3363,3
MT1833140000000,18,33140,"Michigan City-La Porte, IN MSA",2021,10,50174,48160,2014,4
MT1834620000000,18,34620,"Muncie, IN MSA",2021,10,51080,49154,1926,3.8
MT1843780000000,18,43780,"South Bend-Mishawaka, IN-MI MSA",2021,10,152110,146339,5771,3.8
MT1845460000000,18,45460,"Terre Haute, IN MSA",2021,10,75783,73069,2714,3.6
MT1911180000000,19,11180,"Ames, IA MSA",2021,10,67775,65980,1795,2.6
MT1916300000000,19,16300,"Cedar Rapids, IA MSA",2021,10,147743,142680,5063,3.4
MT1919780000000,19,19780,"Des Moines-West Des Moines, IA MSA",2021,10,390869,379121,11748,3
MT1920220000000,19,20220,"Dubuque, IA MSA",2021,10,53206,51317,1889,3.6
MT1926980000000,19,26980,"Iowa City, IA MSA",2021,10,97162,94526,2636,2.7
MT1943580000000,19,43580,"Sioux City, IA-NE-SD MSA",2021,10,75390,73007,2383,3.2
MT1947940000000,19,47940,"Waterloo-Cedar Falls, IA MSA",2021,10,88847,85974,2873,3.2
MT2029940000000,20,29940,"Lawrence, KS MSA",2021,10,68085,66296,1789,2.6
MT2031740000000,20,31740,"Manhattan, KS MSA",2021,10,62517,60869,1648,2.6
MT2045820000000,20,45820,"Topeka, KS MSA",2021,10,115770,112367,3403,2.9
MT2048620000000,20,48620,"Wichita, KS MSA",2021,10,323701,312158,11543,3.6
MT2114540000000,21,14540,"Bowling Green, KY MSA",2021,10,87556,84302,3254,3.7
MT2121060000000,21,21060,"Elizabethtown, KY MSA",2021,10,53343,50972,2371,4.4
MT2130460000000,21,30460,"Lexington-Fayette, KY MSA",2021,10,265376,256061,9315,3.5
MT2131140000000,21,31140,"Louisville/Jefferson County, KY-IN MSA",2021,10,681128,654312,26816,3.9
MT2136980000000,21,36980,"Owensboro, KY MSA",2021,10,51519,49549,1970,3.8
MT2137140000000,21,37140,"Paducah, KY-IL MSA",2021,10,45018,42893,2125,4.7
MT2210780000000,22,10780,"Alexandria, LA MSA",2021,10,64698,62516,2182,3.4
MT2212940000000,22,12940,"Baton Rouge, LA MSA",2021,10,419517,402368,17149,4.1
MT2225220000000,22,25220,"Hammond, LA MSA",2021,10,58319,55337,2982,5.1
MT2226380000000,22,26380,"Houma-Bayou Cane-Thibodaux, LA MSA",2021,10,83775,79915,3860,4.6
MT2229180000000,22,29180,"Lafayette, LA MSA",2021,10,193702,186629,7073,3.7
MT2229340000000,22,29340,"Lake Charles, LA MSA",2021,10,102571,98013,4558,4.4
MT2233740000000,22,33740,"Monroe, LA MSA",2021,10,95875,91619,4256,4.4
MT2235380000000,22,35380,"New Orleans-Metairie, LA MSA",2021,10,459369,435467,23902,5.2
MT2243340000000,22,43340,"Shreveport-Bossier City, LA MSA",2021,10,166427,159291,7136,4.3
MT2243640000000,22,43640,"Slidell-Mandeville-Covington, LA MSA",2021,10,123562,119684,3878,3.1
MT2312620000000,23,12620,"Bangor, ME MSA",2021,10,73870,70367,3503,4.7
MT2330340000000,23,30340,"Lewiston-Auburn, ME MSA",2021,10,55418,52776,2642,4.8
MT2338860000000,23,38860,"Portland-South Portland, ME MSA",2021,10,303521,292239,11282,3.7
MT2412580000000,24,12580,"Baltimore-Columbia-Towson, MD MSA",2021,10,1450059,1390477,59582,4.1
MT2425180000000,24,25180,"Hagerstown-Martinsburg, MD-WV MSA",2021,10,140425,135381,5044,3.6
MT2430500000000,24,30500,"Lexington Park, MD MSA",2021,10,105906,102120,3786,3.6
MT2441540000000,24,41540,"Salisbury, MD MSA",2021,10,60271,57550,2721,4.5
MT2511200000000,25,11200,"Amherst Town-Northampton, MA MSA",2021,10,83641,80284,3357,4
MT2512700000000,25,12700,"Barnstable Town, MA MSA",2021,10,112348,106231,6117,5.4
MT2514460000000,25,14460,"Boston-Cambridge-Newton, MA-NH MSA",2021,10,2711490,2605169,106321,3.9
MT2538340000000,25,38340,"Pittsfield, MA MSA",2021,10,63289,60076,3213,5.1
MT2544140000000,25,44140,"Springfield, MA MSA",2021,10,224070,211265,12805,5.7
MT2549340000000,25,49340,"Worcester, MA MSA",2021,10,449733,429392,20341,4.5
MT2611460000000,26,11460,"Ann Arbor, MI MSA",2021,10,193722,186908,6814,3.5
MT2612980000000,26,12980,"Battle Creek, MI MSA",2021,10,58468,55197,3271,5.6
MT2613020000000,26,13020,"Bay City, MI MSA",2021,10,47555,44975,2580,5.4
MT2619820000000,26,19820,"Detroit-Warren-Dearborn, MI MSA",2021,10,2113347,2001012,112335,5.3
MT2622420000000,26,22420,"Flint, MI MSA",2021,10,177546,166401,11145,6.3
MT2624340000000,26,24340,"Grand Rapids-Wyoming-Kentwood, MI MSA",2021,10,587253,564352,22901,3.9
MT2627100000000,26,27100,"Jackson, MI MSA",2021,10,71406,67803,3603,5
MT2628020000000,26,28020,"Kalamazoo-Portage, MI MSA",2021,10,130782,125403,5379,4.1
MT2629620000000,26,29620,"Lansing-East Lansing, MI MSA",2021,10,231485,220584,10901,4.7
MT2633220000000,26,33220,"Midland, MI MSA",2021,10,38821,37175,1646,4.2
MT2633780000000,26,33780,"Monroe, MI MSA",2021,10,71892,68142,3750,5.2
MT2634740000000,26,34740,"Muskegon-Norton Shores, MI MSA",2021,10,80048,75460,4588,5.7
MT2635660000000,26,35660,"Niles, MI MSA",2021,10,71410,67913,3497,4.9
MT2640980000000,26,40980,"Saginaw, MI MSA",2021,10,81989,76937,5052,6.2
MT2645900000000,26,45900,"Traverse City, MI MSA",2021,10,76009,72551,3458,4.5
MT2720260000000,27,20260,"Duluth, MN-WI MSA",2021,10,138016,132806,5210,3.8
MT2731860000000,27,31860,"Mankato, MN MSA",2021,10,57726,56113,1613,2.8
MT2733460000000,27,33460,"Minneapolis-St. Paul-Bloomington, MN-WI MSA",2021,10,2016042,1954967,61075,3
MT2740340000000,27,40340,"Rochester, MN MSA",2021,10,123674,120303,3371,2.7
MT2741060000000,27,41060,"St. Cloud, MN MSA",2021,10,107186,103432,3754,3.5
MT2825060000000,28,25060,"Gulfport-Biloxi, MS MSA",2021,10,184990,177006,7984,4.3
MT2825620000000,28,25620,"Hattiesburg, MS MSA",2021,10,70005,67138,2867,4.1
MT2827140000000,28,27140,"Jackson, MS MSA",2021,10,275997,264454,11543,4.2
MT2916020000000,29,16020,"Cape Girardeau, MO-IL MSA",2021,10,47295,45816,1479,3.1
MT2917860000000,29,17860,"Columbia, MO MSA",2021,10,111628,108794,2834,2.5
MT2927620000000,29,27620,"Jefferson City, MO MSA",2021,10,72714,70750,1964,2.7
MT2927900000000,29,27900,"Joplin, MO-KS MSA",2021,10,94312,91542,2770,2.9
MT2928140000000,29,28140,"Kansas City, MO-KS MSA",2021,10,1150060,1110817,39243,3.4
MT2941140000000,29,41140,"St. Joseph, MO-KS MSA",2021,10,55574,53762,1812,3.3
MT2941180000000,29,41180,"St. Louis, MO-IL MSA",2021,10,1445432,1390721,54711,3.8
MT2944180000000,29,44180,"Springfield, MO MSA",2021,10,232172,225616,6556,2.8
MT3013740000000,30,13740,"Billings, MT MSA",2021,10,96304,93742,2562,2.7
MT3014580000000,30,14580,"Bozeman, MT MSA",2021,10,72042,70509,1533,2.1
MT3024500000000,30,24500,"Great Falls, MT MSA",2021,10,38735,37662,1073,2.8
MT3025740000000,30,25740,"Helena, MT MSA",2021,10,45274,44047,1227,2.7
MT3033540000000,30,33540,"Missoula, MT MSA",2021,10,70802,68850,1952,2.8
MT3124260000000,31,24260,"Grand Island, NE MSA",2021,10,40919,39929,990,2.4
MT3130700000000,31,30700,"Lincoln, NE MSA",2021,10,187654,183747,3907,2.1
MT3136540000000,31,36540,"Omaha, NE-IA MSA",2021,10,513096,500026,13070,2.5
MT3216180000000,32,16180,"Carson City, NV MSA",2021,10,27354,26313,1041,3.8
MT3229820000000,32,29820,"Las Vegas-Henderson-North Las Vegas, NV MSA",2021,10,1098327,1030313,68014,6.2
MT3239900000000,32,39900,"Reno, NV MSA",2021,10,277003,266782,10221,3.7
MT3331700000000,33,31700,"Manchester-Nashua, NH MSA",2021,10,235771,228896,6875,2.9
MT3412100000000,34,12100,"Atlantic City-Hammonton, NJ MSA",2021,10,176887,161990,14897,8.4
MT3445940000000,34,45940,"Trenton-Princeton, NJ MSA",2021,10,192246,181597,10649,5.5
MT3447220000000,34,47220,"Vineland, NJ MSA",2021,10,64323,59090,5233,8.1
MT3510740000000,35,10740,"Albuquerque, NM MSA",2021,10,446817,422172,24645,5.5
MT3522140000000,35,22140,"Farmington, NM MSA",2021,10,48308,44805,3503,7.3
MT3529740000000,35,29740,"Las Cruces, NM MSA",2021,10,97640,91485,6155,6.3
MT3542140000000,35,42140,"Santa Fe, NM MSA",2021,10,72961,68981,3980,5.5
MT3610580000000,36,10580,"Albany-Schenectady-Troy, NY MSA",2021,10,450170,434048,16122,3.6
MT3613780000000,36,13780,"Binghamton, NY MSA",2021,10,106039,101579,4460,4.2
MT3615380000000,36,15380,"Buffalo-Cheektowaga, NY MSA",2021,10,551991,528292,23699,4.3
MT3621300000000,36,21300,"Elmira, NY MSA",2021,10,36021,34518,1503,4.2
MT3624020000000,36,24020,"Glens Falls, NY MSA",2021,10,59532,57143,2389,4
MT3627060000000,36,27060,"Ithaca, NY MSA",2021,10,48834,47217,1617,3.3
MT3628740000000,36,28740,"Kingston, NY MSA",2021,10,85372,82027,3345,3.9
MT3628880000000,36,28880,"Kiryas Joel-Poughkeepsie-Newburgh, NY MSA",2021,10,327493,314901,12592,3.8
MT3635620000000,36,35620,"New York-Newark-Jersey City, NY-NJ MSA",2021,10,9768944,9132490,636454,6.5
MT3640380000000,36,40380,"Rochester, NY MSA",2021,10,508873,488598,20275,4
MT3645060000000,36,45060,"Syracuse, NY MSA",2021,10,307925,295458,12467,4
MT3646540000000,36,46540,"Utica-Rome, NY MSA",2021,10,128225,122726,5499,4.3
MT3648060000000,36,48060,"Watertown-Fort Drum, NY MSA",2021,10,44719,42720,1999,4.5
MT3711700000000,37,11700,"Asheville, NC MSA",2021,10,202546,195322,7224,3.6
MT3715500000000,37,15500,"Burlington, NC MSA",2021,10,81806,78288,3518,4.3
MT3716740000000,37,16740,"Charlotte-Concord-Gastonia, NC-SC MSA",2021,10,1393456,1337095,56361,4
MT3720500000000,37,20500,"Durham-Chapel Hill, NC MSA",2021,10,305958,294993,10965,3.6
MT3722180000000,37,22180,"Fayetteville, NC MSA",2021,10,152352,143783,8569,5.6
MT3724140000000,37,24140,"Goldsboro, NC MSA",2021,10,49326,47108,2218,4.5
MT3724660000000,37,24660,"Greensboro-High Point, NC MSA",2021,10,367852,350657,17195,4.7
MT3724780000000,37,24780,"Greenville, NC MSA",2021,10,80420,76557,3863,4.8
MT3725860000000,37,25860,"Hickory-Lenoir-Morganton, NC MSA",2021,10,168255,161442,6813,4
MT3727340000000,37,27340,"Jacksonville, NC MSA",2021,10,70487,67597,2890,4.1
MT3738240000000,37,38240,"Pinehurst-Southern Pines, NC MSA",2021,10,41789,40102,1687,4
MT3739580000000,37,39580,"Raleigh-Cary, NC MSA",2021,10,775044,748278,26766,3.5
MT3740580000000,37,40580,"Rocky Mount, NC MSA",2021,10,64609,60642,3967,6.1
MT3748900000000,37,48900,"Wilmington, NC MSA",2021,10,206291,197847,8444,4.1
MT3749180000000,37,49180,"Winston-Salem, NC MSA",2021,10,317075,303623,13452,4.2
MT3813900000000,38,13900,"Bismarck, ND MSA",2021,10,72489,70868,1621,2.2
MT3822020000000,38,22020,"Fargo, ND-MN MSA",2021,10,147438,144352,3086,2.1
MT3824220000000,38,24220,"Grand Forks, ND-MN MSA",2021,10,54166,52760,1406,2.6
MT3833500000000,38,33500,"Minot, ND MSA",2021,10,39492,38450,1042,2.6
MT3910420000000,39,10420,"Akron, OH MSA",2021,10,350301,335144,15157,4.3
MT3915940000000,39,15940,"Canton-Massillon, OH MSA",2021,10,190131,181590,8541,4.5
MT3917140000000,39,17140,"Cincinnati, OH-KY-IN MSA",2021,10,1134334,1091190,43144,3.8
MT3917410000000,39,17410,"Cleveland, OH MSA",2021,10,1063859,1009375,54484,5.1
MT3918140000000,39,18140,"Columbus, OH MSA",2021,10,1111772,1070265,41507,3.7
MT3919430000000,39,19430,"Dayton-Kettering-Beavercreek, OH MSA",2021,10,380191,363942,16249,4.3
MT3930620000000,39,30620,"Lima, OH MSA",2021,10,47358,45260,2098,4.4
MT3931900000000,39,31900,"Mansfield, OH MSA",2021,10,52534,49990,2544,4.8
MT3941780000000,39,41780,"Sandusky, OH MSA",2021,10,56522,53462,3060,5.4
MT3944220000000,39,44220,"Springfield, OH MSA",2021,10,61449,58232,3217,5.2
MT3945780000000,39,45780,"Toledo, OH MSA",2021,10,288515,274700,13815,4.8
MT3948260000000,39,48260,"Weirton-Steubenville, WV-OH MSA",2021,10,52757,49991,2766,5.2
MT3949660000000,39,49660,"Youngstown-Warren, OH MSA",2021,10,187852,178241,9611,5.1
MT4021420000000,40,21420,"Enid, OK MSA",2021,10,28156,27408,748,2.7
MT4030020000000,40,30020,"Lawton, OK MSA",2021,10,50599,49079,1520,3
MT4036420000000,40,36420,"Oklahoma City, OK MSA",2021,10,713747,693550,20197,2.8
MT4046140000000,40,46140,"Tulsa, OK MSA",2021,10,488396,473711,14685,3
MT4110540000000,41,10540,"Albany, OR MSA",2021,10,60560,57764,2796,4.6
MT4113460000000,41,13460,"Bend, OR MSA",2021,10,125326,119944,5382,4.3
MT4118700000000,41,18700,"Corvallis, OR MSA",2021,10,47541,45958,1583,3.3
MT4121660000000,41,21660,"Eugene-Springfield, OR MSA",2021,10,185337,177186,8151,4.4
MT4124420000000,41,24420,"Grants Pass, OR MSA",2021,10,35169,33240,1929,5.5
MT4132780000000,41,32780,"Medford, OR MSA",2021,10,104666,99764,4902,4.7
MT4138900000000,41,38900,"Portland-Vancouver-Hillsboro, OR-WA MSA",2021,10,1355747,1301979,53768,4
MT4141420000000,41,41420,"Salem, OR MSA",2021,10,210879,202160,8719,4.1
MT4210900000000,42,10900,"Allentown-Bethlehem-Easton, PA-NJ MSA",2021,10,439647,416758,22889,5.2
MT4211020000000,42,11020,"Altoona, PA MSA",2021,10,57073,54211,2862,5
MT4216540000000,42,16540,"Chambersburg, PA MSA",2021,10,76061,72956,3105,4.1
MT4221500000000,42,21500,"Erie, PA MSA",2021,10,125083,118086,6997,5.6
MT4223900000000,42,23900,"Gettysburg, PA MSA",2021,10,51665,49697,1968,3.8
MT4225420000000,42,25420,"Harrisburg-Carlisle, PA MSA",2021,10,301478,288486,12992,4.3
MT4227780000000,42,27780,"Johnstown, PA MSA",2021,10,56833,53587,3246,5.7
MT4229540000000,42,29540,"Lancaster, PA MSA",2021,10,285306,274060,11246,3.9
MT4230140000000,42,30140,"Lebanon, PA MSA",2021,10,70586,67466,3120,4.4
MT4237980000000,42,37980,"Philadelphia-Camden-Wilmington, PA-NJ-DE-MD MSA",2021,10,3173486,3011344,162142,5.1
MT4238300000000,42,38300,"Pittsburgh, PA MSA",2021,10,1218200,1157018,61182,5
MT4239740000000,42,39740,"Reading, PA MSA",2021,10,212483,201745,10738,5.1
MT4242540000000,42,42540,"Scranton--Wilkes-Barre, PA MSA",2021,10,273314,256943,16371,6
MT4244300000000,42,44300,"State College, PA MSA",2021,10,74148,71332,2816,3.8
MT4248700000000,42,48700,"Williamsport, PA MSA",2021,10,51804,48851,2953,5.7
MT4249620000000,42,49620,"York-Hanover, PA MSA",2021,10,232760,222702,10058,4.3
MT4439300000000,44,39300,"Providence-Warwick, RI-MA MSA",2021,10,867746,827933,39813,4.6
MT4516700000000,45,16700,"Charleston-North Charleston, SC MSA",2021,10,400215,388122,12093,3
MT4517900000000,45,17900,"Columbia, SC MSA",2021,10,394394,381697,12697,3.2
MT4522500000000,45,22500,"Florence, SC MSA",2021,10,88926,85506,3420,3.8
MT4524860000000,45,24860,"Greenville-Anderson-Greer, SC MSA",2021,10,447246,433797,13449,3
MT4525940000000,45,25940,"Hilton Head Island-Bluffton-Port Royal, SC MSA",2021,10,91685,88969,2716,3
MT4534820000000,45,34820,"Myrtle Beach-Conway-North Myrtle Beach, SC MSA",2021,10,155636,149039,6597,4.2
MT4543900000000,45,43900,"Spartanburg, SC MSA",2021,10,166417,160416,6001,3.6
MT4544940000000,45,44940,"Sumter, SC MSA",2021,10,41867,40198,1669,4
MT4639660000000,46,39660,"Rapid City, SD MSA",2021,10,77007,75270,1737,2.3
MT4643620000000,46,43620,"Sioux Falls, SD-MN MSA",2021,10,165886,162556,3330,2
MT4716860000000,47,16860,"Chattanooga, TN-GA MSA",2021,10,270957,261833,9124,3.4
MT4717300000000,47,17300,"Clarksville, TN-KY MSA",2021,10,132890,127552,5338,4
MT4717420000000,47,17420,"Cleveland, TN MSA",2021,10,56829,54730,2099,3.7
MT4727180000000,47,27180,"Jackson, TN MSA",2021,10,78619,75484,3135,4
MT4727740000000,47,27740,"Johnson City, TN MSA",2021,10,96090,92905,3185,3.3
MT4728700000000,47,28700,"Kingsport-Bristol, TN-VA MSA",2021,10,128922,124281,4641,3.6
MT4728940000000,47,28940,"Knoxville, TN MSA",2021,10,434343,420972,13371,3.1
MT4732820000000,47,32820,"Memphis, TN-MS-AR MSA",2021,10,640651,608507,32144,5
MT4734100000000,47,34100,"Morristown, TN MSA",2021,10,52407,50441,1966,3.8
MT4734980000000,47,34980,"Nashville-Davidson--Murfreesboro--Franklin, TN MSA",2021,10,1105096,1070850,34246,3.1
MT4810180000000,48,10180,"Abilene, TX MSA",2021,10,81279,77977,3302,4.1
MT4811100000000,48,11100,"Amarillo, TX MSA",2021,10,131966,127198,4768,3.6
MT4812420000000,48,12420,"Austin-Round Rock-San Marcos, TX MSA",2021,10,1339830,1292264,47566,3.6
MT4813140000000,48,13140,"Beaumont-Port Arthur, TX MSA",2021,10,169490,156845,12645,7.5
MT4815180000000,48,15180,"Brownsville-Harlingen, TX MSA",2021,10,179962,167867,12095,6.7
MT4817780000000,48,17780,"College Station-Bryan, TX MSA",2021,10,137264,131869,5395,3.9
MT4818580000000,48,18580,"Corpus Christi, TX MSA",2021,10,200768,188524,12244,6.1
MT4819100000000,48,19100,"Dallas-Fort Worth-Arlington, TX MSA",2021,10,4125726,3947385,178341,4.3
MT4820580000000,48,20580,"Eagle Pass, TX MSA",2021,10,23493,21082,2411,10.3
MT4821340000000,48,21340,"El Paso, TX MSA",2021,10,386236,366679,19557,5.1
MT4826420000000,48,26420,"Houston-Pasadena-The Woodlands, TX MSA",2021,10,3537409,3351197,186212,5.3
MT4828660000000,48,28660,"Killeen-Temple, TX MSA",2021,10,193536,183929,9607,5
MT4829700000000,48,29700,"Laredo, TX MSA",2021,10,111564,105496,6068,5.4
MT4830980000000,48,30980,"Longview, TX MSA",2021,10,125363,118596,6767,5.4
MT4831180000000,48,31180,"Lubbock, TX MSA",2021,10,175284,167943,7341,4.2
MT4832580000000,48,32580,"McAllen-Edinburg-Mission, TX MSA",2021,10,375214,346382,28832,7.7
MT4833260000000,48,33260,"Midland, TX MSA",2021,10,89919,85571,4348,4.8
MT4836220000000,48,36220,"Odessa, TX MSA",2021,10,77950,73157,4793,6.1
MT4841660000000,48,41660,"San Angelo, TX MSA",2021,10,58395,56041,2354,4
MT4841700000000,48,41700,"San Antonio-New Braunfels, TX MSA",2021,10,1234742,1179740,55002,4.5
MT4843300000000,48,43300,"Sherman-Denison, TX MSA",2021,10,65927,63139,2788,4.2
MT4845500000000,48,45500,"Texarkana, TX-AR MSA",2021,10,60383,57375,3008,5
MT4846340000000,48,46340,"Tyler, TX MSA",2021,10,110153,105282,4871,4.4
MT4847020000000,48,47020,"Victoria, TX MSA",2021,10,44383,42008,2375,5.4
MT4847380000000,48,47380,"Waco, TX MSA",2021,10,139013,132922,6091,4.4
MT4848660000000,48,48660,"Wichita Falls, TX MSA",2021,10,65446,62564,2882,4.4
MT4930860000000,49,30860,"Logan, UT-ID MSA",2021,10,77088,75613,1475,1.9
MT4936260000000,49,36260,"Ogden, UT MSA",2021,10,327282,320144,7138,2.2
MT4939340000000,49,39340,"Provo-Orem-Lehi, UT MSA",2021,10,343506,336303,7203,2.1
MT4941100000000,49,41100,"St. George, UT MSA",2021,10,83556,81399,2157,2.6
MT4941620000000,49,41620,"Salt Lake City-Murray, UT MSA",2021,10,688801,672316,16485,2.4
MT5015540000000,50,15540,"Burlington-South Burlington, VT MSA",2021,10,124436,121226,3210,2.6
MT5113980000000,51,13980,"Blacksburg-Christiansburg-Radford, VA MSA",2021,10,88134,85657,2477,2.8
MT5116820000000,51,16820,"Charlottesville, VA MSA",2021,10,112289,109079,3210,2.9
MT5125500000000,51,25500,"Harrisonburg, VA MSA",2021,10,69751,67788,1963,2.8
MT5131340000000,51,31340,"Lynchburg, VA MSA",2021,10,125025,120919,4106,3.3
MT5140060000000,51,40060,"Richmond, VA MSA",2021,10,682531,659047,23484,3.4
MT5140220000000,51,40220,"Roanoke, VA MSA",2021,10,150821,145817,5004,3.3
MT5144420000000,51,44420,"Staunton-Stuarts Draft, VA MSA",2021,10,62046,60289,1757,2.8
MT5147260000000,51,47260,"Virginia Beach-Chesapeake-Norfolk, VA-NC MSA",2021,10,843873,812412,31461,3.7
MT5149020000000,51,49020,"Winchester, VA-WV MSA",2021,10,72620,70468,2152,3
MT5313380000000,53,13380,"Bellingham, WA MSA",2021,10,114252,108940,5312,4.6
MT5314740000000,53,14740,"Bremerton-Silverdale-Port Orchard, WA MSA",2021,10,122612,117294,5318,4.3
MT5328420000000,53,28420,"Kennewick-Richland, WA MSA",2021,10,145087,137603,7484,5.2
MT5331020000000,53,31020,"Longview-Kelso, WA MSA",2021,10,47796,45269,2527,5.3
MT5334580000000,53,34580,"Mount Vernon-Anacortes, WA MSA",2021,10,59011,55879,3132,5.3
MT5336500000000,53,36500,"Olympia-Lacey-Tumwater, WA MSA",2021,10,139611,133325,6286,4.5
MT5342660000000,53,42660,"Seattle-Tacoma-Bellevue, WA MSA",2021,10,2173944,2085032,88912,4.1
MT5344060000000,53,44060,"Spokane-Spokane Valley, WA MSA",2021,10,283410,270593,12817,4.5
MT5347460000000,53,47460,"Walla Walla, WA MSA",2021,10,30137,28899,1238,4.1
MT5348300000000,53,48300,"Wenatchee-East Wenatchee, WA MSA",2021,10,62368,59347,3021,4.8
MT5349420000000,53,49420,"Yakima, WA MSA",2021,10,128181,120383,7798,6.1
MT5413220000000,54,13220,"Beckley, WV MSA",2021,10,45036,43009,2027,4.5
MT5416620000000,54,16620,"Charleston, WV MSA",2021,10,89339,85451,3888,4.4
MT5426580000000,54,26580,"Huntington-Ashland, WV-KY-OH MSA",2021,10,154086,146924,7162,4.6
MT5434060000000,54,34060,"Morgantown, WV MSA",2021,10,70704,67976,2728,3.9
MT5437620000000,54,37620,"Parkersburg-Vienna, WV MSA",2021,10,38617,36897,1720,4.5
MT5448540000000,54,48540,"Wheeling, WV-OH MSA",2021,10,59459,56420,3039,5.1
MT5511540000000,55,11540,"Appleton, WI MSA",2021,10,134378,130900,3478,2.6
MT5520740000000,55,20740,"Eau Claire, WI MSA",2021,10,92657,89904,2753,3
MT5522540000000,55,22540,"Fond du Lac, WI MSA",2021,10,56171,54628,1543,2.7
MT5524580000000,55,24580,"Green Bay, WI MSA",2021,10,174834,169765,5069,2.9
MT5527500000000,55,27500,"Janesville-Beloit, WI MSA",2021,10,83909,80617,3292,3.9
MT5528450000000,55,28450,"Kenosha, WI MSA",2021,10,92217,88917,3300,3.6
MT5529100000000,55,29100,"La Crosse-Onalaska, WI-MN MSA",2021,10,88281,85861,2420,2.7
MT5531540000000,55,31540,"Madison, WI MSA",2021,10,393415,383868,9547,2.4
MT5533340000000,55,33340,"Milwaukee-Waukesha, WI MSA",2021,10,811594,782612,28982,3.6
MT5536780000000,55,36780,"Oshkosh-Neenah, WI MSA",2021,10,91617,89125,2492,2.7
MT5539540000000,55,39540,"Racine-Mount Pleasant, WI MSA",2021,10,100004,96160,3844,3.8
MT5543100000000,55,43100,"Sheboygan, WI MSA",2021,10,61987,60340,1647,2.7
MT5548140000000,55,48140,"Wausau, WI MSA",2021,10,74237,72314,1923,2.6
MT5616220000000,56,16220,"Casper, WY MSA",2021,10,40756,38951,1805,4.4
MT5616940000000,56,16940,"Cheyenne, WY MSA",2021,10,48973,47258,1715,3.5
MT7210380000000,72,10380,"Aguadilla, PR MSA",2021,10,84427,77040,7387,8.7
MT7211640000000,72,11640,"Arecibo, PR MSA",2021,10,64396,59496,4900,7.6
MT7225020000000,72,25020,"Guayama, PR MSA",2021,10,19510,17683,1827,9.4
MT7232420000000,72,32420,"Mayaguez, PR MSA",2021,10,66331,60094,6237,9.4
MT7238660000000,72,38660,"Ponce, PR MSA",2021,10,89685,80741,8944,10
MT7241980000000,72,41980,"San Juan-Bayamon-Caguas, PR MSA",2021,10,804368,751345,53023,6.6
MT0111500000000,1,11500,"Anniston-Oxford, AL MSA",2021,11,49592,48081,1511,3
MT0112220000000,1,12220,"Auburn-Opelika, AL MSA",2021,11,90671,88369,2302,2.5
MT0113820000000,1,13820,"Birmingham, AL MSA",2021,11,554624,540641,13983,2.5
MT0119300000000,1,19300,"Daphne-Fairhope-Foley, AL MSA",2021,11,109363,107044,2319,2.1
MT0119460000000,1,19460,"Decatur, AL MSA",2021,11,71804,70202,1602,2.2
MT0120020000000,1,20020,"Dothan, AL MSA",2021,11,65853,64172,1681,2.6
MT0122520000000,1,22520,"Florence-Muscle Shoals, AL MSA",2021,11,66716,64854,1862,2.8
MT0123460000000,1,23460,"Gadsden, AL MSA",2021,11,41060,39799,1261,3.1
MT0126620000000,1,26620,"Huntsville, AL MSA",2021,11,251232,245963,5269,2.1
MT0133660000000,1,33660,"Mobile, AL MSA",2021,11,182889,176220,6669,3.6
MT0133860000000,1,33860,"Montgomery, AL MSA",2021,11,172586,167179,5407,3.1
MT0146220000000,1,46220,"Tuscaloosa, AL MSA",2021,11,119476,115842,3634,3
MT0211260000000,2,11260,"Anchorage, AK MSA",2021,11,198688,188426,10262,5.2
MT0221820000000,2,21820,"Fairbanks-College, AK MSA",2021,11,44752,42628,2124,4.7
MT0422380000000,4,22380,"Flagstaff, AZ MSA",2021,11,71135,67933,3202,4.5
MT0429420000000,4,29420,"Lake Havasu City-Kingman, AZ MSA",2021,11,84459,80683,3776,4.5
MT0438060000000,4,38060,"Phoenix-Mesa-Chandler, AZ MSA",2021,11,2535916,2452920,82996,3.3
MT0439150000000,4,39150,"Prescott Valley-Prescott, AZ MSA",2021,11,100920,97533,3387,3.4
MT0443420000000,4,43420,"Sierra Vista-Douglas, AZ MSA",2021,11,47154,45018,2136,4.5
MT0446060000000,4,46060,"Tucson, AZ MSA",2021,11,484182,466234,17948,3.7
MT0449740000000,4,49740,"Yuma, AZ MSA",2021,11,94172,82983,11189,11.9
MT0522220000000,5,22220,"Fayetteville-Springdale-Rogers, AR MSA",2021,11,279585,273059,6526,2.3
MT0522900000000,5,22900,"Fort Smith, AR-OK MSA",2021,11,98989,96086,2903,2.9
MT0526300000000,5,26300,"Hot Springs, AR MSA",2021,11,43400,41886,1514,3.5
MT0527860000000,5,27860,"Jonesboro, AR MSA",2021,11,63455,61743,1712,2.7
MT0530780000000,5,30780,"Little Rock-North Little Rock-Conway, AR MSA",2021,11,357833,346626,11207,3.1
MT0612540000000,6,12540,"Bakersfield-Delano, CA MSA",2021,11,391255,358406,32849,8.4
MT0617020000000,6,17020,"Chico, CA MSA",2021,11,89980,84931,5049,5.6
MT0620940000000,6,20940,"El Centro, CA MSA",2021,11,66964,56362,10602,15.8
MT0623420000000,6,23420,"Fresno, CA MSA",2021,11,506651,467160,39491,7.8
MT0625260000000,6,25260,"Hanford-Corcoran, CA MSA",2021,11,53726,49044,4682,8.7
MT0631080000000,6,31080,"Los Angeles-Long Beach-Anaheim, CA MSA",2021,11,6625209,6210264,414945,6.3
MT0632900000000,6,32900,"Merced, CA MSA",2021,11,115120,104689,10431,9.1
MT0633700000000,6,33700,"Modesto, CA MSA",2021,11,243391,226791,16600,6.8
MT0634900000000,6,34900,"Napa, CA MSA",2021,11,69564,66520,3044,4.4
MT0637100000000,6,37100,"Oxnard-Thousand Oaks-Ventura, CA MSA",2021,11,411143,391459,19684,4.8
MT0639820000000,6,39820,"Redding, CA MSA",2021,11,76058,71860,4198,5.5
MT0640140000000,6,40140,"Riverside-San Bernardino-Ontario, CA MSA",2021,11,2123713,2001687,122026,5.7
MT0640900000000,6,40900,"Sacramento-Roseville-Folsom, CA MSA",2021,11,1132244,1075463,56781,5
MT0641500000000,6,41500,"Salinas, CA MSA",2021,11,212655,197460,15195,7.1
MT0641740000000,6,41740,"San Diego-Chula Vista-Carlsbad, CA MSA",2021,11,1591973,1516080,75893,4.8
MT0641860000000,6,41860,"San Francisco-Oakland-Fremont, CA MSA",2021,11,2475749,2371015,104734,4.2
MT0641940000000,6,41940,"San Jose-Sunnyvale-Santa Clara, CA MSA",2021,11,1028183,988676,39507,3.8
MT0642020000000,6,42020,"San Luis Obispo-Paso Robles, CA MSA",2021,11,131360,125861,5499,4.2
MT0642100000000,6,42100,"Santa Cruz-Watsonville, CA MSA",2021,11,133516,126028,7488,5.6
MT0642200000000,6,42200,"Santa Maria-Santa Barbara, CA MSA",2021,11,217260,207579,9681,4.5
MT0642220000000,6,42220,"Santa Rosa-Petaluma, CA MSA",2021,11,243139,232822,10317,4.2
MT0644700000000,6,44700,"Stockton-Lodi, CA MSA",2021,11,352386,328893,23493,6.7
MT0646700000000,6,46700,"Vallejo, CA MSA",2021,11,209129,197264,11865,5.7
MT0647300000000,6,47300,"Visalia, CA MSA",2021,11,204935,186422,18513,9
MT0649700000000,6,49700,"Yuba City, CA MSA",2021,11,77424,71678,5746,7.4
MT0814500000000,8,14500,"Boulder, CO MSA",2021,11,190742,183721,7021,3.7
MT0817820000000,8,17820,"Colorado Springs, CO MSA",2021,11,380004,362670,17334,4.6
MT0819740000000,8,19740,"Denver-Aurora-Centennial, CO MSA",2021,11,1729666,1654746,74920,4.3
MT0822660000000,8,22660,"Fort Collins-Loveland, CO MSA",2021,11,201514,193484,8030,4
MT0824300000000,8,24300,"Grand Junction, CO MSA",2021,11,78603,74889,3714,4.7
MT0824540000000,8,24540,"Greeley, CO MSA",2021,11,169433,161501,7932,4.7
MT0839380000000,8,39380,"Pueblo, CO MSA",2021,11,75243,70143,5100,6.8
MT0914860000000,9,14860,"Bridgeport-Stamford-Danbury, CT MSA",2021,11,503529,478915,24614,4.9
MT0925540000000,9,25540,"Hartford-West Hartford-East Hartford, CT MSA",2021,11,609617,577283,32334,5.3
MT0935300000000,9,35300,"New Haven, CT MSA",2021,11,311246,294861,16385,5.3
MT0935980000000,9,35980,"Norwich-New London-Willimantic, CT MSA",2021,11,140868,132795,8073,5.7
MT0947930000000,9,47930,"Waterbury-Shelton, CT MSA",2021,11,240833,226909,13924,5.8
MT1020100000000,10,20100,"Dover, DE MSA",2021,11,84911,80644,4267,5
MT1147900000000,11,47900,"Washington-Arlington-Alexandria, DC-VA-MD-WV MSA",2021,11,3397320,3284016,113304,3.3
MT1215980000000,12,15980,"Cape Coral-Fort Myers, FL MSA",2021,11,354239,341006,13233,3.7
MT1218880000000,12,18880,"Crestview-Fort Walton Beach-Destin, FL MSA",2021,11,136475,132455,4020,2.9
MT1219660000000,12,19660,"Deltona-Daytona Beach-Ormond Beach, FL MSA",2021,11,304344,291983,12361,4.1
MT1223540000000,12,23540,"Gainesville, FL MSA",2021,11,163513,157769,5744,3.5
MT1226140000000,12,26140,"Homosassa Springs, FL MSA",2021,11,51090,48639,2451,4.8
MT1227260000000,12,27260,"Jacksonville, FL MSA",2021,11,811749,782880,28869,3.6
MT1229460000000,12,29460,"Lakeland-Winter Haven, FL MSA",2021,11,339408,324556,14852,4.4
MT1233100000000,12,33100,"Miami-Fort Lauderdale-West Palm Beach, FL MSA",2021,11,3113141,2997395,115746,3.7
MT1234940000000,12,34940,"Naples-Marco Island, FL MSA",2021,11,170259,164489,5770,3.4
MT1235840000000,12,35840,"North Port-Bradenton-Sarasota, FL MSA",2021,11,366923,354042,12881,3.5
MT1236100000000,12,36100,"Ocala, FL MSA",2021,11,148586,142267,6319,4.3
MT1236740000000,12,36740,"Orlando-Kissimmee-Sanford, FL MSA",2021,11,1409142,1353643,55499,3.9
MT1237340000000,12,37340,"Palm Bay-Melbourne-Titusville, FL MSA",2021,11,289852,279626,10226,3.5
MT1237460000000,12,37460,"Panama City-Panama City Beach, FL MSA",2021,11,95625,92328,3297,3.4
MT1237860000000,12,37860,"Pensacola-Ferry Pass-Brent, FL MSA",2021,11,231551,223089,8462,3.7
MT1238940000000,12,38940,"Port St. Lucie, FL MSA",2021,11,224805,215938,8867,3.9
MT1239460000000,12,39460,"Punta Gorda, FL MSA",2021,11,70542,67603,2939,4.2
MT1242680000000,12,42680,"Sebastian-Vero Beach-West Vero Corridor, FL MSA",2021,11,64048,61279,2769,4.3
MT1242700000000,12,42700,"Sebring, FL MSA",2021,11,34759,32991,1768,5.1
MT1245220000000,12,45220,"Tallahassee, FL MSA",2021,11,196748,189403,7345,3.7
MT1245300000000,12,45300,"Tampa-St. Petersburg-Clearwater, FL MSA",2021,11,1606693,1549015,57678,3.6
MT1248680000000,12,48680,"Wildwood-The Villages, FL MSA",2021,11,30450,28712,1738,5.7
MT1310500000000,13,10500,"Albany, GA MSA",2021,11,62671,60082,2589,4.1
MT1312020000000,13,12020,"Athens-Clarke County, GA MSA",2021,11,102440,99418,3022,3
MT1312060000000,13,12060,"Atlanta-Sandy Springs-Roswell, GA MSA",2021,11,3159924,3059940,99984,3.2
MT1312260000000,13,12260,"Augusta-Richmond County, GA-SC MSA",2021,11,263458,254307,9151,3.5
MT1315260000000,13,15260,"Brunswick-St. Simons, GA MSA",2021,11,51902,50292,1610,3.1
MT1317980000000,13,17980,"Columbus, GA-AL MSA",2021,11,130451,125709,4742,3.6
MT1319140000000,13,19140,"Dalton, GA MSA",2021,11,66054,64116,1938,2.9
MT1323580000000,13,23580,"Gainesville, GA MSA",2021,11,101007,98419,2588,2.6
MT1325980000000,13,25980,"Hinesville, GA MSA",2021,11,30613,29473,1140,3.7
MT1331420000000,13,31420,"Macon-Bibb County, GA MSA",2021,11,98556,94902,3654,3.7
MT1340660000000,13,40660,"Rome, GA MSA",2021,11,43693,42273,1420,3.2
MT1342340000000,13,42340,"Savannah, GA MSA",2021,11,202650,196231,6419,3.2
MT1346660000000,13,46660,"Valdosta, GA MSA",2021,11,61310,59198,2112,3.4
MT1347580000000,13,47580,"Warner Robins, GA MSA",2021,11,88436,85633,2803,3.2
MT1527980000000,15,27980,"Kahului-Wailuku, HI MSA",2021,11,82695,79589,3106,3.8
MT1546520000000,15,46520,"Urban Honolulu, HI MSA",2021,11,458637,444444,14193,3.1
MT1614260000000,16,14260,"Boise City, ID MSA",2021,11,415318,403957,11361,2.7
MT1617660000000,16,17660,"Coeur d'Alene, ID MSA",2021,11,85762,82739,3023,3.5
MT1626820000000,16,26820,"Idaho Falls, ID MSA",2021,11,78692,76784,1908,2.4
MT1630300000000,16,30300,"Lewiston, ID-WA MSA",2021,11,30301,29372,929,3.1
MT1638540000000,16,38540,"Pocatello, ID MSA",2021,11,38696,37452,1244,3.2
MT1646300000000,16,46300,"Twin Falls, ID MSA",2021,11,58131,56521,1610,2.8
MT1714010000000,17,14010,"Bloomington, IL MSA",2021,11,89688,86274,3414,3.8
MT1716580000000,17,16580,"Champaign-Urbana, IL MSA",2021,11,122544,117384,5160,4.2
MT1716980000000,17,16980,"Chicago-Naperville-Elgin, IL-IN MSA",2021,11,4806114,4573599,232515,4.8
MT1719340000000,17,19340,"Davenport-Moline-Rock Island, IA-IL MSA",2021,11,189016,181322,7694,4.1
MT1719500000000,17,19500,"Decatur, IL MSA",2021,11,45550,42518,3032,6.7
MT1728100000000,17,28100,"Kankakee, IL MSA",2021,11,50371,47375,2996,5.9
MT1737900000000,17,37900,"Peoria, IL MSA",2021,11,172872,164235,8637,5
MT1740420000000,17,40420,"Rockford, IL MSA",2021,11,161077,149241,11836,7.3
MT1744100000000,17,44100,"Springfield, IL MSA",2021,11,101641,96785,4856,4.8
MT1814020000000,18,14020,"Bloomington, IN MSA",2021,11,81603,79556,2047,2.5
MT1818020000000,18,18020,"Columbus, IN MSA",2021,11,38225,37185,1040,2.7
MT1821140000000,18,21140,"Elkhart-Goshen, IN MSA",2021,11,105936,103431,2505,2.4
MT1821780000000,18,21780,"Evansville, IN MSA",2021,11,133205,129199,4006,3
MT1823060000000,18,23060,"Fort Wayne, IN MSA",2021,11,222658,216253,6405,2.9
MT1826900000000,18,26900,"Indianapolis-Carmel-Greenwood, IN MSA",2021,11,1082513,1050528,31985,3
MT1829020000000,18,29020,"Kokomo, IN MSA",2021,11,35943,34382,1561,4.3
MT1829200000000,18,29200,"Lafayette-West Lafayette, IN MSA",2021,11,114272,110989,3283,2.9
MT1833140000000,18,33140,"Michigan City-La Porte, IN MSA",2021,11,50230,48361,1869,3.7
MT1834620000000,18,34620,"Muncie, IN MSA",2021,11,51041,49192,1849,3.6
MT1843780000000,18,43780,"South Bend-Mishawaka, IN-MI MSA",2021,11,152199,146741,5458,3.6
MT1845460000000,18,45460,"Terre Haute, IN MSA",2021,11,75930,73331,2599,3.4
MT1911180000000,19,11180,"Ames, IA MSA",2021,11,67830,66129,1701,2.5
MT1916300000000,19,16300,"Cedar Rapids, IA MSA",2021,11,147787,142991,4796,3.2
MT1919780000000,19,19780,"Des Moines-West Des Moines, IA MSA",2021,11,391654,380460,11194,2.9
MT1920220000000,19,20220,"Dubuque, IA MSA",2021,11,53247,51479,1768,3.3
MT1926980000000,19,26980,"Iowa City, IA MSA",2021,11,97339,94824,2515,2.6
MT1943580000000,19,43580,"Sioux City, IA-NE-SD MSA",2021,11,75490,73268,2222,2.9
MT1947940000000,19,47940,"Waterloo-Cedar Falls, IA MSA",2021,11,88646,85923,2723,3.1
MT2029940000000,20,29940,"Lawrence, KS MSA",2021,11,68171,66480,1691,2.5
MT2031740000000,20,31740,"Manhattan, KS MSA",2021,11,62489,60908,1581,2.5
MT2045820000000,20,45820,"Topeka, KS MSA",2021,11,115677,112455,3222,2.8
MT2048620000000,20,48620,"Wichita, KS MSA",2021,11,323540,312825,10715,3.3
MT2114540000000,21,14540,"Bowling Green, KY MSA",2021,11,87862,84656,3206,3.6
MT2121060000000,21,21060,"Elizabethtown, KY MSA",2021,11,53414,51111,2303,4.3
MT2130460000000,21,30460,"Lexington-Fayette, KY MSA",2021,11,266124,257117,9007,3.4
MT2131140000000,21,31140,"Louisville/Jefferson County, KY-IN MSA",2021,11,684159,657342,26817,3.9
MT2136980000000,21,36980,"Owensboro, KY MSA",2021,11,51474,49588,1886,3.7
MT2137140000000,21,37140,"Paducah, KY-IL MSA",2021,11,45146,43114,2032,4.5
MT2210780000000,22,10780,"Alexandria, LA MSA",2021,11,64837,62710,2127,3.3
MT2212940000000,22,12940,"Baton Rouge, LA MSA",2021,11,419920,403666,16254,3.9
MT2225220000000,22,25220,"Hammond, LA MSA",2021,11,58479,55671,2808,4.8
MT2226380000000,22,26380,"Houma-Bayou Cane-Thibodaux, LA MSA",2021,11,84476,80742,3734,4.4
MT2229180000000,22,29180,"Lafayette, LA MSA",2021,11,193923,187253,6670,3.4
MT2229340000000,22,29340,"Lake Charles, LA MSA",2021,11,102297,98049,4248,4.2
MT2233740000000,22,33740,"Monroe, LA MSA",2021,11,96094,92047,4047,4.2
MT2235380000000,22,35380,"New Orleans-Metairie, LA MSA",2021,11,462990,440449,22541,4.9
MT2243340000000,22,43340,"Shreveport-Bossier City, LA MSA",2021,11,166878,160120,6758,4
MT2243640000000,22,43640,"Slidell-Mandeville-Covington, LA MSA",2021,11,123723,119986,3737,3
MT2312620000000,23,12620,"Bangor, ME MSA",2021,11,73754,70470,3284,4.5
MT2330340000000,23,30340,"Lewiston-Auburn, ME MSA",2021,11,55159,52723,2436,4.4
MT2338860000000,23,38860,"Portland-South Portland, ME MSA",2021,11,303141,292613,10528,3.5
MT2412580000000,24,12580,"Baltimore-Columbia-Towson, MD MSA",2021,11,1452511,1396584,55927,3.9
MT2425180000000,24,25180,"Hagerstown-Martinsburg, MD-WV MSA",2021,11,140546,135806,4740,3.4
MT2430500000000,24,30500,"Lexington Park, MD MSA",2021,11,105823,102247,3576,3.4
MT2441540000000,24,41540,"Salisbury, MD MSA",2021,11,60372,57830,2542,4.2
MT2511200000000,25,11200,"Amherst Town-Northampton, MA MSA",2021,11,83703,80516,3187,3.8
MT2512700000000,25,12700,"Barnstable Town, MA MSA",2021,11,112389,106604,5785,5.1
MT2514460000000,25,14460,"Boston-Cambridge-Newton, MA-NH MSA",2021,11,2716810,2616559,100251,3.7
MT2538340000000,25,38340,"Pittsfield, MA MSA",2021,11,63467,60440,3027,4.8
MT2544140000000,25,44140,"Springfield, MA MSA",2021,11,223779,211631,12148,5.4
MT2549340000000,25,49340,"Worcester, MA MSA",2021,11,450355,431093,19262,4.3
MT2611460000000,26,11460,"Ann Arbor, MI MSA",2021,11,194596,187898,6698,3.4
MT2612980000000,26,12980,"Battle Creek, MI MSA",2021,11,58556,55449,3107,5.3
MT2613020000000,26,13020,"Bay City, MI MSA",2021,11,47615,45122,2493,5.2
MT2619820000000,26,19820,"Detroit-Warren-Dearborn, MI MSA",2021,11,2115959,2011489,104470,4.9
MT2622420000000,26,22420,"Flint, MI MSA",2021,11,177857,167227,10630,6
MT2624340000000,26,24340,"Grand Rapids-Wyoming-Kentwood, MI MSA",2021,11,589231,567365,21866,3.7
MT2627100000000,26,27100,"Jackson, MI MSA",2021,11,71718,68246,3472,4.8
MT2628020000000,26,28020,"Kalamazoo-Portage, MI MSA",2021,11,131235,126079,5156,3.9
MT2629620000000,26,29620,"Lansing-East Lansing, MI MSA",2021,11,231756,221425,10331,4.5
MT2633220000000,26,33220,"Midland, MI MSA",2021,11,39047,37446,1601,4.1
MT2633780000000,26,33780,"Monroe, MI MSA",2021,11,72329,68747,3582,5
MT2634740000000,26,34740,"Muskegon-Norton Shores, MI MSA",2021,11,80309,75991,4318,5.4
MT2635660000000,26,35660,"Niles, MI MSA",2021,11,71768,68415,3353,4.7
MT2640980000000,26,40980,"Saginaw, MI MSA",2021,11,82208,77429,4779,5.8
MT2645900000000,26,45900,"Traverse City, MI MSA",2021,11,76262,72961,3301,4.3
MT2720260000000,27,20260,"Duluth, MN-WI MSA",2021,11,138265,133245,5020,3.6
MT2731860000000,27,31860,"Mankato, MN MSA",2021,11,58055,56532,1523,2.6
MT2733460000000,27,33460,"Minneapolis-St. Paul-Bloomington, MN-WI MSA",2021,11,2021296,1963290,58006,2.9
MT2740340000000,27,40340,"Rochester, MN MSA",2021,11,123851,120636,3215,2.6
MT2741060000000,27,41060,"St. Cloud, MN MSA",2021,11,107372,103836,3536,3.3
MT2825060000000,28,25060,"Gulfport-Biloxi, MS MSA",2021,11,185509,177950,7559,4.1
MT2825620000000,28,25620,"Hattiesburg, MS MSA",2021,11,70127,67401,2726,3.9
MT2827140000000,28,27140,"Jackson, MS MSA",2021,11,276473,265570,10903,3.9
MT2916020000000,29,16020,"Cape Girardeau, MO-IL MSA",2021,11,47372,45953,1419,3
MT2917860000000,29,17860,"Columbia, MO MSA",2021,11,111582,108805,2777,2.5
MT2927620000000,29,27620,"Jefferson City, MO MSA",2021,11,72837,70921,1916,2.6
MT2927900000000,29,27900,"Joplin, MO-KS MSA",2021,11,94391,91721,2670,2.8
MT2928140000000,29,28140,"Kansas City, MO-KS MSA",2021,11,1152275,1114958,37317,3.2
MT2941140000000,29,41140,"St. Joseph, MO-KS MSA",2021,11,55446,53714,1732,3.1
MT2941180000000,29,41180,"St. Louis, MO-IL MSA",2021,11,1447469,1395868,51601,3.6
MT2944180000000,29,44180,"Springfield, MO MSA",2021,11,232561,226300,6261,2.7
MT3013740000000,30,13740,"Billings, MT MSA",2021,11,96529,94076,2453,2.5
MT3014580000000,30,14580,"Bozeman, MT MSA",2021,11,72394,70926,1468,2
MT3024500000000,30,24500,"Great Falls, MT MSA",2021,11,38890,37879,1011,2.6
MT3025740000000,30,25740,"Helena, MT MSA",2021,11,45403,44223,1180,2.6
MT3033540000000,30,33540,"Missoula, MT MSA",2021,11,70986,69116,1870,2.6
MT3124260000000,31,24260,"Grand Island, NE MSA",2021,11,40994,40071,923,2.3
MT3130700000000,31,30700,"Lincoln, NE MSA",2021,11,187794,184078,3716,2
MT3136540000000,31,36540,"Omaha, NE-IA MSA",2021,11,513750,501354,12396,2.4
MT3216180000000,32,16180,"Carson City, NV MSA",2021,11,27309,26318,991,3.6
MT3229820000000,32,29820,"Las Vegas-Henderson-North Las Vegas, NV MSA",2021,11,1100624,1035463,65161,5.9
MT3239900000000,32,39900,"Reno, NV MSA",2021,11,276941,267058,9883,3.6
MT3331700000000,33,31700,"Manchester-Nashua, NH MSA",2021,11,236089,229662,6427,2.7
MT3412100000000,34,12100,"Atlantic City-Hammonton, NJ MSA",2021,11,176700,162926,13774,7.8
MT3445940000000,34,45940,"Trenton-Princeton, NJ MSA",2021,11,192346,182185,10161,5.3
MT3447220000000,34,47220,"Vineland, NJ MSA",2021,11,64064,59118,4946,7.7
MT3510740000000,35,10740,"Albuquerque, NM MSA",2021,11,446861,423407,23454,5.2
MT3522140000000,35,22140,"Farmington, NM MSA",2021,11,48357,45024,3333,6.9
MT3529740000000,35,29740,"Las Cruces, NM MSA",2021,11,97629,91753,5876,6
MT3542140000000,35,42140,"Santa Fe, NM MSA",2021,11,72786,68990,3796,5.2
MT3610580000000,36,10580,"Albany-Schenectady-Troy, NY MSA",2021,11,450364,435304,15060,3.3
MT3613780000000,36,13780,"Binghamton, NY MSA",2021,11,106110,101976,4134,3.9
MT3615380000000,36,15380,"Buffalo-Cheektowaga, NY MSA",2021,11,552227,530262,21965,4
MT3621300000000,36,21300,"Elmira, NY MSA",2021,11,36018,34628,1390,3.9
MT3624020000000,36,24020,"Glens Falls, NY MSA",2021,11,59445,57270,2175,3.7
MT3627060000000,36,27060,"Ithaca, NY MSA",2021,11,48858,47334,1524,3.1
MT3628740000000,36,28740,"Kingston, NY MSA",2021,11,85389,82261,3128,3.7
MT3628880000000,36,28880,"Kiryas Joel-Poughkeepsie-Newburgh, NY MSA",2021,11,328399,316581,11818,3.6
MT3635620000000,36,35620,"New York-Newark-Jersey City, NY-NJ MSA",2021,11,9783823,9181296,602527,6.2
MT3640380000000,36,40380,"Rochester, NY MSA",2021,11,509617,490735,18882,3.7
MT3645060000000,36,45060,"Syracuse, NY MSA",2021,11,307935,296426,11509,3.7
MT3646540000000,36,46540,"Utica-Rome, NY MSA",2021,11,127940,122895,5045,3.9
MT3648060000000,36,48060,"Watertown-Fort Drum, NY MSA",2021,11,44773,42947,1826,4.1
MT3711700000000,37,11700,"Asheville, NC MSA",2021,11,204167,197292,6875,3.4
MT3715500000000,37,15500,"Burlington, NC MSA",2021,11,82247,78883,3364,4.1
MT3716740000000,37,16740,"Charlotte-Concord-Gastonia, NC-SC MSA",2021,11,1404814,1350675,54139,3.9
MT3720500000000,37,20500,"Durham-Chapel Hill, NC MSA",2021,11,308005,297468,10537,3.4
MT3722180000000,37,22180,"Fayetteville, NC MSA",2021,11,153130,144929,8201,5.4
MT3724140000000,37,24140,"Goldsboro, NC MSA",2021,11,49401,47268,2133,4.3
MT3724660000000,37,24660,"Greensboro-High Point, NC MSA",2021,11,370230,353793,16437,4.4
MT3724780000000,37,24780,"Greenville, NC MSA",2021,11,80830,77066,3764,4.7
MT3725860000000,37,25860,"Hickory-Lenoir-Morganton, NC MSA",2021,11,169361,162922,6439,3.8
MT3727340000000,37,27340,"Jacksonville, NC MSA",2021,11,70920,68145,2775,3.9
MT3738240000000,37,38240,"Pinehurst-Southern Pines, NC MSA",2021,11,42039,40417,1622,3.9
MT3739580000000,37,39580,"Raleigh-Cary, NC MSA",2021,11,781808,755977,25831,3.3
MT3740580000000,37,40580,"Rocky Mount, NC MSA",2021,11,64813,60990,3823,5.9
MT3748900000000,37,48900,"Wilmington, NC MSA",2021,11,208166,200061,8105,3.9
MT3749180000000,37,49180,"Winston-Salem, NC MSA",2021,11,319095,306241,12854,4
MT3813900000000,38,13900,"Bismarck, ND MSA",2021,11,72632,71100,1532,2.1
MT3822020000000,38,22020,"Fargo, ND-MN MSA",2021,11,147862,144929,2933,2
MT3824220000000,38,24220,"Grand Forks, ND-MN MSA",2021,11,54200,52868,1332,2.5
MT3833500000000,38,33500,"Minot, ND MSA",2021,11,39525,38557,968,2.4
MT3910420000000,39,10420,"Akron, OH MSA",2021,11,350037,335771,14266,4.1
MT3915940000000,39,15940,"Canton-Massillon, OH MSA",2021,11,189893,181902,7991,4.2
MT3917140000000,39,17140,"Cincinnati, OH-KY-IN MSA",2021,11,1136756,1095683,41073,3.6
MT3917410000000,39,17410,"Cleveland, OH MSA",2021,11,1064640,1011493,53147,5
MT3918140000000,39,18140,"Columbus, OH MSA",2021,11,1114326,1075164,39162,3.5
MT3919430000000,39,19430,"Dayton-Kettering-Beavercreek, OH MSA",2021,11,379995,364735,15260,4
MT3930620000000,39,30620,"Lima, OH MSA",2021,11,47280,45285,1995,4.2
MT3931900000000,39,31900,"Mansfield, OH MSA",2021,11,52487,50105,2382,4.5
MT3941780000000,39,41780,"Sandusky, OH MSA",2021,11,56456,53401,3055,5.4
MT3944220000000,39,44220,"Springfield, OH MSA",2021,11,60856,58492,2364,3.9
MT3945780000000,39,45780,"Toledo, OH MSA",2021,11,288159,275339,12820,4.4
MT3948260000000,39,48260,"Weirton-Steubenville, WV-OH MSA",2021,11,52804,50142,2662,5
MT3949660000000,39,49660,"Youngstown-Warren, OH MSA",2021,11,188073,178943,9130,4.9
MT4021420000000,40,21420,"Enid, OK MSA",2021,11,28295,27572,723,2.6
MT4030020000000,40,30020,"Lawton, OK MSA",2021,11,50533,49035,1498,3
MT4036420000000,40,36420,"Oklahoma City, OK MSA",2021,11,715664,696647,19017,2.7
MT4046140000000,40,46140,"Tulsa, OK MSA",2021,11,489046,474851,14195,2.9
MT4110540000000,41,10540,"Albany, OR MSA",2021,11,60785,58097,2688,4.4
MT4113460000000,41,13460,"Bend, OR MSA",2021,11,125865,120727,5138,4.1
MT4118700000000,41,18700,"Corvallis, OR MSA",2021,11,47751,46194,1557,3.3
MT4121660000000,41,21660,"Eugene-Springfield, OR MSA",2021,11,185619,177763,7856,4.2
MT4124420000000,41,24420,"Grants Pass, OR MSA",2021,11,35238,33378,1860,5.3
MT4132780000000,41,32780,"Medford, OR MSA",2021,11,104645,99911,4734,4.5
MT4138900000000,41,38900,"Portland-Vancouver-Hillsboro, OR-WA MSA",2021,11,1359785,1307940,51845,3.8
MT4141420000000,41,41420,"Salem, OR MSA",2021,11,211545,203086,8459,4
MT4210900000000,42,10900,"Allentown-Bethlehem-Easton, PA-NJ MSA",2021,11,439397,417834,21563,4.9
MT4211020000000,42,11020,"Altoona, PA MSA",2021,11,57020,54317,2703,4.7
MT4216540000000,42,16540,"Chambersburg, PA MSA",2021,11,76138,73201,2937,3.9
MT4221500000000,42,21500,"Erie, PA MSA",2021,11,124910,118328,6582,5.3
MT4223900000000,42,23900,"Gettysburg, PA MSA",2021,11,51639,49771,1868,3.6
MT4225420000000,42,25420,"Harrisburg-Carlisle, PA MSA",2021,11,302069,289816,12253,4.1
MT4227780000000,42,27780,"Johnstown, PA MSA",2021,11,56723,53663,3060,5.4
MT4229540000000,42,29540,"Lancaster, PA MSA",2021,11,285828,275115,10713,3.7
MT4230140000000,42,30140,"Lebanon, PA MSA",2021,11,70626,67681,2945,4.2
MT4237980000000,42,37980,"Philadelphia-Camden-Wilmington, PA-NJ-DE-MD MSA",2021,11,3175911,3022777,153134,4.8
MT4238300000000,42,38300,"Pittsburgh, PA MSA",2021,11,1216583,1159204,57379,4.7
MT4239740000000,42,39740,"Reading, PA MSA",2021,11,212745,202630,10115,4.8
MT4242540000000,42,42540,"Scranton--Wilkes-Barre, PA MSA",2021,11,274056,258448,15608,5.7
MT4244300000000,42,44300,"State College, PA MSA",2021,11,74260,71579,2681,3.6
MT4248700000000,42,48700,"Williamsport, PA MSA",2021,11,51682,48935,2747,5.3
MT4249620000000,42,49620,"York-Hanover, PA MSA",2021,11,233128,223616,9512,4.1
MT4439300000000,44,39300,"Providence-Warwick, RI-MA MSA",2021,11,868390,831153,37237,4.3
MT4516700000000,45,16700,"Charleston-North Charleston, SC MSA",2021,11,401408,389499,11909,3
MT4517900000000,45,17900,"Columbia, SC MSA",2021,11,395722,383154,12568,3.2
MT4522500000000,45,22500,"Florence, SC MSA",2021,11,88919,85595,3324,3.7
MT4524860000000,45,24860,"Greenville-Anderson-Greer, SC MSA",2021,11,449046,435823,13223,2.9
MT4525940000000,45,25940,"Hilton Head Island-Bluffton-Port Royal, SC MSA",2021,11,91915,89202,2713,3
MT4534820000000,45,34820,"Myrtle Beach-Conway-North Myrtle Beach, SC MSA",2021,11,156098,149763,6335,4.1
MT4543900000000,45,43900,"Spartanburg, SC MSA",2021,11,166527,160689,5838,3.5
MT4544940000000,45,44940,"Sumter, SC MSA",2021,11,41882,40259,1623,3.9
MT4639660000000,46,39660,"Rapid City, SD MSA",2021,11,77040,75408,1632,2.1
MT4643620000000,46,43620,"Sioux Falls, SD-MN MSA",2021,11,166205,163041,3164,1.9
MT4716860000000,47,16860,"Chattanooga, TN-GA MSA",2021,11,271677,262698,8979,3.3
MT4717300000000,47,17300,"Clarksville, TN-KY MSA",2021,11,133465,128328,5137,3.8
MT4717420000000,47,17420,"Cleveland, TN MSA",2021,11,56922,54880,2042,3.6
MT4727180000000,47,27180,"Jackson, TN MSA",2021,11,78741,75784,2957,3.8
MT4727740000000,47,27740,"Johnson City, TN MSA",2021,11,96234,93183,3051,3.2
MT4728700000000,47,28700,"Kingsport-Bristol, TN-VA MSA",2021,11,129199,124827,4372,3.4
MT4728940000000,47,28940,"Knoxville, TN MSA",2021,11,436271,423304,12967,3
MT4732820000000,47,32820,"Memphis, TN-MS-AR MSA",2021,11,639836,610042,29794,4.7
MT4734100000000,47,34100,"Morristown, TN MSA",2021,11,52481,50591,1890,3.6
MT4734980000000,47,34980,"Nashville-Davidson--Murfreesboro--Franklin, TN MSA",2021,11,1110293,1077593,32700,2.9
MT4810180000000,48,10180,"Abilene, TX MSA",2021,11,81607,78398,3209,3.9
MT4811100000000,48,11100,"Amarillo, TX MSA",2021,11,132163,127520,4643,3.5
MT4812420000000,48,12420,"Austin-Round Rock-San Marcos, TX MSA",2021,11,1348396,1302385,46011,3.4
MT4813140000000,48,13140,"Beaumont-Port Arthur, TX MSA",2021,11,169488,157532,11956,7.1
MT4815180000000,48,15180,"Brownsville-Harlingen, TX MSA",2021,11,180107,168525,11582,6.4
MT4817780000000,48,17780,"College Station-Bryan, TX MSA",2021,11,137984,132712,5272,3.8
MT4818580000000,48,18580,"Corpus Christi, TX MSA",2021,11,200965,189164,11801,5.9
MT4819100000000,48,19100,"Dallas-Fort Worth-Arlington, TX MSA",2021,11,4145325,3974228,171097,4.1
MT4820580000000,48,20580,"Eagle Pass, TX MSA",2021,11,23425,21144,2281,9.7
MT4821340000000,48,21340,"El Paso, TX MSA",2021,11,386749,368001,18748,4.8
MT4826420000000,48,26420,"Houston-Pasadena-The Woodlands, TX MSA",2021,11,3546647,3369159,177488,5
MT4828660000000,48,28660,"Killeen-Temple, TX MSA",2021,11,193860,184565,9295,4.8
MT4829700000000,48,29700,"Laredo, TX MSA",2021,11,111592,105792,5800,5.2
MT4830980000000,48,30980,"Longview, TX MSA",2021,11,125479,118995,6484,5.2
MT4831180000000,48,31180,"Lubbock, TX MSA",2021,11,176125,169056,7069,4
MT4832580000000,48,32580,"McAllen-Edinburg-Mission, TX MSA",2021,11,375321,347623,27698,7.4
MT4833260000000,48,33260,"Midland, TX MSA",2021,11,90345,86238,4107,4.5
MT4836220000000,48,36220,"Odessa, TX MSA",2021,11,78156,73693,4463,5.7
MT4841660000000,48,41660,"San Angelo, TX MSA",2021,11,58543,56264,2279,3.9
MT4841700000000,48,41700,"San Antonio-New Braunfels, TX MSA",2021,11,1240128,1187401,52727,4.3
MT4843300000000,48,43300,"Sherman-Denison, TX MSA",2021,11,66018,63300,2718,4.1
MT4845500000000,48,45500,"Texarkana, TX-AR MSA",2021,11,60360,57431,2929,4.9
MT4846340000000,48,46340,"Tyler, TX MSA",2021,11,110404,105716,4688,4.2
MT4847020000000,48,47020,"Victoria, TX MSA",2021,11,44519,42229,2290,5.1
MT4847380000000,48,47380,"Waco, TX MSA",2021,11,139603,133694,5909,4.2
MT4848660000000,48,48660,"Wichita Falls, TX MSA",2021,11,65461,62675,2786,4.3
MT4930860000000,49,30860,"Logan, UT-ID MSA",2021,11,77444,75959,1485,1.9
MT4936260000000,49,36260,"Ogden, UT MSA",2021,11,328400,321422,6978,2.1
MT4939340000000,49,39340,"Provo-Orem-Lehi, UT MSA",2021,11,344855,337782,7073,2.1
MT4941100000000,49,41100,"St. George, UT MSA",2021,11,83962,81836,2126,2.5
MT4941620000000,49,41620,"Salt Lake City-Murray, UT MSA",2021,11,690878,674860,16018,2.3
MT5015540000000,50,15540,"Burlington-South Burlington, VT MSA",2021,11,124976,121908,3068,2.5
MT5113980000000,51,13980,"Blacksburg-Christiansburg-Radford, VA MSA",2021,11,88270,85918,2352,2.7
MT5116820000000,51,16820,"Charlottesville, VA MSA",2021,11,112550,109513,3037,2.7
MT5125500000000,51,25500,"Harrisonburg, VA MSA",2021,11,69841,67964,1877,2.7
MT5131340000000,51,31340,"Lynchburg, VA MSA",2021,11,125203,121320,3883,3.1
MT5140060000000,51,40060,"Richmond, VA MSA",2021,11,685122,662481,22641,3.3
MT5140220000000,51,40220,"Roanoke, VA MSA",2021,11,150972,146305,4667,3.1
MT5144420000000,51,44420,"Staunton-Stuarts Draft, VA MSA",2021,11,62186,60534,1652,2.7
MT5147260000000,51,47260,"Virginia Beach-Chesapeake-Norfolk, VA-NC MSA",2021,11,845254,815940,29314,3.5
MT5149020000000,51,49020,"Winchester, VA-WV MSA",2021,11,72913,70759,2154,3
MT5313380000000,53,13380,"Bellingham, WA MSA",2021,11,114217,109198,5019,4.4
MT5314740000000,53,14740,"Bremerton-Silverdale-Port Orchard, WA MSA",2021,11,122487,117414,5073,4.1
MT5328420000000,53,28420,"Kennewick-Richland, WA MSA",2021,11,145006,137949,7057,4.9
MT5331020000000,53,31020,"Longview-Kelso, WA MSA",2021,11,47743,45347,2396,5
MT5334580000000,53,34580,"Mount Vernon-Anacortes, WA MSA",2021,11,58859,55920,2939,5
MT5336500000000,53,36500,"Olympia-Lacey-Tumwater, WA MSA",2021,11,139551,133549,6002,4.3
MT5342660000000,53,42660,"Seattle-Tacoma-Bellevue, WA MSA",2021,11,2182596,2098366,84230,3.9
MT5344060000000,53,44060,"Spokane-Spokane Valley, WA MSA",2021,11,282900,270802,12098,4.3
MT5347460000000,53,47460,"Walla Walla, WA MSA",2021,11,30031,28839,1192,4
MT5348300000000,53,48300,"Wenatchee-East Wenatchee, WA MSA",2021,11,62360,59481,2879,4.6
MT5349420000000,53,49420,"Yakima, WA MSA",2021,11,127848,120486,7362,5.8
MT5413220000000,54,13220,"Beckley, WV MSA",2021,11,44984,43088,1896,4.2
MT5416620000000,54,16620,"Charleston, WV MSA",2021,11,89394,85691,3703,4.1
MT5426580000000,54,26580,"Huntington-Ashland, WV-KY-OH MSA",2021,11,154595,147622,6973,4.5
MT5434060000000,54,34060,"Morgantown, WV MSA",2021,11,70805,68126,2679,3.8
MT5437620000000,54,37620,"Parkersburg-Vienna, WV MSA",2021,11,38671,37007,1664,4.3
MT5448540000000,54,48540,"Wheeling, WV-OH MSA",2021,11,59441,56570,2871,4.8
MT5511540000000,55,11540,"Appleton, WI MSA",2021,11,134418,131076,3342,2.5
MT5520740000000,55,20740,"Eau Claire, WI MSA",2021,11,92705,90041,2664,2.9
MT5522540000000,55,22540,"Fond du Lac, WI MSA",2021,11,56307,54812,1495,2.7
MT5524580000000,55,24580,"Green Bay, WI MSA",2021,11,174975,170110,4865,2.8
MT5527500000000,55,27500,"Janesville-Beloit, WI MSA",2021,11,83863,80742,3121,3.7
MT5528450000000,55,28450,"Kenosha, WI MSA",2021,11,92440,89266,3174,3.4
MT5529100000000,55,29100,"La Crosse-Onalaska, WI-MN MSA",2021,11,88220,85885,2335,2.6
MT5531540000000,55,31540,"Madison, WI MSA",2021,11,393155,383998,9157,2.3
MT5533340000000,55,33340,"Milwaukee-Waukesha, WI MSA",2021,11,810368,782799,27569,3.4
MT5536780000000,55,36780,"Oshkosh-Neenah, WI MSA",2021,11,91580,89188,2392,2.6
MT5539540000000,55,39540,"Racine-Mount Pleasant, WI MSA",2021,11,99898,96221,3677,3.7
MT5543100000000,55,43100,"Sheboygan, WI MSA",2021,11,62027,60449,1578,2.5
MT5548140000000,55,48140,"Wausau, WI MSA",2021,11,74313,72451,1862,2.5
MT5616220000000,56,16220,"Casper, WY MSA",2021,11,40706,38989,1717,4.2
MT5616940000000,56,16940,"Cheyenne, WY MSA",2021,11,49036,47373,1663,3.4
MT7210380000000,72,10380,"Aguadilla, PR MSA",2021,11,84875,77853,7022,8.3
MT7211640000000,72,11640,"Arecibo, PR MSA",2021,11,64699,59875,4824,7.5
MT7225020000000,72,25020,"Guayama, PR MSA",2021,11,19553,17830,1723,8.8
MT7232420000000,72,32420,"Mayaguez, PR MSA",2021,11,66678,60767,5911,8.9
MT7238660000000,72,38660,"Ponce, PR MSA",2021,11,89779,81364,8415,9.4
MT7241980000000,72,41980,"San Juan-Bayamon-Caguas, PR MSA",2021,11,810419,759833,50586,6.2
MT0111500000000,1,11500,"Anniston-Oxford, AL MSA",2021,12,49630,48167,1463,2.9
MT0112220000000,1,12220,"Auburn-Opelika, AL MSA",2021,12,91082,88821,2261,2.5
MT0113820000000,1,13820,"Birmingham, AL MSA",2021,12,556044,542334,13710,2.5
MT0119300000000,1,19300,"Daphne-Fairhope-Foley, AL MSA",2021,12,109951,107700,2251,2
MT0119460000000,1,19460,"Decatur, AL MSA",2021,12,72015,70462,1553,2.2
MT0120020000000,1,20020,"Dothan, AL MSA",2021,12,66045,64413,1632,2.5
MT0122520000000,1,22520,"Florence-Muscle Shoals, AL MSA",2021,12,67010,65211,1799,2.7
MT0123460000000,1,23460,"Gadsden, AL MSA",2021,12,41156,39946,1210,2.9
MT0126620000000,1,26620,"Huntsville, AL MSA",2021,12,252324,247151,5173,2.1
MT0133660000000,1,33660,"Mobile, AL MSA",2021,12,183194,176802,6392,3.5
MT0133860000000,1,33860,"Montgomery, AL MSA",2021,12,172753,167571,5182,3
MT0146220000000,1,46220,"Tuscaloosa, AL MSA",2021,12,119763,116264,3499,2.9
MT0211260000000,2,11260,"Anchorage, AK MSA",2021,12,199014,189123,9891,5
MT0221820000000,2,21820,"Fairbanks-College, AK MSA",2021,12,44802,42723,2079,4.6
MT0422380000000,4,22380,"Flagstaff, AZ MSA",2021,12,71468,68382,3086,4.3
MT0429420000000,4,29420,"Lake Havasu City-Kingman, AZ MSA",2021,12,84647,80971,3676,4.3
MT0438060000000,4,38060,"Phoenix-Mesa-Chandler, AZ MSA",2021,12,2541800,2461263,80537,3.2
MT0439150000000,4,39150,"Prescott Valley-Prescott, AZ MSA",2021,12,101126,97807,3319,3.3
MT0443420000000,4,43420,"Sierra Vista-Douglas, AZ MSA",2021,12,47195,45103,2092,4.4
MT0446060000000,4,46060,"Tucson, AZ MSA",2021,12,484741,467286,17455,3.6
MT0449740000000,4,49740,"Yuma, AZ MSA",2021,12,94760,83388,11372,12
MT0522220000000,5,22220,"Fayetteville-Springdale-Rogers, AR MSA",2021,12,281249,274724,6525,2.3
MT0522900000000,5,22900,"Fort Smith, AR-OK MSA",2021,12,99395,96530,2865,2.9
MT0526300000000,5,26300,"Hot Springs, AR MSA",2021,12,43481,41990,1491,3.4
MT0527860000000,5,27860,"Jonesboro, AR MSA",2021,12,63624,61926,1698,2.7
MT0530780000000,5,30780,"Little Rock-North Little Rock-Conway, AR MSA",2021,12,359709,348697,11012,3.1
MT0612540000000,6,12540,"Bakersfield-Delano, CA MSA",2021,12,392378,361390,30988,7.9
MT0617020000000,6,17020,"Chico, CA MSA",2021,12,89870,85150,4720,5.3
MT0620940000000,6,20940,"El Centro, CA MSA",2021,12,66990,56621,10369,15.5
MT0623420000000,6,23420,"Fresno, CA MSA",2021,12,507585,469928,37657,7.4
MT0625260000000,6,25260,"Hanford-Corcoran, CA MSA",2021,12,53788,49361,4427,8.2
MT0631080000000,6,31080,"Los Angeles-Long Beach-Anaheim, CA MSA",2021,12,6630546,6241175,389371,5.9
MT0632900000000,6,32900,"Merced, CA MSA",2021,12,115133,105097,10036,8.7
MT0633700000000,6,33700,"Modesto, CA MSA",2021,12,243790,228225,15565,6.4
MT0634900000000,6,34900,"Napa, CA MSA",2021,12,69866,67020,2846,4.1
MT0637100000000,6,37100,"Oxnard-Thousand Oaks-Ventura, CA MSA",2021,12,411567,393004,18563,4.5
MT0639820000000,6,39820,"Redding, CA MSA",2021,12,76043,72135,3908,5.1
MT0640140000000,6,40140,"Riverside-San Bernardino-Ontario, CA MSA",2021,12,2129880,2015321,114559,5.4
MT0640900000000,6,40900,"Sacramento-Roseville-Folsom, CA MSA",2021,12,1132990,1079935,53055,4.7
MT0641500000000,6,41500,"Salinas, CA MSA",2021,12,213368,198985,14383,6.7
MT0641740000000,6,41740,"San Diego-Chula Vista-Carlsbad, CA MSA",2021,12,1595891,1525001,70890,4.4
MT0641860000000,6,41860,"San Francisco-Oakland-Fremont, CA MSA",2021,12,2482096,2383955,98141,4
MT0641940000000,6,41940,"San Jose-Sunnyvale-Santa Clara, CA MSA",2021,12,1030599,993481,37118,3.6
MT0642020000000,6,42020,"San Luis Obispo-Paso Robles, CA MSA",2021,12,131264,126099,5165,3.9
MT0642100000000,6,42100,"Santa Cruz-Watsonville, CA MSA",2021,12,133441,126326,7115,5.3
MT0642200000000,6,42200,"Santa Maria-Santa Barbara, CA MSA",2021,12,217415,208318,9097,4.2
MT0642220000000,6,42220,"Santa Rosa-Petaluma, CA MSA",2021,12,243497,233843,9654,4
MT0644700000000,6,44700,"Stockton-Lodi, CA MSA",2021,12,353700,331767,21933,6.2
MT0646700000000,6,46700,"Vallejo, CA MSA",2021,12,209222,198144,11078,5.3
MT0647300000000,6,47300,"Visalia, CA MSA",2021,12,205108,187439,17669,8.6
MT0649700000000,6,49700,"Yuba City, CA MSA",2021,12,77493,72122,5371,6.9
MT0814500000000,8,14500,"Boulder, CO MSA",2021,12,190995,184374,6621,3.5
MT0817820000000,8,17820,"Colorado Springs, CO MSA",2021,12,380319,364150,16169,4.3
MT0819740000000,8,19740,"Denver-Aurora-Centennial, CO MSA",2021,12,1733824,1664357,69467,4
MT0822660000000,8,22660,"Fort Collins-Loveland, CO MSA",2021,12,201760,194202,7558,3.7
MT0824300000000,8,24300,"Grand Junction, CO MSA",2021,12,78500,75042,3458,4.4
MT0824540000000,8,24540,"Greeley, CO MSA",2021,12,169822,162404,7418,4.4
MT0839380000000,8,39380,"Pueblo, CO MSA",2021,12,75036,70333,4703,6.3
MT0914860000000,9,14860,"Bridgeport-Stamford-Danbury, CT MSA",2021,12,506898,483325,23573,4.7
MT0925540000000,9,25540,"Hartford-West Hartford-East Hartford, CT MSA",2021,12,613927,583048,30879,5
MT0935300000000,9,35300,"New Haven, CT MSA",2021,12,313597,297980,15617,5
MT0935980000000,9,35980,"Norwich-New London-Willimantic, CT MSA",2021,12,141763,134109,7654,5.4
MT0947930000000,9,47930,"Waterbury-Shelton, CT MSA",2021,12,242211,228963,13248,5.5
MT1020100000000,10,20100,"Dover, DE MSA",2021,12,84993,80822,4171,4.9
MT1147900000000,11,47900,"Washington-Arlington-Alexandria, DC-VA-MD-WV MSA",2021,12,3404174,3297223,106951,3.1
MT1215980000000,12,15980,"Cape Coral-Fort Myers, FL MSA",2021,12,355516,342638,12878,3.6
MT1218880000000,12,18880,"Crestview-Fort Walton Beach-Destin, FL MSA",2021,12,137149,133260,3889,2.8
MT1219660000000,12,19660,"Deltona-Daytona Beach-Ormond Beach, FL MSA",2021,12,305476,293528,11948,3.9
MT1223540000000,12,23540,"Gainesville, FL MSA",2021,12,163809,158206,5603,3.4
MT1226140000000,12,26140,"Homosassa Springs, FL MSA",2021,12,51346,48957,2389,4.7
MT1227260000000,12,27260,"Jacksonville, FL MSA",2021,12,816191,788149,28042,3.4
MT1229460000000,12,29460,"Lakeland-Winter Haven, FL MSA",2021,12,340423,326035,14388,4.2
MT1233100000000,12,33100,"Miami-Fort Lauderdale-West Palm Beach, FL MSA",2021,12,3125608,3015771,109837,3.5
MT1234940000000,12,34940,"Naples-Marco Island, FL MSA",2021,12,170494,164741,5753,3.4
MT1235840000000,12,35840,"North Port-Bradenton-Sarasota, FL MSA",2021,12,367988,355407,12581,3.4
MT1236100000000,12,36100,"Ocala, FL MSA",2021,12,149352,143261,6091,4.1
MT1236740000000,12,36740,"Orlando-Kissimmee-Sanford, FL MSA",2021,12,1418327,1365134,53193,3.8
MT1237340000000,12,37340,"Palm Bay-Melbourne-Titusville, FL MSA",2021,12,290589,280682,9907,3.4
MT1237460000000,12,37460,"Panama City-Panama City Beach, FL MSA",2021,12,95886,92689,3197,3.3
MT1237860000000,12,37860,"Pensacola-Ferry Pass-Brent, FL MSA",2021,12,232034,223867,8167,3.5
MT1238940000000,12,38940,"Port St. Lucie, FL MSA",2021,12,225520,216849,8671,3.8
MT1239460000000,12,39460,"Punta Gorda, FL MSA",2021,12,70795,67904,2891,4.1
MT1242680000000,12,42680,"Sebastian-Vero Beach-West Vero Corridor, FL MSA",2021,12,64319,61583,2736,4.3
MT1242700000000,12,42700,"Sebring, FL MSA",2021,12,34942,33225,1717,4.9
MT1245220000000,12,45220,"Tallahassee, FL MSA",2021,12,197172,190059,7113,3.6
MT1245300000000,12,45300,"Tampa-St. Petersburg-Clearwater, FL MSA",2021,12,1614797,1559283,55514,3.4
MT1248680000000,12,48680,"Wildwood-The Villages, FL MSA",2021,12,30669,28969,1700,5.5
MT1310500000000,13,10500,"Albany, GA MSA",2021,12,62698,60170,2528,4
MT1312020000000,13,12020,"Athens-Clarke County, GA MSA",2021,12,102360,99332,3028,3
MT1312060000000,13,12060,"Atlanta-Sandy Springs-Roswell, GA MSA",2021,12,3170795,3072278,98517,3.1
MT1312260000000,13,12260,"Augusta-Richmond County, GA-SC MSA",2021,12,263557,254437,9120,3.5
MT1315260000000,13,15260,"Brunswick-St. Simons, GA MSA",2021,12,52077,50486,1591,3.1
MT1317980000000,13,17980,"Columbus, GA-AL MSA",2021,12,130487,125843,4644,3.6
MT1319140000000,13,19140,"Dalton, GA MSA",2021,12,66248,64352,1896,2.9
MT1323580000000,13,23580,"Gainesville, GA MSA",2021,12,101506,98905,2601,2.6
MT1325980000000,13,25980,"Hinesville, GA MSA",2021,12,30659,29521,1138,3.7
MT1331420000000,13,31420,"Macon-Bibb County, GA MSA",2021,12,98537,94941,3596,3.6
MT1340660000000,13,40660,"Rome, GA MSA",2021,12,43795,42402,1393,3.2
MT1342340000000,13,42340,"Savannah, GA MSA",2021,12,203263,196952,6311,3.1
MT1346660000000,13,46660,"Valdosta, GA MSA",2021,12,61385,59309,2076,3.4
MT1347580000000,13,47580,"Warner Robins, GA MSA",2021,12,88536,85773,2763,3.1
MT1527980000000,15,27980,"Kahului-Wailuku, HI MSA",2021,12,82603,79726,2877,3.5
MT1546520000000,15,46520,"Urban Honolulu, HI MSA",2021,12,459311,445690,13621,3
MT1614260000000,16,14260,"Boise City, ID MSA",2021,12,416852,405884,10968,2.6
MT1617660000000,16,17660,"Coeur d'Alene, ID MSA",2021,12,85900,83003,2897,3.4
MT1626820000000,16,26820,"Idaho Falls, ID MSA",2021,12,79117,77222,1895,2.4
MT1630300000000,16,30300,"Lewiston, ID-WA MSA",2021,12,30298,29397,901,3
MT1638540000000,16,38540,"Pocatello, ID MSA",2021,12,38709,37502,1207,3.1
MT1646300000000,16,46300,"Twin Falls, ID MSA",2021,12,58301,56733,1568,2.7
MT1714010000000,17,14010,"Bloomington, IL MSA",2021,12,90065,86717,3348,3.7
MT1716580000000,17,16580,"Champaign-Urbana, IL MSA",2021,12,122884,117865,5019,4.1
MT1716980000000,17,16980,"Chicago-Naperville-Elgin, IL-IN MSA",2021,12,4826836,4602180,224656,4.7
MT1719340000000,17,19340,"Davenport-Moline-Rock Island, IA-IL MSA",2021,12,189191,181758,7433,3.9
MT1719500000000,17,19500,"Decatur, IL MSA",2021,12,45508,42569,2939,6.5
MT1728100000000,17,28100,"Kankakee, IL MSA",2021,12,50453,47545,2908,5.8
MT1737900000000,17,37900,"Peoria, IL MSA",2021,12,173116,164715,8401,4.9
MT1740420000000,17,40420,"Rockford, IL MSA",2021,12,161708,150199,11509,7.1
MT1744100000000,17,44100,"Springfield, IL MSA",2021,12,101652,96921,4731,4.7
MT1814020000000,18,14020,"Bloomington, IN MSA",2021,12,82460,80444,2016,2.4
MT1818020000000,18,18020,"Columbus, IN MSA",2021,12,38435,37440,995,2.6
MT1821140000000,18,21140,"Elkhart-Goshen, IN MSA",2021,12,106309,103866,2443,2.3
MT1821780000000,18,21780,"Evansville, IN MSA",2021,12,133609,129680,3929,2.9
MT1823060000000,18,23060,"Fort Wayne, IN MSA",2021,12,223584,217398,6186,2.8
MT1826900000000,18,26900,"Indianapolis-Carmel-Greenwood, IN MSA",2021,12,1086406,1055279,31127,2.9
MT1829020000000,18,29020,"Kokomo, IN MSA",2021,12,35990,34458,1532,4.3
MT1829200000000,18,29200,"Lafayette-West Lafayette, IN MSA",2021,12,114944,111719,3225,2.8
MT1833140000000,18,33140,"Michigan City-La Porte, IN MSA",2021,12,50300,48534,1766,3.5
MT1834620000000,18,34620,"Muncie, IN MSA",2021,12,51067,49275,1792,3.5
MT1843780000000,18,43780,"South Bend-Mishawaka, IN-MI MSA",2021,12,152509,147259,5250,3.4
MT1845460000000,18,45460,"Terre Haute, IN MSA",2021,12,76182,73669,2513,3.3
MT1911180000000,19,11180,"Ames, IA MSA",2021,12,67911,66288,1623,2.4
MT1916300000000,19,16300,"Cedar Rapids, IA MSA",2021,12,147952,143362,4590,3.1
MT1919780000000,19,19780,"Des Moines-West Des Moines, IA MSA",2021,12,392579,381782,10797,2.8
MT1920220000000,19,20220,"Dubuque, IA MSA",2021,12,53339,51669,1670,3.1
MT1926980000000,19,26980,"Iowa City, IA MSA",2021,12,97570,95149,2421,2.5
MT1943580000000,19,43580,"Sioux City, IA-NE-SD MSA",2021,12,75667,73573,2094,2.8
MT1947940000000,19,47940,"Waterloo-Cedar Falls, IA MSA",2021,12,88472,85863,2609,2.9
MT2029940000000,20,29940,"Lawrence, KS MSA",2021,12,68252,66625,1627,2.4
MT2031740000000,20,31740,"Manhattan, KS MSA",2021,12,62479,60936,1543,2.5
MT2045820000000,20,45820,"Topeka, KS MSA",2021,12,115664,112546,3118,2.7
MT2048620000000,20,48620,"Wichita, KS MSA",2021,12,323536,313372,10164,3.1
MT2114540000000,21,14540,"Bowling Green, KY MSA",2021,12,88065,84895,3170,3.6
MT2121060000000,21,21060,"Elizabethtown, KY MSA",2021,12,53492,51244,2248,4.2
MT2130460000000,21,30460,"Lexington-Fayette, KY MSA",2021,12,266720,257991,8729,3.3
MT2131140000000,21,31140,"Louisville/Jefferson County, KY-IN MSA",2021,12,686544,659982,26562,3.9
MT2136980000000,21,36980,"Owensboro, KY MSA",2021,12,51357,49541,1816,3.5
MT2137140000000,21,37140,"Paducah, KY-IL MSA",2021,12,45281,43331,1950,4.3
MT2210780000000,22,10780,"Alexandria, LA MSA",2021,12,65014,62914,2100,3.2
MT2212940000000,22,12940,"Baton Rouge, LA MSA",2021,12,420623,404904,15719,3.7
MT2225220000000,22,25220,"Hammond, LA MSA",2021,12,58725,56044,2681,4.6
MT2226380000000,22,26380,"Houma-Bayou Cane-Thibodaux, LA MSA",2021,12,84921,81316,3605,4.2
MT2229180000000,22,29180,"Lafayette, LA MSA",2021,12,194284,187860,6424,3.3
MT2229340000000,22,29340,"Lake Charles, LA MSA",2021,12,101960,97905,4055,4
MT2233740000000,22,33740,"Monroe, LA MSA",2021,12,96306,92388,3918,4.1
MT2235380000000,22,35380,"New Orleans-Metairie, LA MSA",2021,12,465682,444044,21638,4.6
MT2243340000000,22,43340,"Shreveport-Bossier City, LA MSA",2021,12,167432,160887,6545,3.9
MT2243640000000,22,43640,"Slidell-Mandeville-Covington, LA MSA",2021,12,123976,120339,3637,2.9
MT2312620000000,23,12620,"Bangor, ME MSA",2021,12,73563,70515,3048,4.1
MT2330340000000,23,30340,"Lewiston-Auburn, ME MSA",2021,12,54857,52634,2223,4.1
MT2338860000000,23,38860,"Portland-South Portland, ME MSA",2021,12,302649,292856,9793,3.2
MT2412580000000,24,12580,"Baltimore-Columbia-Towson, MD MSA",2021,12,1454968,1402396,52572,3.6
MT2425180000000,24,25180,"Hagerstown-Martinsburg, MD-WV MSA",2021,12,140757,136257,4500,3.2
MT2430500000000,24,30500,"Lexington Park, MD MSA",2021,12,105667,102275,3392,3.2
MT2441540000000,24,41540,"Salisbury, MD MSA",2021,12,60513,58134,2379,3.9
MT2511200000000,25,11200,"Amherst Town-Northampton, MA MSA",2021,12,83790,80739,3051,3.6
MT2512700000000,25,12700,"Barnstable Town, MA MSA",2021,12,112477,106954,5523,4.9
MT2514460000000,25,14460,"Boston-Cambridge-Newton, MA-NH MSA",2021,12,2722032,2626426,95606,3.5
MT2538340000000,25,38340,"Pittsfield, MA MSA",2021,12,63620,60743,2877,4.5
MT2544140000000,25,44140,"Springfield, MA MSA",2021,12,223587,211950,11637,5.2
MT2549340000000,25,49340,"Worcester, MA MSA",2021,12,451137,432750,18387,4.1
MT2611460000000,26,11460,"Ann Arbor, MI MSA",2021,12,195566,188859,6707,3.4
MT2612980000000,26,12980,"Battle Creek, MI MSA",2021,12,58688,55699,2989,5.1
MT2613020000000,26,13020,"Bay City, MI MSA",2021,12,47710,45277,2433,5.1
MT2619820000000,26,19820,"Detroit-Warren-Dearborn, MI MSA",2021,12,2119461,2020349,99112,4.7
MT2622420000000,26,22420,"Flint, MI MSA",2021,12,178305,168068,10237,5.7
MT2624340000000,26,24340,"Grand Rapids-Wyoming-Kentwood, MI MSA",2021,12,591162,570002,21160,3.6
MT2627100000000,26,27100,"Jackson, MI MSA",2021,12,72065,68679,3386,4.7
MT2628020000000,26,28020,"Kalamazoo-Portage, MI MSA",2021,12,131784,126763,5021,3.8
MT2629620000000,26,29620,"Lansing-East Lansing, MI MSA",2021,12,232427,222539,9888,4.3
MT2633220000000,26,33220,"Midland, MI MSA",2021,12,39260,37687,1573,4
MT2633780000000,26,33780,"Monroe, MI MSA",2021,12,72926,69418,3508,4.8
MT2634740000000,26,34740,"Muskegon-Norton Shores, MI MSA",2021,12,80579,76457,4122,5.1
MT2635660000000,26,35660,"Niles, MI MSA",2021,12,72156,68909,3247,4.5
MT2640980000000,26,40980,"Saginaw, MI MSA",2021,12,82477,77910,4567,5.5
MT2645900000000,26,45900,"Traverse City, MI MSA",2021,12,76444,73258,3186,4.2
MT2720260000000,27,20260,"Duluth, MN-WI MSA",2021,12,138321,133509,4812,3.5
MT2731860000000,27,31860,"Mankato, MN MSA",2021,12,58392,56961,1431,2.5
MT2733460000000,27,33460,"Minneapolis-St. Paul-Bloomington, MN-WI MSA",2021,12,2026395,1971431,54964,2.7
MT2740340000000,27,40340,"Rochester, MN MSA",2021,12,123997,120944,3053,2.5
MT2741060000000,27,41060,"St. Cloud, MN MSA",2021,12,107564,104235,3329,3.1
MT2825060000000,28,25060,"Gulfport-Biloxi, MS MSA",2021,12,185800,178521,7279,3.9
MT2825620000000,28,25620,"Hattiesburg, MS MSA",2021,12,70204,67559,2645,3.8
MT2827140000000,28,27140,"Jackson, MS MSA",2021,12,276867,266390,10477,3.8
MT2916020000000,29,16020,"Cape Girardeau, MO-IL MSA",2021,12,47465,46110,1355,2.9
MT2917860000000,29,17860,"Columbia, MO MSA",2021,12,111613,108920,2693,2.4
MT2927620000000,29,27620,"Jefferson City, MO MSA",2021,12,72972,71134,1838,2.5
MT2927900000000,29,27900,"Joplin, MO-KS MSA",2021,12,94492,91917,2575,2.7
MT2928140000000,29,28140,"Kansas City, MO-KS MSA",2021,12,1154296,1118670,35626,3.1
MT2941140000000,29,41140,"St. Joseph, MO-KS MSA",2021,12,55274,53623,1651,3
MT2941180000000,29,41180,"St. Louis, MO-IL MSA",2021,12,1448761,1399833,48928,3.4
MT2944180000000,29,44180,"Springfield, MO MSA",2021,12,232917,226951,5966,2.6
MT3013740000000,30,13740,"Billings, MT MSA",2021,12,96932,94543,2389,2.5
MT3014580000000,30,14580,"Bozeman, MT MSA",2021,12,72752,71317,1435,2
MT3024500000000,30,24500,"Great Falls, MT MSA",2021,12,39090,38116,974,2.5
MT3025740000000,30,25740,"Helena, MT MSA",2021,12,45536,44388,1148,2.5
MT3033540000000,30,33540,"Missoula, MT MSA",2021,12,71215,69397,1818,2.6
MT3124260000000,31,24260,"Grand Island, NE MSA",2021,12,41095,40221,874,2.1
MT3130700000000,31,30700,"Lincoln, NE MSA",2021,12,187847,184269,3578,1.9
MT3136540000000,31,36540,"Omaha, NE-IA MSA",2021,12,514394,502491,11903,2.3
MT3216180000000,32,16180,"Carson City, NV MSA",2021,12,27305,26348,957,3.5
MT3229820000000,32,29820,"Las Vegas-Henderson-North Las Vegas, NV MSA",2021,12,1104294,1040721,63573,5.8
MT3239900000000,32,39900,"Reno, NV MSA",2021,12,277245,267533,9712,3.5
MT3331700000000,33,31700,"Manchester-Nashua, NH MSA",2021,12,236469,230387,6082,2.6
MT3412100000000,34,12100,"Atlantic City-Hammonton, NJ MSA",2021,12,176724,163951,12773,7.2
MT3445940000000,34,45940,"Trenton-Princeton, NJ MSA",2021,12,192637,182982,9655,5
MT3447220000000,34,47220,"Vineland, NJ MSA",2021,12,63987,59319,4668,7.3
MT3510740000000,35,10740,"Albuquerque, NM MSA",2021,12,447091,424672,22419,5
MT3522140000000,35,22140,"Farmington, NM MSA",2021,12,48349,45181,3168,6.6
MT3529740000000,35,29740,"Las Cruces, NM MSA",2021,12,97598,91983,5615,5.8
MT3542140000000,35,42140,"Santa Fe, NM MSA",2021,12,72671,69036,3635,5
MT3610580000000,36,10580,"Albany-Schenectady-Troy, NY MSA",2021,12,450504,436207,14297,3.2
MT3613780000000,36,13780,"Binghamton, NY MSA",2021,12,106203,102299,3904,3.7
MT3615380000000,36,15380,"Buffalo-Cheektowaga, NY MSA",2021,12,553148,532369,20779,3.8
MT3621300000000,36,21300,"Elmira, NY MSA",2021,12,36006,34700,1306,3.6
MT3624020000000,36,24020,"Glens Falls, NY MSA",2021,12,59422,57413,2009,3.4
MT3627060000000,36,27060,"Ithaca, NY MSA",2021,12,48934,47479,1455,3
MT3628740000000,36,28740,"Kingston, NY MSA",2021,12,85485,82510,2975,3.5
MT3628880000000,36,28880,"Kiryas Joel-Poughkeepsie-Newburgh, NY MSA",2021,12,329373,318075,11298,3.4
MT3635620000000,36,35620,"New York-Newark-Jersey City, NY-NJ MSA",2021,12,9802454,9229592,572862,5.8
MT3640380000000,36,40380,"Rochester, NY MSA",2021,12,510688,492747,17941,3.5
MT3645060000000,36,45060,"Syracuse, NY MSA",2021,12,308210,297372,10838,3.5
MT3646540000000,36,46540,"Utica-Rome, NY MSA",2021,12,127698,122995,4703,3.7
MT3648060000000,36,48060,"Watertown-Fort Drum, NY MSA",2021,12,44864,43159,1705,3.8
MT3711700000000,37,11700,"Asheville, NC MSA",2021,12,205465,198860,6605,3.2
MT3715500000000,37,15500,"Burlington, NC MSA",2021,12,82624,79394,3230,3.9
MT3716740000000,37,16740,"Charlotte-Concord-Gastonia, NC-SC MSA",2021,12,1415238,1362979,52259,3.7
MT3720500000000,37,20500,"Durham-Chapel Hill, NC MSA",2021,12,309781,299575,10206,3.3
MT3722180000000,37,22180,"Fayetteville, NC MSA",2021,12,153678,145782,7896,5.1
MT3724140000000,37,24140,"Goldsboro, NC MSA",2021,12,49476,47413,2063,4.2
MT3724660000000,37,24660,"Greensboro-High Point, NC MSA",2021,12,372202,356432,15770,4.2
MT3724780000000,37,24780,"Greenville, NC MSA",2021,12,81198,77531,3667,4.5
MT3725860000000,37,25860,"Hickory-Lenoir-Morganton, NC MSA",2021,12,170292,164163,6129,3.6
MT3727340000000,37,27340,"Jacksonville, NC MSA",2021,12,71248,68543,2705,3.8
MT3738240000000,37,38240,"Pinehurst-Southern Pines, NC MSA",2021,12,42275,40703,1572,3.7
MT3739580000000,37,39580,"Raleigh-Cary, NC MSA",2021,12,788423,763300,25123,3.2
MT3740580000000,37,40580,"Rocky Mount, NC MSA",2021,12,64892,61199,3693,5.7
MT3748900000000,37,48900,"Wilmington, NC MSA",2021,12,209855,201972,7883,3.8
MT3749180000000,37,49180,"Winston-Salem, NC MSA",2021,12,320971,308632,12339,3.8
MT3813900000000,38,13900,"Bismarck, ND MSA",2021,12,72743,71273,1470,2
MT3822020000000,38,22020,"Fargo, ND-MN MSA",2021,12,148212,145408,2804,1.9
MT3824220000000,38,24220,"Grand Forks, ND-MN MSA",2021,12,54252,52981,1271,2.3
MT3833500000000,38,33500,"Minot, ND MSA",2021,12,39561,38651,910,2.3
MT3910420000000,39,10420,"Akron, OH MSA",2021,12,350019,336379,13640,3.9
MT3915940000000,39,15940,"Canton-Massillon, OH MSA",2021,12,189753,182156,7597,4
MT3917140000000,39,17140,"Cincinnati, OH-KY-IN MSA",2021,12,1139362,1099690,39672,3.5
MT3917410000000,39,17410,"Cleveland, OH MSA",2021,12,1066072,1013592,52480,4.9
MT3918140000000,39,18140,"Columbus, OH MSA",2021,12,1117631,1080088,37543,3.4
MT3919430000000,39,19430,"Dayton-Kettering-Beavercreek, OH MSA",2021,12,380108,365529,14579,3.8
MT3930620000000,39,30620,"Lima, OH MSA",2021,12,47265,45346,1919,4.1
MT3931900000000,39,31900,"Mansfield, OH MSA",2021,12,52466,50197,2269,4.3
MT3941780000000,39,41780,"Sandusky, OH MSA",2021,12,56456,53364,3092,5.5
MT3944220000000,39,44220,"Springfield, OH MSA",2021,12,61174,58738,2436,4
MT3945780000000,39,45780,"Toledo, OH MSA",2021,12,288128,276003,12125,4.2
MT3948260000000,39,48260,"Weirton-Steubenville, WV-OH MSA",2021,12,52827,50247,2580,4.9
MT3949660000000,39,49660,"Youngstown-Warren, OH MSA",2021,12,188310,179536,8774,4.7
MT4021420000000,40,21420,"Enid, OK MSA",2021,12,28468,27748,720,2.5
MT4030020000000,40,30020,"Lawton, OK MSA",2021,12,50504,48982,1522,3
MT4036420000000,40,36420,"Oklahoma City, OK MSA",2021,12,718160,699465,18695,2.6
MT4046140000000,40,46140,"Tulsa, OK MSA",2021,12,490021,475961,14060,2.9
MT4110540000000,41,10540,"Albany, OR MSA",2021,12,61063,58444,2619,4.3
MT4113460000000,41,13460,"Bend, OR MSA",2021,12,126454,121482,4972,3.9
MT4118700000000,41,18700,"Corvallis, OR MSA",2021,12,47952,46405,1547,3.2
MT4121660000000,41,21660,"Eugene-Springfield, OR MSA",2021,12,185949,178288,7661,4.1
MT4124420000000,41,24420,"Grants Pass, OR MSA",2021,12,35336,33521,1815,5.1
MT4132780000000,41,32780,"Medford, OR MSA",2021,12,104765,100174,4591,4.4
MT4138900000000,41,38900,"Portland-Vancouver-Hillsboro, OR-WA MSA",2021,12,1364080,1313535,50545,3.7
MT4141420000000,41,41420,"Salem, OR MSA",2021,12,212474,204180,8294,3.9
MT4210900000000,42,10900,"Allentown-Bethlehem-Easton, PA-NJ MSA",2021,12,439544,419066,20478,4.7
MT4211020000000,42,11020,"Altoona, PA MSA",2021,12,57020,54440,2580,4.5
MT4216540000000,42,16540,"Chambersburg, PA MSA",2021,12,76247,73438,2809,3.7
MT4221500000000,42,21500,"Erie, PA MSA",2021,12,124956,118695,6261,5
MT4223900000000,42,23900,"Gettysburg, PA MSA",2021,12,51651,49864,1787,3.5
MT4225420000000,42,25420,"Harrisburg-Carlisle, PA MSA",2021,12,302858,291197,11661,3.9
MT4227780000000,42,27780,"Johnstown, PA MSA",2021,12,56669,53757,2912,5.1
MT4229540000000,42,29540,"Lancaster, PA MSA",2021,12,286448,276156,10292,3.6
MT4230140000000,42,30140,"Lebanon, PA MSA",2021,12,70704,67901,2803,4
MT4237980000000,42,37980,"Philadelphia-Camden-Wilmington, PA-NJ-DE-MD MSA",2021,12,3181750,3035968,145782,4.6
MT4238300000000,42,38300,"Pittsburgh, PA MSA",2021,12,1216141,1161675,54466,4.5
MT4239740000000,42,39740,"Reading, PA MSA",2021,12,213171,203543,9628,4.5
MT4242540000000,42,42540,"Scranton--Wilkes-Barre, PA MSA",2021,12,274898,259947,14951,5.4
MT4244300000000,42,44300,"State College, PA MSA",2021,12,74401,71814,2587,3.5
MT4248700000000,42,48700,"Williamsport, PA MSA",2021,12,51660,49077,2583,5
MT4249620000000,42,49620,"York-Hanover, PA MSA",2021,12,233777,224692,9085,3.9
MT4439300000000,44,39300,"Providence-Warwick, RI-MA MSA",2021,12,869095,834001,35094,4
MT4516700000000,45,16700,"Charleston-North Charleston, SC MSA",2021,12,402775,390875,11900,3
MT4517900000000,45,17900,"Columbia, SC MSA",2021,12,397310,384719,12591,3.2
MT4522500000000,45,22500,"Florence, SC MSA",2021,12,88971,85697,3274,3.7
MT4524860000000,45,24860,"Greenville-Anderson-Greer, SC MSA",2021,12,450945,437788,13157,2.9
MT4525940000000,45,25940,"Hilton Head Island-Bluffton-Port Royal, SC MSA",2021,12,92179,89438,2741,3
MT4534820000000,45,34820,"Myrtle Beach-Conway-North Myrtle Beach, SC MSA",2021,12,156626,150455,6171,3.9
MT4543900000000,45,43900,"Spartanburg, SC MSA",2021,12,166809,161069,5740,3.4
MT4544940000000,45,44940,"Sumter, SC MSA",2021,12,41942,40347,1595,3.8
MT4639660000000,46,39660,"Rapid City, SD MSA",2021,12,77102,75557,1545,2
MT4643620000000,46,43620,"Sioux Falls, SD-MN MSA",2021,12,166541,163511,3030,1.8
MT4716860000000,47,16860,"Chattanooga, TN-GA MSA",2021,12,272786,263815,8971,3.3
MT4717300000000,47,17300,"Clarksville, TN-KY MSA",2021,12,134063,129041,5022,3.7
MT4717420000000,47,17420,"Cleveland, TN MSA",2021,12,57119,55089,2030,3.6
MT4727180000000,47,27180,"Jackson, TN MSA",2021,12,78886,76034,2852,3.6
MT4727740000000,47,27740,"Johnson City, TN MSA",2021,12,96446,93469,2977,3.1
MT4728700000000,47,28700,"Kingsport-Bristol, TN-VA MSA",2021,12,129596,125386,4210,3.2
MT4728940000000,47,28940,"Knoxville, TN MSA",2021,12,438514,425668,12846,2.9
MT4732820000000,47,32820,"Memphis, TN-MS-AR MSA",2021,12,639755,611475,28280,4.4
MT4734100000000,47,34100,"Morristown, TN MSA",2021,12,52616,50766,1850,3.5
MT4734980000000,47,34980,"Nashville-Davidson--Murfreesboro--Franklin, TN MSA",2021,12,1116067,1084325,31742,2.8
MT4810180000000,48,10180,"Abilene, TX MSA",2021,12,81920,78808,3112,3.8
MT4811100000000,48,11100,"Amarillo, TX MSA",2021,12,132334,127819,4515,3.4
MT4812420000000,48,12420,"Austin-Round Rock-San Marcos, TX MSA",2021,12,1356395,1311827,44568,3.3
MT4813140000000,48,13140,"Beaumont-Port Arthur, TX MSA",2021,12,169608,158238,11370,6.7
MT4815180000000,48,15180,"Brownsville-Harlingen, TX MSA",2021,12,180298,169135,11163,6.2
MT4817780000000,48,17780,"College Station-Bryan, TX MSA",2021,12,138676,133517,5159,3.7
MT4818580000000,48,18580,"Corpus Christi, TX MSA",2021,12,201193,189752,11441,5.7
MT4819100000000,48,19100,"Dallas-Fort Worth-Arlington, TX MSA",2021,12,4163881,3999260,164621,4
MT4820580000000,48,20580,"Eagle Pass, TX MSA",2021,12,23395,21223,2172,9.3
MT4821340000000,48,21340,"El Paso, TX MSA",2021,12,387212,369163,18049,4.7
MT4826420000000,48,26420,"Houston-Pasadena-The Woodlands, TX MSA",2021,12,3554991,3384921,170070,4.8
MT4828660000000,48,28660,"Killeen-Temple, TX MSA",2021,12,194141,185157,8984,4.6
MT4829700000000,48,29700,"Laredo, TX MSA",2021,12,111623,106058,5565,5
MT4830980000000,48,30980,"Longview, TX MSA",2021,12,125612,119376,6236,5
MT4831180000000,48,31180,"Lubbock, TX MSA",2021,12,176800,170006,6794,3.8
MT4832580000000,48,32580,"McAllen-Edinburg-Mission, TX MSA",2021,12,375576,348835,26741,7.1
MT4833260000000,48,33260,"Midland, TX MSA",2021,12,90767,86880,3887,4.3
MT4836220000000,48,36220,"Odessa, TX MSA",2021,12,78406,74238,4168,5.3
MT4841660000000,48,41660,"San Angelo, TX MSA",2021,12,58690,56488,2202,3.8
MT4841700000000,48,41700,"San Antonio-New Braunfels, TX MSA",2021,12,1245397,1194700,50697,4.1
MT4843300000000,48,43300,"Sherman-Denison, TX MSA",2021,12,66090,63448,2642,4
MT4845500000000,48,45500,"Texarkana, TX-AR MSA",2021,12,60387,57520,2867,4.7
MT4846340000000,48,46340,"Tyler, TX MSA",2021,12,110732,106186,4546,4.1
MT4847020000000,48,47020,"Victoria, TX MSA",2021,12,44641,42439,2202,4.9
MT4847380000000,48,47380,"Waco, TX MSA",2021,12,139999,134262,5737,4.1
MT4848660000000,48,48660,"Wichita Falls, TX MSA",2021,12,65495,62793,2702,4.1
MT4930860000000,49,30860,"Logan, UT-ID MSA",2021,12,77849,76349,1500,1.9
MT4936260000000,49,36260,"Ogden, UT MSA",2021,12,329511,322568,6943,2.1
MT4939340000000,49,39340,"Provo-Orem-Lehi, UT MSA",2021,12,346284,339268,7016,2
MT4941100000000,49,41100,"St. George, UT MSA",2021,12,84415,82289,2126,2.5
MT4941620000000,49,41620,"Salt Lake City-Murray, UT MSA",2021,12,693148,677319,15829,2.3
MT5015540000000,50,15540,"Burlington-South Burlington, VT MSA",2021,12,125437,122496,2941,2.3
MT5113980000000,51,13980,"Blacksburg-Christiansburg-Radford, VA MSA",2021,12,88549,86259,2290,2.6
MT5116820000000,51,16820,"Charlottesville, VA MSA",2021,12,112882,109984,2898,2.6
MT5125500000000,51,25500,"Harrisonburg, VA MSA",2021,12,69914,68118,1796,2.6
MT5131340000000,51,31340,"Lynchburg, VA MSA",2021,12,125446,121752,3694,2.9
MT5140060000000,51,40060,"Richmond, VA MSA",2021,12,688352,666197,22155,3.2
MT5140220000000,51,40220,"Roanoke, VA MSA",2021,12,151178,146820,4358,2.9
MT5144420000000,51,44420,"Staunton-Stuarts Draft, VA MSA",2021,12,62324,60761,1563,2.5
MT5147260000000,51,47260,"Virginia Beach-Chesapeake-Norfolk, VA-NC MSA",2021,12,846774,819375,27399,3.2
MT5149020000000,51,49020,"Winchester, VA-WV MSA",2021,12,73240,71060,2180,3
MT5313380000000,53,13380,"Bellingham, WA MSA",2021,12,114216,109444,4772,4.2
MT5314740000000,53,14740,"Bremerton-Silverdale-Port Orchard, WA MSA",2021,12,122382,117504,4878,4
MT5328420000000,53,28420,"Kennewick-Richland, WA MSA",2021,12,145042,138325,6717,4.6
MT5331020000000,53,31020,"Longview-Kelso, WA MSA",2021,12,47709,45416,2293,4.8
MT5334580000000,53,34580,"Mount Vernon-Anacortes, WA MSA",2021,12,58728,55943,2785,4.7
MT5336500000000,53,36500,"Olympia-Lacey-Tumwater, WA MSA",2021,12,139549,133771,5778,4.1
MT5342660000000,53,42660,"Seattle-Tacoma-Bellevue, WA MSA",2021,12,2192658,2111573,81085,3.7
MT5344060000000,53,44060,"Spokane-Spokane Valley, WA MSA",2021,12,282261,270768,11493,4.1
MT5347460000000,53,47460,"Walla Walla, WA MSA",2021,12,29905,28753,1152,3.9
MT5348300000000,53,48300,"Wenatchee-East Wenatchee, WA MSA",2021,12,62422,59660,2762,4.4
MT5349420000000,53,49420,"Yakima, WA MSA",2021,12,127521,120529,6992,5.5
MT5413220000000,54,13220,"Beckley, WV MSA",2021,12,44972,43169,1803,4
MT5416620000000,54,16620,"Charleston, WV MSA",2021,12,89544,85957,3587,4
MT5426580000000,54,26580,"Huntington-Ashland, WV-KY-OH MSA",2021,12,155051,148233,6818,4.4
MT5434060000000,54,34060,"Morgantown, WV MSA",2021,12,70891,68253,2638,3.7
MT5437620000000,54,37620,"Parkersburg-Vienna, WV MSA",2021,12,38785,37149,1636,4.2
MT5448540000000,54,48540,"Wheeling, WV-OH MSA",2021,12,59453,56686,2767,4.7
MT5511540000000,55,11540,"Appleton, WI MSA",2021,12,134483,131231,3252,2.4
MT5520740000000,55,20740,"Eau Claire, WI MSA",2021,12,92746,90132,2614,2.8
MT5522540000000,55,22540,"Fond du Lac, WI MSA",2021,12,56455,54990,1465,2.6
MT5524580000000,55,24580,"Green Bay, WI MSA",2021,12,175162,170443,4719,2.7
MT5527500000000,55,27500,"Janesville-Beloit, WI MSA",2021,12,83890,80870,3020,3.6
MT5528450000000,55,28450,"Kenosha, WI MSA",2021,12,92673,89573,3100,3.3
MT5529100000000,55,29100,"La Crosse-Onalaska, WI-MN MSA",2021,12,88209,85936,2273,2.6
MT5531540000000,55,31540,"Madison, WI MSA",2021,12,393036,384123,8913,2.3
MT5533340000000,55,33340,"Milwaukee-Waukesha, WI MSA",2021,12,809348,782594,26754,3.3
MT5536780000000,55,36780,"Oshkosh-Neenah, WI MSA",2021,12,91554,89229,2325,2.5
MT5539540000000,55,39540,"Racine-Mount Pleasant, WI MSA",2021,12,99824,96248,3576,3.6
MT5543100000000,55,43100,"Sheboygan, WI MSA",2021,12,62073,60538,1535,2.5
MT5548140000000,55,48140,"Wausau, WI MSA",2021,12,74443,72619,1824,2.5
MT5616220000000,56,16220,"Casper, WY MSA",2021,12,40662,39000,1662,4.1
MT5616940000000,56,16940,"Cheyenne, WY MSA",2021,12,49061,47423,1638,3.3
MT7210380000000,72,10380,"Aguadilla, PR MSA",2021,12,85258,78537,6721,7.9
MT7211640000000,72,11640,"Arecibo, PR MSA",2021,12,64950,60126,4824,7.4
MT7225020000000,72,25020,"Guayama, PR MSA",2021,12,19545,17899,1646,8.4
MT7232420000000,72,32420,"Mayaguez, PR MSA",2021,12,66862,61247,5615,8.4
MT7238660000000,72,38660,"Ponce, PR MSA",2021,12,89669,81704,7965,8.9
MT7241980000000,72,41980,"San Juan-Bayamon-Caguas, PR MSA",2021,12,814563,766201,48362,5.9
MT0111500000000,1,11500,"Anniston-Oxford, AL MSA",2022,1,49624,48193,1431,2.9
MT0112220000000,1,12220,"Auburn-Opelika, AL MSA",2022,1,91453,89229,2224,2.4
MT0113820000000,1,13820,"Birmingham, AL MSA",2022,1,557190,543660,13530,2.4
MT0119300000000,1,19300,"Daphne-Fairhope-Foley, AL MSA",2022,1,110310,108071,2239,2
MT0119460000000,1,19460,"Decatur, AL MSA",2022,1,72199,70676,1523,2.1
MT0120020000000,1,20020,"Dothan, AL MSA",2022,1,66220,64607,1613,2.4
MT0122520000000,1,22520,"Florence-Muscle Shoals, AL MSA",2022,1,67258,65494,1764,2.6
MT0123460000000,1,23460,"Gadsden, AL MSA",2022,1,41246,40073,1173,2.8
MT0126620000000,1,26620,"Huntsville, AL MSA",2022,1,253424,248306,5118,2
MT0133660000000,1,33660,"Mobile, AL MSA",2022,1,183435,177221,6214,3.4
MT0133860000000,1,33860,"Montgomery, AL MSA",2022,1,172715,167680,5035,2.9
MT0146220000000,1,46220,"Tuscaloosa, AL MSA",2022,1,120015,116629,3386,2.8
MT0211260000000,2,11260,"Anchorage, AK MSA",2022,1,199173,189700,9473,4.8
MT0221820000000,2,21820,"Fairbanks-College, AK MSA",2022,1,44844,42826,2018,4.5
MT0422380000000,4,22380,"Flagstaff, AZ MSA",2022,1,71781,68737,3044,4.2
MT0429420000000,4,29420,"Lake Havasu City-Kingman, AZ MSA",2022,1,84906,81237,3669,4.3
MT0438060000000,4,38060,"Phoenix-Mesa-Chandler, AZ MSA",2022,1,2549372,2469168,80204,3.1
MT0439150000000,4,39150,"Prescott Valley-Prescott, AZ MSA",2022,1,101410,98090,3320,3.3
MT0443420000000,4,43420,"Sierra Vista-Douglas, AZ MSA",2022,1,47270,45210,2060,4.4
MT0446060000000,4,46060,"Tucson, AZ MSA",2022,1,485621,468257,17364,3.6
MT0449740000000,4,49740,"Yuma, AZ MSA",2022,1,95419,83790,11629,12.2
MT0522220000000,5,22220,"Fayetteville-Springdale-Rogers, AR MSA",2022,1,282993,276377,6616,2.3
MT0522900000000,5,22900,"Fort Smith, AR-OK MSA",2022,1,99737,96851,2886,2.9
MT0526300000000,5,26300,"Hot Springs, AR MSA",2022,1,43549,42058,1491,3.4
MT0527860000000,5,27860,"Jonesboro, AR MSA",2022,1,63796,62076,1720,2.7
MT0530780000000,5,30780,"Little Rock-North Little Rock-Conway, AR MSA",2022,1,361287,350280,11007,3
MT0612540000000,6,12540,"Bakersfield-Delano, CA MSA",2022,1,392999,363621,29378,7.5
MT0617020000000,6,17020,"Chico, CA MSA",2022,1,89847,85408,4439,4.9
MT0620940000000,6,20940,"El Centro, CA MSA",2022,1,67043,56823,10220,15.2
MT0623420000000,6,23420,"Fresno, CA MSA",2022,1,508369,472316,36053,7.1
MT0625260000000,6,25260,"Hanford-Corcoran, CA MSA",2022,1,53893,49676,4217,7.8
MT0631080000000,6,31080,"Los Angeles-Long Beach-Anaheim, CA MSA",2022,1,6633731,6266263,367468,5.5
MT0632900000000,6,32900,"Merced, CA MSA",2022,1,115076,105398,9678,8.4
MT0633700000000,6,33700,"Modesto, CA MSA",2022,1,244200,229559,14641,6
MT0634900000000,6,34900,"Napa, CA MSA",2022,1,70158,67474,2684,3.8
MT0637100000000,6,37100,"Oxnard-Thousand Oaks-Ventura, CA MSA",2022,1,412011,394372,17639,4.3
MT0639820000000,6,39820,"Redding, CA MSA",2022,1,76045,72383,3662,4.8
MT0640140000000,6,40140,"Riverside-San Bernardino-Ontario, CA MSA",2022,1,2135876,2027841,108035,5.1
MT0640900000000,6,40900,"Sacramento-Roseville-Folsom, CA MSA",2022,1,1134060,1084324,49736,4.4
MT0641500000000,6,41500,"Salinas, CA MSA",2022,1,214036,200328,13708,6.4
MT0641740000000,6,41740,"San Diego-Chula Vista-Carlsbad, CA MSA",2022,1,1599676,1533157,66519,4.2
MT0641860000000,6,41860,"San Francisco-Oakland-Fremont, CA MSA",2022,1,2487521,2395272,92249,3.7
MT0641940000000,6,41940,"San Jose-Sunnyvale-Santa Clara, CA MSA",2022,1,1033077,998092,34985,3.4
MT0642020000000,6,42020,"San Luis Obispo-Paso Robles, CA MSA",2022,1,131205,126322,4883,3.7
MT0642100000000,6,42100,"Santa Cruz-Watsonville, CA MSA",2022,1,133419,126631,6788,5.1
MT0642200000000,6,42200,"Santa Maria-Santa Barbara, CA MSA",2022,1,217572,208945,8627,4
MT0642220000000,6,42220,"Santa Rosa-Petaluma, CA MSA",2022,1,243889,234810,9079,3.7
MT0644700000000,6,44700,"Stockton-Lodi, CA MSA",2022,1,354940,334366,20574,5.8
MT0646700000000,6,46700,"Vallejo, CA MSA",2022,1,209312,198947,10365,5
MT0647300000000,6,47300,"Visalia, CA MSA",2022,1,205458,188460,16998,8.3
MT0649700000000,6,49700,"Yuba City, CA MSA",2022,1,77554,72506,5048,6.5
MT0814500000000,8,14500,"Boulder, CO MSA",2022,1,191261,185006,6255,3.3
MT0817820000000,8,17820,"Colorado Springs, CO MSA",2022,1,380566,365519,15047,4
MT0819740000000,8,19740,"Denver-Aurora-Centennial, CO MSA",2022,1,1736975,1672566,64409,3.7
MT0822660000000,8,22660,"Fort Collins-Loveland, CO MSA",2022,1,201901,194796,7105,3.5
MT0824300000000,8,24300,"Grand Junction, CO MSA",2022,1,78425,75204,3221,4.1
MT0824540000000,8,24540,"Greeley, CO MSA",2022,1,169990,163048,6942,4.1
MT0839380000000,8,39380,"Pueblo, CO MSA",2022,1,74841,70508,4333,5.8
MT0914860000000,9,14860,"Bridgeport-Stamford-Danbury, CT MSA",2022,1,509596,486882,22714,4.5
MT0925540000000,9,25540,"Hartford-West Hartford-East Hartford, CT MSA",2022,1,616813,587171,29642,4.8
MT0935300000000,9,35300,"New Haven, CT MSA",2022,1,315584,300623,14961,4.7
MT0935980000000,9,35980,"Norwich-New London-Willimantic, CT MSA",2022,1,142375,135096,7279,5.1
MT0947930000000,9,47930,"Waterbury-Shelton, CT MSA",2022,1,243141,230478,12663,5.2
MT1020100000000,10,20100,"Dover, DE MSA",2022,1,85080,80979,4101,4.8
MT1147900000000,11,47900,"Washington-Arlington-Alexandria, DC-VA-MD-WV MSA",2022,1,3412555,3309872,102683,3
MT1215980000000,12,15980,"Cape Coral-Fort Myers, FL MSA",2022,1,356752,344170,12582,3.5
MT1218880000000,12,18880,"Crestview-Fort Walton Beach-Destin, FL MSA",2022,1,137724,133920,3804,2.8
MT1219660000000,12,19660,"Deltona-Daytona Beach-Ormond Beach, FL MSA",2022,1,306281,294673,11608,3.8
MT1223540000000,12,23540,"Gainesville, FL MSA",2022,1,164052,158543,5509,3.4
MT1226140000000,12,26140,"Homosassa Springs, FL MSA",2022,1,51620,49280,2340,4.5
MT1227260000000,12,27260,"Jacksonville, FL MSA",2022,1,819866,792555,27311,3.3
MT1229460000000,12,29460,"Lakeland-Winter Haven, FL MSA",2022,1,341325,327310,14015,4.1
MT1233100000000,12,33100,"Miami-Fort Lauderdale-West Palm Beach, FL MSA",2022,1,3138623,3033446,105177,3.4
MT1234940000000,12,34940,"Naples-Marco Island, FL MSA",2022,1,170929,165173,5756,3.4
MT1235840000000,12,35840,"North Port-Bradenton-Sarasota, FL MSA",2022,1,368937,356577,12360,3.4
MT1236100000000,12,36100,"Ocala, FL MSA",2022,1,150053,144149,5904,3.9
MT1236740000000,12,36740,"Orlando-Kissimmee-Sanford, FL MSA",2022,1,1426607,1375530,51077,3.6
MT1237340000000,12,37340,"Palm Bay-Melbourne-Titusville, FL MSA",2022,1,291350,281706,9644,3.3
MT1237460000000,12,37460,"Panama City-Panama City Beach, FL MSA",2022,1,96147,93028,3119,3.2
MT1237860000000,12,37860,"Pensacola-Ferry Pass-Brent, FL MSA",2022,1,232546,224614,7932,3.4
MT1238940000000,12,38940,"Port St. Lucie, FL MSA",2022,1,226261,217752,8509,3.8
MT1239460000000,12,39460,"Punta Gorda, FL MSA",2022,1,71056,68200,2856,4
MT1242680000000,12,42680,"Sebastian-Vero Beach-West Vero Corridor, FL MSA",2022,1,64611,61905,2706,4.2
MT1242700000000,12,42700,"Sebring, FL MSA",2022,1,35142,33461,1681,4.8
MT1245220000000,12,45220,"Tallahassee, FL MSA",2022,1,197654,190724,6930,3.5
MT1245300000000,12,45300,"Tampa-St. Petersburg-Clearwater, FL MSA",2022,1,1621857,1568235,53622,3.3
MT1248680000000,12,48680,"Wildwood-The Villages, FL MSA",2022,1,30921,29246,1675,5.4
MT1310500000000,13,10500,"Albany, GA MSA",2022,1,62819,60323,2496,4
MT1312020000000,13,12020,"Athens-Clarke County, GA MSA",2022,1,102296,99268,3028,3
MT1312060000000,13,12060,"Atlanta-Sandy Springs-Roswell, GA MSA",2022,1,3179942,3082361,97581,3.1
MT1312260000000,13,12260,"Augusta-Richmond County, GA-SC MSA",2022,1,263775,254612,9163,3.5
MT1315260000000,13,15260,"Brunswick-St. Simons, GA MSA",2022,1,52207,50625,1582,3
MT1317980000000,13,17980,"Columbus, GA-AL MSA",2022,1,130348,125755,4593,3.5
MT1319140000000,13,19140,"Dalton, GA MSA",2022,1,66424,64513,1911,2.9
MT1323580000000,13,23580,"Gainesville, GA MSA",2022,1,102013,99407,2606,2.6
MT1325980000000,13,25980,"Hinesville, GA MSA",2022,1,30700,29561,1139,3.7
MT1331420000000,13,31420,"Macon-Bibb County, GA MSA",2022,1,98511,94952,3559,3.6
MT1340660000000,13,40660,"Rome, GA MSA",2022,1,43938,42566,1372,3.1
MT1342340000000,13,42340,"Savannah, GA MSA",2022,1,203821,197586,6235,3.1
MT1346660000000,13,46660,"Valdosta, GA MSA",2022,1,61460,59409,2051,3.3
MT1347580000000,13,47580,"Warner Robins, GA MSA",2022,1,88618,85889,2729,3.1
MT1527980000000,15,27980,"Kahului-Wailuku, HI MSA",2022,1,82567,79785,2782,3.4
MT1546520000000,15,46520,"Urban Honolulu, HI MSA",2022,1,460675,447125,13550,2.9
MT1614260000000,16,14260,"Boise City, ID MSA",2022,1,418449,407706,10743,2.6
MT1617660000000,16,17660,"Coeur d'Alene, ID MSA",2022,1,86011,83196,2815,3.3
MT1626820000000,16,26820,"Idaho Falls, ID MSA",2022,1,79551,77644,1907,2.4
MT1630300000000,16,30300,"Lewiston, ID-WA MSA",2022,1,30311,29423,888,2.9
MT1638540000000,16,38540,"Pocatello, ID MSA",2022,1,38753,37561,1192,3.1
MT1646300000000,16,46300,"Twin Falls, ID MSA",2022,1,58498,56947,1551,2.7
MT1714010000000,17,14010,"Bloomington, IL MSA",2022,1,90445,87102,3343,3.7
MT1716580000000,17,16580,"Champaign-Urbana, IL MSA",2022,1,123150,118185,4965,4
MT1716980000000,17,16980,"Chicago-Naperville-Elgin, IL-IN MSA",2022,1,4844942,4623193,221749,4.6
MT1719340000000,17,19340,"Davenport-Moline-Rock Island, IA-IL MSA",2022,1,189344,182046,7298,3.9
MT1719500000000,17,19500,"Decatur, IL MSA",2022,1,45483,42604,2879,6.3
MT1728100000000,17,28100,"Kankakee, IL MSA",2022,1,50577,47714,2863,5.7
MT1737900000000,17,37900,"Peoria, IL MSA",2022,1,173328,165032,8296,4.8
MT1740420000000,17,40420,"Rockford, IL MSA",2022,1,162047,150778,11269,7
MT1744100000000,17,44100,"Springfield, IL MSA",2022,1,101636,96960,4676,4.6
MT1814020000000,18,14020,"Bloomington, IN MSA",2022,1,84065,82061,2004,2.4
MT1818020000000,18,18020,"Columbus, IN MSA",2022,1,38662,37699,963,2.5
MT1821140000000,18,21140,"Elkhart-Goshen, IN MSA",2022,1,106748,104326,2422,2.3
MT1821780000000,18,21780,"Evansville, IN MSA",2022,1,134043,130156,3887,2.9
MT1823060000000,18,23060,"Fort Wayne, IN MSA",2022,1,224403,218333,6070,2.7
MT1826900000000,18,26900,"Indianapolis-Carmel-Greenwood, IN MSA",2022,1,1090030,1059403,30627,2.8
MT1829020000000,18,29020,"Kokomo, IN MSA",2022,1,36006,34493,1513,4.2
MT1829200000000,18,29200,"Lafayette-West Lafayette, IN MSA",2022,1,115614,112437,3177,2.7
MT1833140000000,18,33140,"Michigan City-La Porte, IN MSA",2022,1,50362,48661,1701,3.4
MT1834620000000,18,34620,"Muncie, IN MSA",2022,1,51126,49369,1757,3.4
MT1843780000000,18,43780,"South Bend-Mishawaka, IN-MI MSA",2022,1,152962,147825,5137,3.4
MT1845460000000,18,45460,"Terre Haute, IN MSA",2022,1,76443,73990,2453,3.2
MT1911180000000,19,11180,"Ames, IA MSA",2022,1,68034,66480,1554,2.3
MT1916300000000,19,16300,"Cedar Rapids, IA MSA",2022,1,148208,143776,4432,3
MT1919780000000,19,19780,"Des Moines-West Des Moines, IA MSA",2022,1,393703,383194,10509,2.7
MT1920220000000,19,20220,"Dubuque, IA MSA",2022,1,53464,51874,1590,3
MT1926980000000,19,26980,"Iowa City, IA MSA",2022,1,97815,95467,2348,2.4
MT1943580000000,19,43580,"Sioux City, IA-NE-SD MSA",2022,1,75889,73895,1994,2.6
MT1947940000000,19,47940,"Waterloo-Cedar Falls, IA MSA",2022,1,88409,85898,2511,2.8
MT2029940000000,20,29940,"Lawrence, KS MSA",2022,1,68319,66726,1593,2.3
MT2031740000000,20,31740,"Manhattan, KS MSA",2022,1,62520,60989,1531,2.4
MT2045820000000,20,45820,"Topeka, KS MSA",2022,1,115731,112645,3086,2.7
MT2048620000000,20,48620,"Wichita, KS MSA",2022,1,323630,313787,9843,3
MT2114540000000,21,14540,"Bowling Green, KY MSA",2022,1,88177,85037,3140,3.6
MT2121060000000,21,21060,"Elizabethtown, KY MSA",2022,1,53561,51344,2217,4.1
MT2130460000000,21,30460,"Lexington-Fayette, KY MSA",2022,1,267185,258655,8530,3.2
MT2131140000000,21,31140,"Louisville/Jefferson County, KY-IN MSA",2022,1,688060,661999,26061,3.8
MT2136980000000,21,36980,"Owensboro, KY MSA",2022,1,51233,49452,1781,3.5
MT2137140000000,21,37140,"Paducah, KY-IL MSA",2022,1,45416,43519,1897,4.2
MT2210780000000,22,10780,"Alexandria, LA MSA",2022,1,65188,63096,2092,3.2
MT2212940000000,22,12940,"Baton Rouge, LA MSA",2022,1,421365,405928,15437,3.7
MT2225220000000,22,25220,"Hammond, LA MSA",2022,1,59003,56407,2596,4.4
MT2226380000000,22,26380,"Houma-Bayou Cane-Thibodaux, LA MSA",2022,1,85245,81779,3466,4.1
MT2229180000000,22,29180,"Lafayette, LA MSA",2022,1,194742,188450,6292,3.2
MT2229340000000,22,29340,"Lake Charles, LA MSA",2022,1,101569,97641,3928,3.9
MT2233740000000,22,33740,"Monroe, LA MSA",2022,1,96487,92631,3856,4
MT2235380000000,22,35380,"New Orleans-Metairie, LA MSA",2022,1,467487,446474,21013,4.5
MT2243340000000,22,43340,"Shreveport-Bossier City, LA MSA",2022,1,167974,161526,6448,3.8
MT2243640000000,22,43640,"Slidell-Mandeville-Covington, LA MSA",2022,1,124353,120782,3571,2.9
MT2312620000000,23,12620,"Bangor, ME MSA",2022,1,73361,70548,2813,3.8
MT2330340000000,23,30340,"Lewiston-Auburn, ME MSA",2022,1,54575,52550,2025,3.7
MT2338860000000,23,38860,"Portland-South Portland, ME MSA",2022,1,302164,293070,9094,3
MT2412580000000,24,12580,"Baltimore-Columbia-Towson, MD MSA",2022,1,1456881,1407124,49757,3.4
MT2425180000000,24,25180,"Hagerstown-Martinsburg, MD-WV MSA",2022,1,141000,136667,4333,3.1
MT2430500000000,24,30500,"Lexington Park, MD MSA",2022,1,105468,102226,3242,3.1
MT2441540000000,24,41540,"Salisbury, MD MSA",2022,1,60710,58446,2264,3.7
MT2511200000000,25,11200,"Amherst Town-Northampton, MA MSA",2022,1,83921,80958,2963,3.5
MT2512700000000,25,12700,"Barnstable Town, MA MSA",2022,1,112591,107250,5341,4.7
MT2514460000000,25,14460,"Boston-Cambridge-Newton, MA-NH MSA",2022,1,2726352,2634060,92292,3.4
MT2538340000000,25,38340,"Pittsfield, MA MSA",2022,1,63742,60977,2765,4.3
MT2544140000000,25,44140,"Springfield, MA MSA",2022,1,223480,212233,11247,5
MT2549340000000,25,49340,"Worcester, MA MSA",2022,1,451913,434176,17737,3.9
MT2611460000000,26,11460,"Ann Arbor, MI MSA",2022,1,196615,189802,6813,3.5
MT2612980000000,26,12980,"Battle Creek, MI MSA",2022,1,58840,55935,2905,4.9
MT2613020000000,26,13020,"Bay City, MI MSA",2022,1,47843,45447,2396,5
MT2619820000000,26,19820,"Detroit-Warren-Dearborn, MI MSA",2022,1,2122973,2026848,96125,4.5
MT2622420000000,26,22420,"Flint, MI MSA",2022,1,178794,168842,9952,5.6
MT2624340000000,26,24340,"Grand Rapids-Wyoming-Kentwood, MI MSA",2022,1,593265,572473,20792,3.5
MT2627100000000,26,27100,"Jackson, MI MSA",2022,1,72439,69100,3339,4.6
MT2628020000000,26,28020,"Kalamazoo-Portage, MI MSA",2022,1,132425,127459,4966,3.8
MT2629620000000,26,29620,"Lansing-East Lansing, MI MSA",2022,1,233520,223846,9674,4.1
MT2633220000000,26,33220,"Midland, MI MSA",2022,1,39459,37896,1563,4
MT2633780000000,26,33780,"Monroe, MI MSA",2022,1,73600,70087,3513,4.8
MT2634740000000,26,34740,"Muskegon-Norton Shores, MI MSA",2022,1,80860,76876,3984,4.9
MT2635660000000,26,35660,"Niles, MI MSA",2022,1,72539,69356,3183,4.4
MT2640980000000,26,40980,"Saginaw, MI MSA",2022,1,82757,78321,4436,5.4
MT2645900000000,26,45900,"Traverse City, MI MSA",2022,1,76633,73528,3105,4.1
MT2720260000000,27,20260,"Duluth, MN-WI MSA",2022,1,138207,133599,4608,3.3
MT2731860000000,27,31860,"Mankato, MN MSA",2022,1,58627,57290,1337,2.3
MT2733460000000,27,33460,"Minneapolis-St. Paul-Bloomington, MN-WI MSA",2022,1,2030989,1979115,51874,2.6
MT2740340000000,27,40340,"Rochester, MN MSA",2022,1,124076,121188,2888,2.3
MT2741060000000,27,41060,"St. Cloud, MN MSA",2022,1,107716,104572,3144,2.9
MT2825060000000,28,25060,"Gulfport-Biloxi, MS MSA",2022,1,185825,178714,7111,3.8
MT2825620000000,28,25620,"Hattiesburg, MS MSA",2022,1,70224,67621,2603,3.7
MT2827140000000,28,27140,"Jackson, MS MSA",2022,1,277086,266857,10229,3.7
MT2916020000000,29,16020,"Cape Girardeau, MO-IL MSA",2022,1,47547,46265,1282,2.7
MT2917860000000,29,17860,"Columbia, MO MSA",2022,1,111707,109138,2569,2.3
MT2927620000000,29,27620,"Jefferson City, MO MSA",2022,1,73120,71391,1729,2.4
MT2927900000000,29,27900,"Joplin, MO-KS MSA",2022,1,94585,92123,2462,2.6
MT2928140000000,29,28140,"Kansas City, MO-KS MSA",2022,1,1155723,1121659,34064,2.9
MT2941140000000,29,41140,"St. Joseph, MO-KS MSA",2022,1,55073,53510,1563,2.8
MT2941180000000,29,41180,"St. Louis, MO-IL MSA",2022,1,1449033,1402495,46538,3.2
MT2944180000000,29,44180,"Springfield, MO MSA",2022,1,233171,227541,5630,2.4
MT3013740000000,30,13740,"Billings, MT MSA",2022,1,97475,95108,2367,2.4
MT3014580000000,30,14580,"Bozeman, MT MSA",2022,1,73108,71678,1430,2
MT3024500000000,30,24500,"Great Falls, MT MSA",2022,1,39300,38332,968,2.5
MT3025740000000,30,25740,"Helena, MT MSA",2022,1,45665,44528,1137,2.5
MT3033540000000,30,33540,"Missoula, MT MSA",2022,1,71454,69656,1798,2.5
MT3124260000000,31,24260,"Grand Island, NE MSA",2022,1,41216,40365,851,2.1
MT3130700000000,31,30700,"Lincoln, NE MSA",2022,1,187877,184368,3509,1.9
MT3136540000000,31,36540,"Omaha, NE-IA MSA",2022,1,514924,503335,11589,2.3
MT3216180000000,32,16180,"Carson City, NV MSA",2022,1,27346,26395,951,3.5
MT3229820000000,32,29820,"Las Vegas-Henderson-North Las Vegas, NV MSA",2022,1,1109606,1046650,62956,5.7
MT3239900000000,32,39900,"Reno, NV MSA",2022,1,283751,273968,9783,3.4
MT3331700000000,33,31700,"Manchester-Nashua, NH MSA",2022,1,236902,231065,5837,2.5
MT3412100000000,34,12100,"Atlantic City-Hammonton, NJ MSA",2022,1,176909,164978,11931,6.7
MT3445940000000,34,45940,"Trenton-Princeton, NJ MSA",2022,1,193063,183923,9140,4.7
MT3447220000000,34,47220,"Vineland, NJ MSA",2022,1,64098,59686,4412,6.9
MT3510740000000,35,10740,"Albuquerque, NM MSA",2022,1,447459,425951,21508,4.8
MT3522140000000,35,22140,"Farmington, NM MSA",2022,1,48303,45293,3010,6.2
MT3529740000000,35,29740,"Las Cruces, NM MSA",2022,1,97567,92180,5387,5.5
MT3542140000000,35,42140,"Santa Fe, NM MSA",2022,1,72661,69180,3481,4.8
MT3610580000000,36,10580,"Albany-Schenectady-Troy, NY MSA",2022,1,450710,436865,13845,3.1
MT3613780000000,36,13780,"Binghamton, NY MSA",2022,1,106282,102502,3780,3.6
MT3615380000000,36,15380,"Buffalo-Cheektowaga, NY MSA",2022,1,554678,534583,20095,3.6
MT3621300000000,36,21300,"Elmira, NY MSA",2022,1,35998,34744,1254,3.5
MT3624020000000,36,24020,"Glens Falls, NY MSA",2022,1,59459,57552,1907,3.2
MT3627060000000,36,27060,"Ithaca, NY MSA",2022,1,49054,47638,1416,2.9
MT3628740000000,36,28740,"Kingston, NY MSA",2022,1,85651,82767,2884,3.4
MT3628880000000,36,28880,"Kiryas Joel-Poughkeepsie-Newburgh, NY MSA",2022,1,330349,319320,11029,3.3
MT3635620000000,36,35620,"New York-Newark-Jersey City, NY-NJ MSA",2022,1,9822556,9277537,545019,5.5
MT3640380000000,36,40380,"Rochester, NY MSA",2022,1,511730,494305,17425,3.4
MT3645060000000,36,45060,"Syracuse, NY MSA",2022,1,308655,298184,10471,3.4
MT3646540000000,36,46540,"Utica-Rome, NY MSA",2022,1,127532,123039,4493,3.5
MT3648060000000,36,48060,"Watertown-Fort Drum, NY MSA",2022,1,44952,43308,1644,3.7
MT3711700000000,37,11700,"Asheville, NC MSA",2022,1,206456,200021,6435,3.1
MT3715500000000,37,15500,"Burlington, NC MSA",2022,1,82917,79791,3126,3.8
MT3716740000000,37,16740,"Charlotte-Concord-Gastonia, NC-SC MSA",2022,1,1423916,1373124,50792,3.6
MT3720500000000,37,20500,"Durham-Chapel Hill, NC MSA",2022,1,311252,301256,9996,3.2
MT3722180000000,37,22180,"Fayetteville, NC MSA",2022,1,153976,146328,7648,5
MT3724140000000,37,24140,"Goldsboro, NC MSA",2022,1,49558,47542,2016,4.1
MT3724660000000,37,24660,"Greensboro-High Point, NC MSA",2022,1,373678,358436,15242,4.1
MT3724780000000,37,24780,"Greenville, NC MSA",2022,1,81498,77920,3578,4.4
MT3725860000000,37,25860,"Hickory-Lenoir-Morganton, NC MSA",2022,1,171024,165119,5905,3.5
MT3727340000000,37,27340,"Jacksonville, NC MSA",2022,1,71510,68827,2683,3.8
MT3738240000000,37,38240,"Pinehurst-Southern Pines, NC MSA",2022,1,42498,40958,1540,3.6
MT3739580000000,37,39580,"Raleigh-Cary, NC MSA",2022,1,794252,769644,24608,3.1
MT3740580000000,37,40580,"Rocky Mount, NC MSA",2022,1,64820,61243,3577,5.5
MT3748900000000,37,48900,"Wilmington, NC MSA",2022,1,211312,203531,7781,3.7
MT3749180000000,37,49180,"Winston-Salem, NC MSA",2022,1,322529,310560,11969,3.7
MT3813900000000,38,13900,"Bismarck, ND MSA",2022,1,72806,71372,1434,2
MT3822020000000,38,22020,"Fargo, ND-MN MSA",2022,1,148506,145785,2721,1.8
MT3824220000000,38,24220,"Grand Forks, ND-MN MSA",2022,1,54309,53090,1219,2.2
MT3833500000000,38,33500,"Minot, ND MSA",2022,1,39593,38724,869,2.2
MT3910420000000,39,10420,"Akron, OH MSA",2022,1,350304,337032,13272,3.8
MT3915940000000,39,15940,"Canton-Massillon, OH MSA",2022,1,189691,182330,7361,3.9
MT3917140000000,39,17140,"Cincinnati, OH-KY-IN MSA",2022,1,1141932,1103091,38841,3.4
MT3917410000000,39,17410,"Cleveland, OH MSA",2022,1,1067818,1015476,52342,4.9
MT3918140000000,39,18140,"Columbus, OH MSA",2022,1,1120961,1084356,36605,3.3
MT3919430000000,39,19430,"Dayton-Kettering-Beavercreek, OH MSA",2022,1,380532,366348,14184,3.7
MT3930620000000,39,30620,"Lima, OH MSA",2022,1,47276,45411,1865,3.9
MT3931900000000,39,31900,"Mansfield, OH MSA",2022,1,52458,50257,2201,4.2
MT3941780000000,39,41780,"Sandusky, OH MSA",2022,1,56568,53436,3132,5.5
MT3944220000000,39,44220,"Springfield, OH MSA",2022,1,61435,58950,2485,4
MT3945780000000,39,45780,"Toledo, OH MSA",2022,1,288439,276704,11735,4.1
MT3948260000000,39,48260,"Weirton-Steubenville, WV-OH MSA",2022,1,52837,50311,2526,4.8
MT3949660000000,39,49660,"Youngstown-Warren, OH MSA",2022,1,188565,180005,8560,4.5
MT4021420000000,40,21420,"Enid, OK MSA",2022,1,28638,27905,733,2.6
MT4030020000000,40,30020,"Lawton, OK MSA",2022,1,50521,48944,1577,3.1
MT4036420000000,40,36420,"Oklahoma City, OK MSA",2022,1,720819,701918,18901,2.6
MT4046140000000,40,46140,"Tulsa, OK MSA",2022,1,491200,477009,14191,2.9
MT4110540000000,41,10540,"Albany, OR MSA",2022,1,61312,58735,2577,4.2
MT4113460000000,41,13460,"Bend, OR MSA",2022,1,126960,122097,4863,3.8
MT4118700000000,41,18700,"Corvallis, OR MSA",2022,1,48124,46568,1556,3.2
MT4121660000000,41,21660,"Eugene-Springfield, OR MSA",2022,1,186259,178730,7529,4
MT4124420000000,41,24420,"Grants Pass, OR MSA",2022,1,35420,33633,1787,5
MT4132780000000,41,32780,"Medford, OR MSA",2022,1,104974,100506,4468,4.3
MT4138900000000,41,38900,"Portland-Vancouver-Hillsboro, OR-WA MSA",2022,1,1367541,1317910,49631,3.6
MT4141420000000,41,41420,"Salem, OR MSA",2022,1,213438,205246,8192,3.8
MT4210900000000,42,10900,"Allentown-Bethlehem-Easton, PA-NJ MSA",2022,1,440122,420470,19652,4.5
MT4211020000000,42,11020,"Altoona, PA MSA",2022,1,57086,54584,2502,4.4
MT4216540000000,42,16540,"Chambersburg, PA MSA",2022,1,76384,73656,2728,3.6
MT4221500000000,42,21500,"Erie, PA MSA",2022,1,125221,119170,6051,4.8
MT4223900000000,42,23900,"Gettysburg, PA MSA",2022,1,51696,49964,1732,3.4
MT4225420000000,42,25420,"Harrisburg-Carlisle, PA MSA",2022,1,303739,292476,11263,3.7
MT4227780000000,42,27780,"Johnstown, PA MSA",2022,1,56696,53877,2819,5
MT4229540000000,42,29540,"Lancaster, PA MSA",2022,1,287163,277137,10026,3.5
MT4230140000000,42,30140,"Lebanon, PA MSA",2022,1,70808,68103,2705,3.8
MT4237980000000,42,37980,"Philadelphia-Camden-Wilmington, PA-NJ-DE-MD MSA",2022,1,3190755,3050341,140414,4.4
MT4238300000000,42,38300,"Pittsburgh, PA MSA",2022,1,1216933,1164273,52660,4.3
MT4239740000000,42,39740,"Reading, PA MSA",2022,1,213736,204446,9290,4.3
MT4242540000000,42,42540,"Scranton--Wilkes-Barre, PA MSA",2022,1,275713,261296,14417,5.2
MT4244300000000,42,44300,"State College, PA MSA",2022,1,74568,72029,2539,3.4
MT4248700000000,42,48700,"Williamsport, PA MSA",2022,1,51742,49259,2483,4.8
MT4249620000000,42,49620,"York-Hanover, PA MSA",2022,1,234616,225804,8812,3.8
MT4439300000000,44,39300,"Providence-Warwick, RI-MA MSA",2022,1,869924,836437,33487,3.8
MT4516700000000,45,16700,"Charleston-North Charleston, SC MSA",2022,1,404175,392181,11994,3
MT4517900000000,45,17900,"Columbia, SC MSA",2022,1,398867,386153,12714,3.2
MT4522500000000,45,22500,"Florence, SC MSA",2022,1,89106,85843,3263,3.7
MT4524860000000,45,24860,"Greenville-Anderson-Greer, SC MSA",2022,1,452808,439616,13192,2.9
MT4525940000000,45,25940,"Hilton Head Island-Bluffton-Port Royal, SC MSA",2022,1,92430,89648,2782,3
MT4534820000000,45,34820,"Myrtle Beach-Conway-North Myrtle Beach, SC MSA",2022,1,157209,151117,6092,3.9
MT4543900000000,45,43900,"Spartanburg, SC MSA",2022,1,167156,161476,5680,3.4
MT4544940000000,45,44940,"Sumter, SC MSA",2022,1,42018,40431,1587,3.8
MT4639660000000,46,39660,"Rapid City, SD MSA",2022,1,77204,75724,1480,1.9
MT4643620000000,46,43620,"Sioux Falls, SD-MN MSA",2022,1,166806,163881,2925,1.8
MT4716860000000,47,16860,"Chattanooga, TN-GA MSA",2022,1,273991,264962,9029,3.3
MT4717300000000,47,17300,"Clarksville, TN-KY MSA",2022,1,134539,129565,4974,3.7
MT4717420000000,47,17420,"Cleveland, TN MSA",2022,1,57371,55328,2043,3.6
MT4727180000000,47,27180,"Jackson, TN MSA",2022,1,79009,76197,2812,3.6
MT4727740000000,47,27740,"Johnson City, TN MSA",2022,1,96687,93726,2961,3.1
MT4728700000000,47,28700,"Kingsport-Bristol, TN-VA MSA",2022,1,130039,125886,4153,3.2
MT4728940000000,47,28940,"Knoxville, TN MSA",2022,1,440658,427709,12949,2.9
MT4732820000000,47,32820,"Memphis, TN-MS-AR MSA",2022,1,640448,612982,27466,4.3
MT4734100000000,47,34100,"Morristown, TN MSA",2022,1,52778,50938,1840,3.5
MT4734980000000,47,34980,"Nashville-Davidson--Murfreesboro--Franklin, TN MSA",2022,1,1121874,1090586,31288,2.8
MT4810180000000,48,10180,"Abilene, TX MSA",2022,1,82162,79146,3016,3.7
MT4811100000000,48,11100,"Amarillo, TX MSA",2022,1,132503,128113,4390,3.3
MT4812420000000,48,12420,"Austin-Round Rock-San Marcos, TX MSA",2022,1,1363569,1320334,43235,3.2
MT4813140000000,48,13140,"Beaumont-Port Arthur, TX MSA",2022,1,169774,158928,10846,6.4
MT4815180000000,48,15180,"Brownsville-Harlingen, TX MSA",2022,1,180465,169647,10818,6
MT4817780000000,48,17780,"College Station-Bryan, TX MSA",2022,1,139302,134256,5046,3.6
MT4818580000000,48,18580,"Corpus Christi, TX MSA",2022,1,201390,190275,11115,5.5
MT4819100000000,48,19100,"Dallas-Fort Worth-Arlington, TX MSA",2022,1,4180512,4021652,158860,3.8
MT4820580000000,48,20580,"Eagle Pass, TX MSA",2022,1,23382,21305,2077,8.9
MT4821340000000,48,21340,"El Paso, TX MSA",2022,1,387656,370227,17429,4.5
MT4826420000000,48,26420,"Houston-Pasadena-The Woodlands, TX MSA",2022,1,3562708,3398750,163958,4.6
MT4828660000000,48,28660,"Killeen-Temple, TX MSA",2022,1,194358,185669,8689,4.5
MT4829700000000,48,29700,"Laredo, TX MSA",2022,1,111715,106356,5359,4.8
MT4830980000000,48,30980,"Longview, TX MSA",2022,1,125757,119745,6012,4.8
MT4831180000000,48,31180,"Lubbock, TX MSA",2022,1,177210,170680,6530,3.7
MT4832580000000,48,32580,"McAllen-Edinburg-Mission, TX MSA",2022,1,375989,350052,25937,6.9
MT4833260000000,48,33260,"Midland, TX MSA",2022,1,91192,87500,3692,4
MT4836220000000,48,36220,"Odessa, TX MSA",2022,1,78688,74781,3907,5
MT4841660000000,48,41660,"San Angelo, TX MSA",2022,1,58836,56712,2124,3.6
MT4841700000000,48,41700,"San Antonio-New Braunfels, TX MSA",2022,1,1249929,1200990,48939,3.9
MT4843300000000,48,43300,"Sherman-Denison, TX MSA",2022,1,66163,63598,2565,3.9
MT4845500000000,48,45500,"Texarkana, TX-AR MSA",2022,1,60440,57626,2814,4.7
MT4846340000000,48,46340,"Tyler, TX MSA",2022,1,111127,106686,4441,4
MT4847020000000,48,47020,"Victoria, TX MSA",2022,1,44722,42612,2110,4.7
MT4847380000000,48,47380,"Waco, TX MSA",2022,1,140221,134644,5577,4
MT4848660000000,48,48660,"Wichita Falls, TX MSA",2022,1,65564,62935,2629,4
MT4930860000000,49,30860,"Logan, UT-ID MSA",2022,1,78254,76729,1525,1.9
MT4936260000000,49,36260,"Ogden, UT MSA",2022,1,330534,323516,7018,2.1
MT4939340000000,49,39340,"Provo-Orem-Lehi, UT MSA",2022,1,347801,340742,7059,2
MT4941100000000,49,41100,"St. George, UT MSA",2022,1,84877,82732,2145,2.5
MT4941620000000,49,41620,"Salt Lake City-Murray, UT MSA",2022,1,695497,679646,15851,2.3
MT5015540000000,50,15540,"Burlington-South Burlington, VT MSA",2022,1,125759,122936,2823,2.2
MT5113980000000,51,13980,"Blacksburg-Christiansburg-Radford, VA MSA",2022,1,88962,86679,2283,2.6
MT5116820000000,51,16820,"Charlottesville, VA MSA",2022,1,113276,110484,2792,2.5
MT5125500000000,51,25500,"Harrisonburg, VA MSA",2022,1,70000,68275,1725,2.5
MT5131340000000,51,31340,"Lynchburg, VA MSA",2022,1,125735,122188,3547,2.8
MT5140060000000,51,40060,"Richmond, VA MSA",2022,1,687324,669901,17423,2.5
MT5140220000000,51,40220,"Roanoke, VA MSA",2022,1,151465,147354,4111,2.7
MT5144420000000,51,44420,"Staunton-Stuarts Draft, VA MSA",2022,1,62477,60979,1498,2.4
MT5147260000000,51,47260,"Virginia Beach-Chesapeake-Norfolk, VA-NC MSA",2022,1,848492,822596,25896,3.1
MT5149020000000,51,49020,"Winchester, VA-WV MSA",2022,1,73010,71352,1658,2.3
MT5313380000000,53,13380,"Bellingham, WA MSA",2022,1,114256,109631,4625,4
MT5314740000000,53,14740,"Bremerton-Silverdale-Port Orchard, WA MSA",2022,1,122311,117528,4783,3.9
MT5328420000000,53,28420,"Kennewick-Richland, WA MSA",2022,1,145160,138602,6558,4.5
MT5331020000000,53,31020,"Longview-Kelso, WA MSA",2022,1,47687,45444,2243,4.7
MT5334580000000,53,34580,"Mount Vernon-Anacortes, WA MSA",2022,1,58639,55938,2701,4.6
MT5336500000000,53,36500,"Olympia-Lacey-Tumwater, WA MSA",2022,1,139625,133956,5669,4.1
MT5342660000000,53,42660,"Seattle-Tacoma-Bellevue, WA MSA",2022,1,2204106,2124172,79934,3.6
MT5344060000000,53,44060,"Spokane-Spokane Valley, WA MSA",2022,1,281707,270557,11150,4
MT5347460000000,53,47460,"Walla Walla, WA MSA",2022,1,29765,28630,1135,3.8
MT5348300000000,53,48300,"Wenatchee-East Wenatchee, WA MSA",2022,1,62430,59732,2698,4.3
MT5349420000000,53,49420,"Yakima, WA MSA",2022,1,127263,120496,6767,5.3
MT5413220000000,54,13220,"Beckley, WV MSA",2022,1,45010,43264,1746,3.9
MT5416620000000,54,16620,"Charleston, WV MSA",2022,1,89738,86220,3518,3.9
MT5426580000000,54,26580,"Huntington-Ashland, WV-KY-OH MSA",2022,1,155382,148686,6696,4.3
MT5434060000000,54,34060,"Morgantown, WV MSA",2022,1,70967,68358,2609,3.7
MT5437620000000,54,37620,"Parkersburg-Vienna, WV MSA",2022,1,38923,37303,1620,4.2
MT5448540000000,54,48540,"Wheeling, WV-OH MSA",2022,1,59513,56793,2720,4.6
MT5511540000000,55,11540,"Appleton, WI MSA",2022,1,134553,131357,3196,2.4
MT5520740000000,55,20740,"Eau Claire, WI MSA",2022,1,92809,90220,2589,2.8
MT5522540000000,55,22540,"Fond du Lac, WI MSA",2022,1,56561,55118,1443,2.6
MT5524580000000,55,24580,"Green Bay, WI MSA",2022,1,175324,170701,4623,2.6
MT5527500000000,55,27500,"Janesville-Beloit, WI MSA",2022,1,83952,80978,2974,3.5
MT5528450000000,55,28450,"Kenosha, WI MSA",2022,1,92870,89810,3060,3.3
MT5529100000000,55,29100,"La Crosse-Onalaska, WI-MN MSA",2022,1,88222,85993,2229,2.5
MT5531540000000,55,31540,"Madison, WI MSA",2022,1,393063,384288,8775,2.2
MT5533340000000,55,33340,"Milwaukee-Waukesha, WI MSA",2022,1,808578,782242,26336,3.3
MT5536780000000,55,36780,"Oshkosh-Neenah, WI MSA",2022,1,91531,89249,2282,2.5
MT5539540000000,55,39540,"Racine-Mount Pleasant, WI MSA",2022,1,99785,96258,3527,3.5
MT5543100000000,55,43100,"Sheboygan, WI MSA",2022,1,62097,60591,1506,2.4
MT5548140000000,55,48140,"Wausau, WI MSA",2022,1,74591,72788,1803,2.4
MT5616220000000,56,16220,"Casper, WY MSA",2022,1,40626,39002,1624,4
MT5616940000000,56,16940,"Cheyenne, WY MSA",2022,1,47917,46285,1632,3.4
MT7210380000000,72,10380,"Aguadilla, PR MSA",2022,1,85582,79061,6521,7.6
MT7211640000000,72,11640,"Arecibo, PR MSA",2022,1,65144,60254,4890,7.5
MT7225020000000,72,25020,"Guayama, PR MSA",2022,1,19475,17867,1608,8.3
MT7232420000000,72,32420,"Mayaguez, PR MSA",2022,1,66883,61495,5388,8.1
MT7238660000000,72,38660,"Ponce, PR MSA",2022,1,89402,81728,7674,8.6
MT7241980000000,72,41980,"San Juan-Bayamon-Caguas, PR MSA",2022,1,816117,769575,46542,5.7
MT0111500000000,1,11500,"Anniston-Oxford, AL MSA",2022,2,49573,48155,1418,2.9
MT0112220000000,1,12220,"Auburn-Opelika, AL MSA",2022,2,91746,89544,2202,2.4
MT0113820000000,1,13820,"Birmingham, AL MSA",2022,2,558020,544598,13422,2.4
MT0119300000000,1,19300,"Daphne-Fairhope-Foley, AL MSA",2022,2,110409,108122,2287,2.1
MT0119460000000,1,19460,"Decatur, AL MSA",2022,2,72329,70807,1522,2.1
MT0120020000000,1,20020,"Dothan, AL MSA",2022,2,66344,64725,1619,2.4
MT0122520000000,1,22520,"Florence-Muscle Shoals, AL MSA",2022,2,67426,65663,1763,2.6
MT0123460000000,1,23460,"Gadsden, AL MSA",2022,2,41307,40152,1155,2.8
MT0126620000000,1,26620,"Huntsville, AL MSA",2022,2,254439,249317,5122,2
MT0133660000000,1,33660,"Mobile, AL MSA",2022,2,183524,177416,6108,3.3
MT0133860000000,1,33860,"Montgomery, AL MSA",2022,2,172459,167518,4941,2.9
MT0146220000000,1,46220,"Tuscaloosa, AL MSA",2022,2,120239,116914,3325,2.8
MT0211260000000,2,11260,"Anchorage, AK MSA",2022,2,199080,190073,9007,4.5
MT0221820000000,2,21820,"Fairbanks-College, AK MSA",2022,2,44850,42905,1945,4.3
MT0422380000000,4,22380,"Flagstaff, AZ MSA",2022,2,71993,68938,3055,4.2
MT0429420000000,4,29420,"Lake Havasu City-Kingman, AZ MSA",2022,2,85177,81444,3733,4.4
MT0438060000000,4,38060,"Phoenix-Mesa-Chandler, AZ MSA",2022,2,2557784,2476424,81360,3.2
MT0439150000000,4,39150,"Prescott Valley-Prescott, AZ MSA",2022,2,101734,98349,3385,3.3
MT0443420000000,4,43420,"Sierra Vista-Douglas, AZ MSA",2022,2,47341,45298,2043,4.3
MT0446060000000,4,46060,"Tucson, AZ MSA",2022,2,486534,468986,17548,3.6
MT0449740000000,4,49740,"Yuma, AZ MSA",2022,2,95923,84152,11771,12.3
MT0522220000000,5,22220,"Fayetteville-Springdale-Rogers, AR MSA",2022,2,284683,277936,6747,2.4
MT0522900000000,5,22900,"Fort Smith, AR-OK MSA",2022,2,99986,97042,2944,2.9
MT0526300000000,5,26300,"Hot Springs, AR MSA",2022,2,43593,42088,1505,3.5
MT0527860000000,5,27860,"Jonesboro, AR MSA",2022,2,63978,62216,1762,2.8
MT0530780000000,5,30780,"Little Rock-North Little Rock-Conway, AR MSA",2022,2,362438,351341,11097,3.1
MT0612540000000,6,12540,"Bakersfield-Delano, CA MSA",2022,2,392835,364775,28060,7.1
MT0617020000000,6,17020,"Chico, CA MSA",2022,2,89858,85639,4219,4.7
MT0620940000000,6,20940,"El Centro, CA MSA",2022,2,67081,56991,10090,15
MT0623420000000,6,23420,"Fresno, CA MSA",2022,2,508786,474039,34747,6.8
MT0625260000000,6,25260,"Hanford-Corcoran, CA MSA",2022,2,54010,49957,4053,7.5
MT0631080000000,6,31080,"Los Angeles-Long Beach-Anaheim, CA MSA",2022,2,6633439,6285792,347647,5.2
MT0632900000000,6,32900,"Merced, CA MSA",2022,2,115021,105650,9371,8.1
MT0633700000000,6,33700,"Modesto, CA MSA",2022,2,244512,230647,13865,5.7
MT0634900000000,6,34900,"Napa, CA MSA",2022,2,70393,67847,2546,3.6
MT0637100000000,6,37100,"Oxnard-Thousand Oaks-Ventura, CA MSA",2022,2,412323,395457,16866,4.1
MT0639820000000,6,39820,"Redding, CA MSA",2022,2,76043,72572,3471,4.6
MT0640140000000,6,40140,"Riverside-San Bernardino-Ontario, CA MSA",2022,2,2139640,2037718,101922,4.8
MT0640900000000,6,40900,"Sacramento-Roseville-Folsom, CA MSA",2022,2,1135092,1088249,46843,4.1
MT0641500000000,6,41500,"Salinas, CA MSA",2022,2,214611,201413,13198,6.1
MT0641740000000,6,41740,"San Diego-Chula Vista-Carlsbad, CA MSA",2022,2,1602897,1540271,62626,3.9
MT0641860000000,6,41860,"San Francisco-Oakland-Fremont, CA MSA",2022,2,2491824,2404994,86830,3.5
MT0641940000000,6,41940,"San Jose-Sunnyvale-Santa Clara, CA MSA",2022,2,1035492,1002413,33079,3.2
MT0642020000000,6,42020,"San Luis Obispo-Paso Robles, CA MSA",2022,2,131236,126579,4657,3.5
MT0642100000000,6,42100,"Santa Cruz-Watsonville, CA MSA",2022,2,133447,126926,6521,4.9
MT0642200000000,6,42200,"Santa Maria-Santa Barbara, CA MSA",2022,2,217731,209447,8284,3.8
MT0642220000000,6,42220,"Santa Rosa-Petaluma, CA MSA",2022,2,244272,235666,8606,3.5
MT0644700000000,6,44700,"Stockton-Lodi, CA MSA",2022,2,355764,336322,19442,5.5
MT0646700000000,6,46700,"Vallejo, CA MSA",2022,2,209372,199652,9720,4.6
MT0647300000000,6,47300,"Visalia, CA MSA",2022,2,205972,189468,16504,8
MT0649700000000,6,49700,"Yuba City, CA MSA",2022,2,77603,72806,4797,6.2
MT0814500000000,8,14500,"Boulder, CO MSA",2022,2,191470,185561,5909,3.1
MT0817820000000,8,17820,"Colorado Springs, CO MSA",2022,2,380639,366625,14014,3.7
MT0819740000000,8,19740,"Denver-Aurora-Centennial, CO MSA",2022,2,1738213,1678437,59776,3.4
MT0822660000000,8,22660,"Fort Collins-Loveland, CO MSA",2022,2,201922,195232,6690,3.3
MT0824300000000,8,24300,"Grand Junction, CO MSA",2022,2,78343,75343,3000,3.8
MT0824540000000,8,24540,"Greeley, CO MSA",2022,2,169905,163412,6493,3.8
MT0839380000000,8,39380,"Pueblo, CO MSA",2022,2,74643,70654,3989,5.3
MT0914860000000,9,14860,"Bridgeport-Stamford-Danbury, CT MSA",2022,2,511178,489188,21990,4.3
MT0925540000000,9,25540,"Hartford-West Hartford-East Hartford, CT MSA",2022,2,617921,589341,28580,4.6
MT0935300000000,9,35300,"New Haven, CT MSA",2022,2,316774,302382,14392,4.5
MT0935980000000,9,35980,"Norwich-New London-Willimantic, CT MSA",2022,2,142682,135720,6962,4.9
MT0947930000000,9,47930,"Waterbury-Shelton, CT MSA",2022,2,243417,231259,12158,5
MT1020100000000,10,20100,"Dover, DE MSA",2022,2,85099,81056,4043,4.8
MT1147900000000,11,47900,"Washington-Arlington-Alexandria, DC-VA-MD-WV MSA",2022,2,3420735,3320677,100058,2.9
MT1215980000000,12,15980,"Cape Coral-Fort Myers, FL MSA",2022,2,357892,345616,12276,3.4
MT1218880000000,12,18880,"Crestview-Fort Walton Beach-Destin, FL MSA",2022,2,138092,134339,3753,2.7
MT1219660000000,12,19660,"Deltona-Daytona Beach-Ormond Beach, FL MSA",2022,2,306653,295365,11288,3.7
MT1223540000000,12,23540,"Gainesville, FL MSA",2022,2,164209,158767,5442,3.3
MT1226140000000,12,26140,"Homosassa Springs, FL MSA",2022,2,51853,49557,2296,4.4
MT1227260000000,12,27260,"Jacksonville, FL MSA",2022,2,822337,795684,26653,3.2
MT1229460000000,12,29460,"Lakeland-Winter Haven, FL MSA",2022,2,342069,328398,13671,4
MT1233100000000,12,33100,"Miami-Fort Lauderdale-West Palm Beach, FL MSA",2022,2,3150136,3048783,101353,3.2
MT1234940000000,12,34940,"Naples-Marco Island, FL MSA",2022,2,171570,165829,5741,3.3
MT1235840000000,12,35840,"North Port-Bradenton-Sarasota, FL MSA",2022,2,369740,357572,12168,3.3
MT1236100000000,12,36100,"Ocala, FL MSA",2022,2,150566,144812,5754,3.8
MT1236740000000,12,36740,"Orlando-Kissimmee-Sanford, FL MSA",2022,2,1433406,1384308,49098,3.4
MT1237340000000,12,37340,"Palm Bay-Melbourne-Titusville, FL MSA",2022,2,291945,282514,9431,3.2
MT1237460000000,12,37460,"Panama City-Panama City Beach, FL MSA",2022,2,96351,93295,3056,3.2
MT1237860000000,12,37860,"Pensacola-Ferry Pass-Brent, FL MSA",2022,2,233054,225323,7731,3.3
MT1238940000000,12,38940,"Port St. Lucie, FL MSA",2022,2,226914,218557,8357,3.7
MT1239460000000,12,39460,"Punta Gorda, FL MSA",2022,2,71284,68474,2810,3.9
MT1242680000000,12,42680,"Sebastian-Vero Beach-West Vero Corridor, FL MSA",2022,2,64889,62221,2668,4.1
MT1242700000000,12,42700,"Sebring, FL MSA",2022,2,35299,33651,1648,4.7
MT1245220000000,12,45220,"Tallahassee, FL MSA",2022,2,198182,191410,6772,3.4
MT1245300000000,12,45300,"Tampa-St. Petersburg-Clearwater, FL MSA",2022,2,1627199,1575193,52006,3.2
MT1248680000000,12,48680,"Wildwood-The Villages, FL MSA",2022,2,31165,29514,1651,5.3
MT1310500000000,13,10500,"Albany, GA MSA",2022,2,62941,60473,2468,3.9
MT1312020000000,13,12020,"Athens-Clarke County, GA MSA",2022,2,102277,99249,3028,3
MT1312060000000,13,12060,"Atlanta-Sandy Springs-Roswell, GA MSA",2022,2,3185546,3088736,96810,3
MT1312260000000,13,12260,"Augusta-Richmond County, GA-SC MSA",2022,2,264044,254809,9235,3.5
MT1315260000000,13,15260,"Brunswick-St. Simons, GA MSA",2022,2,52279,50696,1583,3
MT1317980000000,13,17980,"Columbus, GA-AL MSA",2022,2,130110,125543,4567,3.5
MT1319140000000,13,19140,"Dalton, GA MSA",2022,2,66586,64599,1987,3
MT1323580000000,13,23580,"Gainesville, GA MSA",2022,2,102481,99875,2606,2.5
MT1325980000000,13,25980,"Hinesville, GA MSA",2022,2,30719,29576,1143,3.7
MT1331420000000,13,31420,"Macon-Bibb County, GA MSA",2022,2,98435,94907,3528,3.6
MT1340660000000,13,40660,"Rome, GA MSA",2022,2,44112,42745,1367,3.1
MT1342340000000,13,42340,"Savannah, GA MSA",2022,2,204173,197996,6177,3
MT1346660000000,13,46660,"Valdosta, GA MSA",2022,2,61498,59463,2035,3.3
MT1347580000000,13,47580,"Warner Robins, GA MSA",2022,2,88654,85948,2706,3.1
MT1527980000000,15,27980,"Kahului-Wailuku, HI MSA",2022,2,82578,79814,2764,3.3
MT1546520000000,15,46520,"Urban Honolulu, HI MSA",2022,2,461993,448177,13816,3
MT1614260000000,16,14260,"Boise City, ID MSA",2022,2,419894,409226,10668,2.5
MT1617660000000,16,17660,"Coeur d'Alene, ID MSA",2022,2,86069,83283,2786,3.2
MT1626820000000,16,26820,"Idaho Falls, ID MSA",2022,2,79924,77988,1936,2.4
MT1630300000000,16,30300,"Lewiston, ID-WA MSA",2022,2,30331,29442,889,2.9
MT1638540000000,16,38540,"Pocatello, ID MSA",2022,2,38827,37632,1195,3.1
MT1646300000000,16,46300,"Twin Falls, ID MSA",2022,2,58701,57146,1555,2.6
MT1714010000000,17,14010,"Bloomington, IL MSA",2022,2,90753,87384,3369,3.7
MT1716580000000,17,16580,"Champaign-Urbana, IL MSA",2022,2,123297,118334,4963,4
MT1716980000000,17,16980,"Chicago-Naperville-Elgin, IL-IN MSA",2022,2,4857277,4635339,221938,4.6
MT1719340000000,17,19340,"Davenport-Moline-Rock Island, IA-IL MSA",2022,2,189427,182175,7252,3.8
MT1719500000000,17,19500,"Decatur, IL MSA",2022,2,45445,42611,2834,6.2
MT1728100000000,17,28100,"Kankakee, IL MSA",2022,2,50684,47843,2841,5.6
MT1737900000000,17,37900,"Peoria, IL MSA",2022,2,173424,165146,8278,4.8
MT1740420000000,17,40420,"Rockford, IL MSA",2022,2,161955,150926,11029,6.8
MT1744100000000,17,44100,"Springfield, IL MSA",2022,2,101644,96981,4663,4.6
MT1814020000000,18,14020,"Bloomington, IN MSA",2022,2,84213,82192,2021,2.4
MT1818020000000,18,18020,"Columbus, IN MSA",2022,2,38879,37924,955,2.5
MT1821140000000,18,21140,"Elkhart-Goshen, IN MSA",2022,2,107203,104745,2458,2.3
MT1821780000000,18,21780,"Evansville, IN MSA",2022,2,134406,130525,3881,2.9
MT1823060000000,18,23060,"Fort Wayne, IN MSA",2022,2,225184,219106,6078,2.7
MT1826900000000,18,26900,"Indianapolis-Carmel-Greenwood, IN MSA",2022,2,1092706,1062220,30486,2.8
MT1829020000000,18,29020,"Kokomo, IN MSA",2022,2,35965,34464,1501,4.2
MT1829200000000,18,29200,"Lafayette-West Lafayette, IN MSA",2022,2,116077,112921,3156,2.7
MT1833140000000,18,33140,"Michigan City-La Porte, IN MSA",2022,2,50392,48717,1675,3.3
MT1834620000000,18,34620,"Muncie, IN MSA",2022,2,51193,49440,1753,3.4
MT1843780000000,18,43780,"South Bend-Mishawaka, IN-MI MSA",2022,2,153428,148290,5138,3.3
MT1845460000000,18,45460,"Terre Haute, IN MSA",2022,2,76632,74203,2429,3.2
MT1911180000000,19,11180,"Ames, IA MSA",2022,2,68200,66701,1499,2.2
MT1916300000000,19,16300,"Cedar Rapids, IA MSA",2022,2,148469,144155,4314,2.9
MT1919780000000,19,19780,"Des Moines-West Des Moines, IA MSA",2022,2,394909,384612,10297,2.6
MT1920220000000,19,20220,"Dubuque, IA MSA",2022,2,53586,52056,1530,2.9
MT1926980000000,19,26980,"Iowa City, IA MSA",2022,2,98031,95738,2293,2.3
MT1943580000000,19,43580,"Sioux City, IA-NE-SD MSA",2022,2,76084,74157,1927,2.5
MT1947940000000,19,47940,"Waterloo-Cedar Falls, IA MSA",2022,2,88476,86052,2424,2.7
MT2029940000000,20,29940,"Lawrence, KS MSA",2022,2,68363,66781,1582,2.3
MT2031740000000,20,31740,"Manhattan, KS MSA",2022,2,62613,61071,1542,2.5
MT2045820000000,20,45820,"Topeka, KS MSA",2022,2,115841,112731,3110,2.7
MT2048620000000,20,48620,"Wichita, KS MSA",2022,2,323756,314058,9698,3
MT2114540000000,21,14540,"Bowling Green, KY MSA",2022,2,88195,85070,3125,3.5
MT2121060000000,21,21060,"Elizabethtown, KY MSA",2022,2,53579,51376,2203,4.1
MT2130460000000,21,30460,"Lexington-Fayette, KY MSA",2022,2,267467,259043,8424,3.1
MT2131140000000,21,31140,"Louisville/Jefferson County, KY-IN MSA",2022,2,688448,663111,25337,3.7
MT2136980000000,21,36980,"Owensboro, KY MSA",2022,2,51140,49356,1784,3.5
MT2137140000000,21,37140,"Paducah, KY-IL MSA",2022,2,45514,43635,1879,4.1
MT2210780000000,22,10780,"Alexandria, LA MSA",2022,2,65316,63221,2095,3.2
MT2212940000000,22,12940,"Baton Rouge, LA MSA",2022,2,421822,406524,15298,3.6
MT2225220000000,22,25220,"Hammond, LA MSA",2022,2,59212,56666,2546,4.3
MT2226380000000,22,26380,"Houma-Bayou Cane-Thibodaux, LA MSA",2022,2,85518,82187,3331,3.9
MT2229180000000,22,29180,"Lafayette, LA MSA",2022,2,195163,188933,6230,3.2
MT2229340000000,22,29340,"Lake Charles, LA MSA",2022,2,101094,97218,3876,3.8
MT2233740000000,22,33740,"Monroe, LA MSA",2022,2,96588,92756,3832,4
MT2235380000000,22,35380,"New Orleans-Metairie, LA MSA",2022,2,468509,448053,20456,4.4
MT2243340000000,22,43340,"Shreveport-Bossier City, LA MSA",2022,2,168391,161980,6411,3.8
MT2243640000000,22,43640,"Slidell-Mandeville-Covington, LA MSA",2022,2,124829,121281,3548,2.8
MT2312620000000,23,12620,"Bangor, ME MSA",2022,2,73182,70589,2593,3.5
MT2330340000000,23,30340,"Lewiston-Auburn, ME MSA",2022,2,54334,52484,1850,3.4
MT2338860000000,23,38860,"Portland-South Portland, ME MSA",2022,2,301683,293218,8465,2.8
MT2412580000000,24,12580,"Baltimore-Columbia-Towson, MD MSA",2022,2,1457656,1409991,47665,3.3
MT2425180000000,24,25180,"Hagerstown-Martinsburg, MD-WV MSA",2022,2,141182,136935,4247,3
MT2430500000000,24,30500,"Lexington Park, MD MSA",2022,2,105248,102114,3134,3
MT2441540000000,24,41540,"Salisbury, MD MSA",2022,2,60974,58765,2209,3.6
MT2511200000000,25,11200,"Amherst Town-Northampton, MA MSA",2022,2,84053,81129,2924,3.5
MT2512700000000,25,12700,"Barnstable Town, MA MSA",2022,2,112712,107458,5254,4.7
MT2514460000000,25,14460,"Boston-Cambridge-Newton, MA-NH MSA",2022,2,2728970,2638582,90388,3.3
MT2538340000000,25,38340,"Pittsfield, MA MSA",2022,2,63813,61121,2692,4.2
MT2544140000000,25,44140,"Springfield, MA MSA",2022,2,223348,212388,10960,4.9
MT2549340000000,25,49340,"Worcester, MA MSA",2022,2,452357,435044,17313,3.8
MT2611460000000,26,11460,"Ann Arbor, MI MSA",2022,2,197630,190691,6939,3.5
MT2612980000000,26,12980,"Battle Creek, MI MSA",2022,2,58994,56142,2852,4.8
MT2613020000000,26,13020,"Bay City, MI MSA",2022,2,47999,45608,2391,5
MT2619820000000,26,19820,"Detroit-Warren-Dearborn, MI MSA",2022,2,2124520,2031250,93270,4.4
MT2622420000000,26,22420,"Flint, MI MSA",2022,2,179204,169418,9786,5.5
MT2624340000000,26,24340,"Grand Rapids-Wyoming-Kentwood, MI MSA",2022,2,595448,574655,20793,3.5
MT2627100000000,26,27100,"Jackson, MI MSA",2022,2,72805,69477,3328,4.6
MT2628020000000,26,28020,"Kalamazoo-Portage, MI MSA",2022,2,133090,128117,4973,3.7
MT2629620000000,26,29620,"Lansing-East Lansing, MI MSA",2022,2,234992,225231,9761,4.2
MT2633220000000,26,33220,"Midland, MI MSA",2022,2,39636,38059,1577,4
MT2633780000000,26,33780,"Monroe, MI MSA",2022,2,74222,70639,3583,4.8
MT2634740000000,26,34740,"Muskegon-Norton Shores, MI MSA",2022,2,81105,77210,3895,4.8
MT2635660000000,26,35660,"Niles, MI MSA",2022,2,72854,69696,3158,4.3
MT2640980000000,26,40980,"Saginaw, MI MSA",2022,2,82981,78581,4400,5.3
MT2645900000000,26,45900,"Traverse City, MI MSA",2022,2,76898,73812,3086,4
MT2720260000000,27,20260,"Duluth, MN-WI MSA",2022,2,137998,133546,4452,3.2
MT2731860000000,27,31860,"Mankato, MN MSA",2022,2,58704,57448,1256,2.1
MT2733460000000,27,33460,"Minneapolis-St. Paul-Bloomington, MN-WI MSA",2022,2,2033908,1984828,49080,2.4
MT2740340000000,27,40340,"Rochester, MN MSA",2022,2,124069,121323,2746,2.2
MT2741060000000,27,41060,"St. Cloud, MN MSA",2022,2,107783,104797,2986,2.8
MT2825060000000,28,25060,"Gulfport-Biloxi, MS MSA",2022,2,185551,178543,7008,3.8
MT2825620000000,28,25620,"Hattiesburg, MS MSA",2022,2,70183,67604,2579,3.7
MT2827140000000,28,27140,"Jackson, MS MSA",2022,2,277028,266940,10088,3.6
MT2916020000000,29,16020,"Cape Girardeau, MO-IL MSA",2022,2,47608,46399,1209,2.5
MT2917860000000,29,17860,"Columbia, MO MSA",2022,2,111819,109397,2422,2.2
MT2927620000000,29,27620,"Jefferson City, MO MSA",2022,2,73252,71638,1614,2.2
MT2927900000000,29,27900,"Joplin, MO-KS MSA",2022,2,94664,92324,2340,2.5
MT2928140000000,29,28140,"Kansas City, MO-KS MSA",2022,2,1156123,1123468,32655,2.8
MT2941140000000,29,41140,"St. Joseph, MO-KS MSA",2022,2,54867,53393,1474,2.7
MT2941180000000,29,41180,"St. Louis, MO-IL MSA",2022,2,1448189,1403868,44321,3.1
MT2944180000000,29,44180,"Springfield, MO MSA",2022,2,233318,228026,5292,2.3
MT3013740000000,30,13740,"Billings, MT MSA",2022,2,98025,95645,2380,2.4
MT3014580000000,30,14580,"Bozeman, MT MSA",2022,2,73442,71997,1445,2
MT3024500000000,30,24500,"Great Falls, MT MSA",2022,2,39478,38490,988,2.5
MT3025740000000,30,25740,"Helena, MT MSA",2022,2,45791,44647,1144,2.5
MT3033540000000,30,33540,"Missoula, MT MSA",2022,2,71666,69857,1809,2.5
MT3124260000000,31,24260,"Grand Island, NE MSA",2022,2,41334,40485,849,2.1
MT3130700000000,31,30700,"Lincoln, NE MSA",2022,2,187943,184440,3503,1.9
MT3136540000000,31,36540,"Omaha, NE-IA MSA",2022,2,515183,503788,11395,2.2
MT3216180000000,32,16180,"Carson City, NV MSA",2022,2,27433,26452,981,3.6
MT3229820000000,32,29820,"Las Vegas-Henderson-North Las Vegas, NV MSA",2022,2,1116007,1052944,63063,5.7
MT3239900000000,32,39900,"Reno, NV MSA",2022,2,284719,274598,10121,3.6
MT3331700000000,33,31700,"Manchester-Nashua, NH MSA",2022,2,237322,231637,5685,2.4
MT3412100000000,34,12100,"Atlantic City-Hammonton, NJ MSA",2022,2,177020,165805,11215,6.3
MT3445940000000,34,45940,"Trenton-Princeton, NJ MSA",2022,2,193500,184902,8598,4.4
MT3447220000000,34,47220,"Vineland, NJ MSA",2022,2,64276,60105,4171,6.5
MT3510740000000,35,10740,"Albuquerque, NM MSA",2022,2,447557,427026,20531,4.6
MT3522140000000,35,22140,"Farmington, NM MSA",2022,2,48207,45362,2845,5.9
MT3529740000000,35,29740,"Las Cruces, NM MSA",2022,2,97481,92312,5169,5.3
MT3542140000000,35,42140,"Santa Fe, NM MSA",2022,2,72730,69416,3314,4.6
MT3610580000000,36,10580,"Albany-Schenectady-Troy, NY MSA",2022,2,451017,437338,13679,3
MT3613780000000,36,13780,"Binghamton, NY MSA",2022,2,106291,102533,3758,3.5
MT3615380000000,36,15380,"Buffalo-Cheektowaga, NY MSA",2022,2,556011,536150,19861,3.6
MT3621300000000,36,21300,"Elmira, NY MSA",2022,2,35993,34762,1231,3.4
MT3624020000000,36,24020,"Glens Falls, NY MSA",2022,2,59525,57648,1877,3.2
MT3627060000000,36,27060,"Ithaca, NY MSA",2022,2,49185,47784,1401,2.8
MT3628740000000,36,28740,"Kingston, NY MSA",2022,2,85821,82975,2846,3.3
MT3628880000000,36,28880,"Kiryas Joel-Poughkeepsie-Newburgh, NY MSA",2022,2,331183,320245,10938,3.3
MT3635620000000,36,35620,"New York-Newark-Jersey City, NY-NJ MSA",2022,2,9839678,9321467,518211,5.3
MT3640380000000,36,40380,"Rochester, NY MSA",2022,2,512360,495083,17277,3.4
MT3645060000000,36,45060,"Syracuse, NY MSA",2022,2,309079,298685,10394,3.4
MT3646540000000,36,46540,"Utica-Rome, NY MSA",2022,2,127491,123077,4414,3.5
MT3648060000000,36,48060,"Watertown-Fort Drum, NY MSA",2022,2,45018,43369,1649,3.7
MT3711700000000,37,11700,"Asheville, NC MSA",2022,2,207136,200781,6355,3.1
MT3715500000000,37,15500,"Burlington, NC MSA",2022,2,83112,80048,3064,3.7
MT3716740000000,37,16740,"Charlotte-Concord-Gastonia, NC-SC MSA",2022,2,1430162,1380300,49862,3.5
MT3720500000000,37,20500,"Durham-Chapel Hill, NC MSA",2022,2,312378,302455,9923,3.2
MT3722180000000,37,22180,"Fayetteville, NC MSA",2022,2,154038,146565,7473,4.9
MT3724140000000,37,24140,"Goldsboro, NC MSA",2022,2,49633,47645,1988,4
MT3724660000000,37,24660,"Greensboro-High Point, NC MSA",2022,2,374431,359566,14865,4
MT3724780000000,37,24780,"Greenville, NC MSA",2022,2,81711,78207,3504,4.3
MT3725860000000,37,25860,"Hickory-Lenoir-Morganton, NC MSA",2022,2,171550,165739,5811,3.4
MT3727340000000,37,27340,"Jacksonville, NC MSA",2022,2,71725,69025,2700,3.8
MT3738240000000,37,38240,"Pinehurst-Southern Pines, NC MSA",2022,2,42695,41167,1528,3.6
MT3739580000000,37,39580,"Raleigh-Cary, NC MSA",2022,2,798908,774501,24407,3.1
MT3740580000000,37,40580,"Rocky Mount, NC MSA",2022,2,64603,61121,3482,5.4
MT3748900000000,37,48900,"Wilmington, NC MSA",2022,2,212477,204690,7787,3.7
MT3749180000000,37,49180,"Winston-Salem, NC MSA",2022,2,323624,311856,11768,3.6
MT3813900000000,38,13900,"Bismarck, ND MSA",2022,2,72808,71388,1420,2
MT3822020000000,38,22020,"Fargo, ND-MN MSA",2022,2,148765,146080,2685,1.8
MT3824220000000,38,24220,"Grand Forks, ND-MN MSA",2022,2,54360,53187,1173,2.2
MT3833500000000,38,33500,"Minot, ND MSA",2022,2,39612,38769,843,2.1
MT3910420000000,39,10420,"Akron, OH MSA",2022,2,350770,337615,13155,3.8
MT3915940000000,39,15940,"Canton-Massillon, OH MSA",2022,2,189608,182333,7275,3.8
MT3917140000000,39,17140,"Cincinnati, OH-KY-IN MSA",2022,2,1143877,1105350,38527,3.4
MT3917410000000,39,17410,"Cleveland, OH MSA",2022,2,1069349,1017199,52150,4.9
MT3918140000000,39,18140,"Columbus, OH MSA",2022,2,1122986,1086709,36277,3.2
MT3919430000000,39,19430,"Dayton-Kettering-Beavercreek, OH MSA",2022,2,381087,367023,14064,3.7
MT3930620000000,39,30620,"Lima, OH MSA",2022,2,47282,45448,1834,3.9
MT3931900000000,39,31900,"Mansfield, OH MSA",2022,2,52437,50254,2183,4.2
MT3941780000000,39,41780,"Sandusky, OH MSA",2022,2,56736,53588,3148,5.5
MT3944220000000,39,44220,"Springfield, OH MSA",2022,2,61586,59075,2511,4.1
MT3945780000000,39,45780,"Toledo, OH MSA",2022,2,288827,277240,11587,4
MT3948260000000,39,48260,"Weirton-Steubenville, WV-OH MSA",2022,2,52830,50331,2499,4.7
MT3949660000000,39,49660,"Youngstown-Warren, OH MSA",2022,2,188722,180248,8474,4.5
MT4021420000000,40,21420,"Enid, OK MSA",2022,2,28769,28017,752,2.6
MT4030020000000,40,30020,"Lawton, OK MSA",2022,2,50568,48924,1644,3.3
MT4036420000000,40,36420,"Oklahoma City, OK MSA",2022,2,723057,703766,19291,2.7
MT4046140000000,40,46140,"Tulsa, OK MSA",2022,2,492335,477892,14443,2.9
MT4110540000000,41,10540,"Albany, OR MSA",2022,2,61457,58901,2556,4.2
MT4113460000000,41,13460,"Bend, OR MSA",2022,2,127262,122444,4818,3.8
MT4118700000000,41,18700,"Corvallis, OR MSA",2022,2,48260,46681,1579,3.3
MT4121660000000,41,21660,"Eugene-Springfield, OR MSA",2022,2,186433,178982,7451,4
MT4124420000000,41,24420,"Grants Pass, OR MSA",2022,2,35451,33675,1776,5
MT4132780000000,41,32780,"Medford, OR MSA",2022,2,105149,100773,4376,4.2
MT4138900000000,41,38900,"Portland-Vancouver-Hillsboro, OR-WA MSA",2022,2,1369234,1320297,48937,3.6
MT4141420000000,41,41420,"Salem, OR MSA",2022,2,214111,205973,8138,3.8
MT4210900000000,42,10900,"Allentown-Bethlehem-Easton, PA-NJ MSA",2022,2,440902,421795,19107,4.3
MT4211020000000,42,11020,"Altoona, PA MSA",2022,2,57178,54701,2477,4.3
MT4216540000000,42,16540,"Chambersburg, PA MSA",2022,2,76551,73855,2696,3.5
MT4221500000000,42,21500,"Erie, PA MSA",2022,2,125585,119636,5949,4.7
MT4223900000000,42,23900,"Gettysburg, PA MSA",2022,2,51767,50045,1722,3.3
MT4225420000000,42,25420,"Harrisburg-Carlisle, PA MSA",2022,2,304508,293458,11050,3.6
MT4227780000000,42,27780,"Johnstown, PA MSA",2022,2,56776,53987,2789,4.9
MT4229540000000,42,29540,"Lancaster, PA MSA",2022,2,287868,277949,9919,3.4
MT4230140000000,42,30140,"Lebanon, PA MSA",2022,2,70897,68241,2656,3.7
MT4237980000000,42,37980,"Philadelphia-Camden-Wilmington, PA-NJ-DE-MD MSA",2022,2,3199860,3063550,136310,4.3
MT4238300000000,42,38300,"Pittsburgh, PA MSA",2022,2,1218128,1166192,51936,4.3
MT4239740000000,42,39740,"Reading, PA MSA",2022,2,214308,205211,9097,4.2
MT4242540000000,42,42540,"Scranton--Wilkes-Barre, PA MSA",2022,2,276287,262270,14017,5.1
MT4244300000000,42,44300,"State College, PA MSA",2022,2,74742,72197,2545,3.4
MT4248700000000,42,48700,"Williamsport, PA MSA",2022,2,51885,49435,2450,4.7
MT4249620000000,42,49620,"York-Hanover, PA MSA",2022,2,235418,226719,8699,3.7
MT4439300000000,44,39300,"Providence-Warwick, RI-MA MSA",2022,2,870615,838213,32402,3.7
MT4516700000000,45,16700,"Charleston-North Charleston, SC MSA",2022,2,405364,393296,12068,3
MT4517900000000,45,17900,"Columbia, SC MSA",2022,2,399999,387202,12797,3.2
MT4522500000000,45,22500,"Florence, SC MSA",2022,2,89269,86010,3259,3.7
MT4524860000000,45,24860,"Greenville-Anderson-Greer, SC MSA",2022,2,454214,440986,13228,2.9
MT4525940000000,45,25940,"Hilton Head Island-Bluffton-Port Royal, SC MSA",2022,2,92586,89775,2811,3
MT4534820000000,45,34820,"Myrtle Beach-Conway-North Myrtle Beach, SC MSA",2022,2,157767,151692,6075,3.9
MT4543900000000,45,43900,"Spartanburg, SC MSA",2022,2,167423,161783,5640,3.4
MT4544940000000,45,44940,"Sumter, SC MSA",2022,2,42066,40481,1585,3.8
MT4639660000000,46,39660,"Rapid City, SD MSA",2022,2,77323,75880,1443,1.9
MT4643620000000,46,43620,"Sioux Falls, SD-MN MSA",2022,2,166930,164077,2853,1.7
MT4716860000000,47,16860,"Chattanooga, TN-GA MSA",2022,2,274890,265788,9102,3.3
MT4717300000000,47,17300,"Clarksville, TN-KY MSA",2022,2,134786,129801,4985,3.7
MT4717420000000,47,17420,"Cleveland, TN MSA",2022,2,57597,55538,2059,3.6
MT4727180000000,47,27180,"Jackson, TN MSA",2022,2,79037,76216,2821,3.6
MT4727740000000,47,27740,"Johnson City, TN MSA",2022,2,96868,93866,3002,3.1
MT4728700000000,47,28700,"Kingsport-Bristol, TN-VA MSA",2022,2,130397,126205,4192,3.2
MT4728940000000,47,28940,"Knoxville, TN MSA",2022,2,442191,428972,13219,3
MT4732820000000,47,32820,"Memphis, TN-MS-AR MSA",2022,2,641174,614209,26965,4.2
MT4734100000000,47,34100,"Morristown, TN MSA",2022,2,52916,51058,1858,3.5
MT4734980000000,47,34980,"Nashville-Davidson--Murfreesboro--Franklin, TN MSA",2022,2,1126350,1095137,31213,2.8
MT4810180000000,48,10180,"Abilene, TX MSA",2022,2,82278,79348,2930,3.6
MT4811100000000,48,11100,"Amarillo, TX MSA",2022,2,132648,128366,4282,3.2
MT4812420000000,48,12420,"Austin-Round Rock-San Marcos, TX MSA",2022,2,1369624,1327454,42170,3.1
MT4813140000000,48,13140,"Beaumont-Port Arthur, TX MSA",2022,2,169863,159490,10373,6.1
MT4815180000000,48,15180,"Brownsville-Harlingen, TX MSA",2022,2,180545,170016,10529,5.8
MT4817780000000,48,17780,"College Station-Bryan, TX MSA",2022,2,139758,134823,4935,3.5
MT4818580000000,48,18580,"Corpus Christi, TX MSA",2022,2,201460,190683,10777,5.3
MT4819100000000,48,19100,"Dallas-Fort Worth-Arlington, TX MSA",2022,2,4193830,4039639,154191,3.7
MT4820580000000,48,20580,"Eagle Pass, TX MSA",2022,2,23366,21375,1991,8.5
MT4821340000000,48,21340,"El Paso, TX MSA",2022,2,388021,371128,16893,4.4
MT4826420000000,48,26420,"Houston-Pasadena-The Woodlands, TX MSA",2022,2,3568817,3410160,158657,4.4
MT4828660000000,48,28660,"Killeen-Temple, TX MSA",2022,2,194462,186022,8440,4.3
MT4829700000000,48,29700,"Laredo, TX MSA",2022,2,111843,106679,5164,4.6
MT4830980000000,48,30980,"Longview, TX MSA",2022,2,125881,120078,5803,4.6
MT4831180000000,48,31180,"Lubbock, TX MSA",2022,2,177350,171047,6303,3.6
MT4832580000000,48,32580,"McAllen-Edinburg-Mission, TX MSA",2022,2,376388,351135,25253,6.7
MT4833260000000,48,33260,"Midland, TX MSA",2022,2,91611,88090,3521,3.8
MT4836220000000,48,36220,"Odessa, TX MSA",2022,2,78981,75303,3678,4.7
MT4841660000000,48,41660,"San Angelo, TX MSA",2022,2,58964,56919,2045,3.5
MT4841700000000,48,41700,"San Antonio-New Braunfels, TX MSA",2022,2,1253188,1205600,47588,3.8
MT4843300000000,48,43300,"Sherman-Denison, TX MSA",2022,2,66252,63756,2496,3.8
MT4845500000000,48,45500,"Texarkana, TX-AR MSA",2022,2,60484,57721,2763,4.6
MT4846340000000,48,46340,"Tyler, TX MSA",2022,2,111538,107168,4370,3.9
MT4847020000000,48,47020,"Victoria, TX MSA",2022,2,44739,42721,2018,4.5
MT4847380000000,48,47380,"Waco, TX MSA",2022,2,140252,134815,5437,3.9
MT4848660000000,48,48660,"Wichita Falls, TX MSA",2022,2,65655,63087,2568,3.9
MT4930860000000,49,30860,"Logan, UT-ID MSA",2022,2,78588,77028,1560,2
MT4936260000000,49,36260,"Ogden, UT MSA",2022,2,331354,324191,7163,2.2
MT4939340000000,49,39340,"Provo-Orem-Lehi, UT MSA",2022,2,349271,342080,7191,2.1
MT4941100000000,49,41100,"St. George, UT MSA",2022,2,85287,83112,2175,2.6
MT4941620000000,49,41620,"Salt Lake City-Murray, UT MSA",2022,2,697691,681687,16004,2.3
MT5015540000000,50,15540,"Burlington-South Burlington, VT MSA",2022,2,125954,123222,2732,2.2
MT5113980000000,51,13980,"Blacksburg-Christiansburg-Radford, VA MSA",2022,2,89462,87141,2321,2.6
MT5116820000000,51,16820,"Charlottesville, VA MSA",2022,2,113685,110955,2730,2.4
MT5125500000000,51,25500,"Harrisonburg, VA MSA",2022,2,70117,68439,1678,2.4
MT5131340000000,51,31340,"Lynchburg, VA MSA",2022,2,125992,122540,3452,2.7
MT5140060000000,51,40060,"Richmond, VA MSA",2022,2,690591,673003,17588,2.5
MT5140220000000,51,40220,"Roanoke, VA MSA",2022,2,151827,147867,3960,2.6
MT5144420000000,51,44420,"Staunton-Stuarts Draft, VA MSA",2022,2,62641,61182,1459,2.3
MT5147260000000,51,47260,"Virginia Beach-Chesapeake-Norfolk, VA-NC MSA",2022,2,850146,825136,25010,2.9
MT5149020000000,51,49020,"Winchester, VA-WV MSA",2022,2,73291,71599,1692,2.3
MT5313380000000,53,13380,"Bellingham, WA MSA",2022,2,114298,109717,4581,4
MT5314740000000,53,14740,"Bremerton-Silverdale-Port Orchard, WA MSA",2022,2,122237,117458,4779,3.9
MT5328420000000,53,28420,"Kennewick-Richland, WA MSA",2022,2,145256,138691,6565,4.5
MT5331020000000,53,31020,"Longview-Kelso, WA MSA",2022,2,47661,45421,2240,4.7
MT5334580000000,53,34580,"Mount Vernon-Anacortes, WA MSA",2022,2,58580,55895,2685,4.6
MT5336500000000,53,36500,"Olympia-Lacey-Tumwater, WA MSA",2022,2,139713,134049,5664,4.1
MT5342660000000,53,42660,"Seattle-Tacoma-Bellevue, WA MSA",2022,2,2215836,2136280,79556,3.6
MT5344060000000,53,44060,"Spokane-Spokane Valley, WA MSA",2022,2,281278,270187,11091,3.9
MT5347460000000,53,47460,"Walla Walla, WA MSA",2022,2,29628,28486,1142,3.9
MT5348300000000,53,48300,"Wenatchee-East Wenatchee, WA MSA",2022,2,62358,59667,2691,4.3
MT5349420000000,53,49420,"Yakima, WA MSA",2022,2,127133,120442,6691,5.3
MT5413220000000,54,13220,"Beckley, WV MSA",2022,2,45064,43336,1728,3.8
MT5416620000000,54,16620,"Charleston, WV MSA",2022,2,89882,86393,3489,3.9
MT5426580000000,54,26580,"Huntington-Ashland, WV-KY-OH MSA",2022,2,155514,148900,6614,4.3
MT5434060000000,54,34060,"Morgantown, WV MSA",2022,2,71008,68407,2601,3.7
MT5437620000000,54,37620,"Parkersburg-Vienna, WV MSA",2022,2,39031,37420,1611,4.1
MT5448540000000,54,48540,"Wheeling, WV-OH MSA",2022,2,59564,56850,2714,4.6
MT5511540000000,55,11540,"Appleton, WI MSA",2022,2,134582,131403,3179,2.4
MT5520740000000,55,20740,"Eau Claire, WI MSA",2022,2,92870,90292,2578,2.8
MT5522540000000,55,22540,"Fond du Lac, WI MSA",2022,2,56579,55150,1429,2.5
MT5524580000000,55,24580,"Green Bay, WI MSA",2022,2,175362,170792,4570,2.6
MT5527500000000,55,27500,"Janesville-Beloit, WI MSA",2022,2,83981,81020,2961,3.5
MT5528450000000,55,28450,"Kenosha, WI MSA",2022,2,92956,89924,3032,3.3
MT5529100000000,55,29100,"La Crosse-Onalaska, WI-MN MSA",2022,2,88191,85985,2206,2.5
MT5531540000000,55,31540,"Madison, WI MSA",2022,2,393155,384434,8721,2.2
MT5533340000000,55,33340,"Milwaukee-Waukesha, WI MSA",2022,2,807790,781740,26050,3.2
MT5536780000000,55,36780,"Oshkosh-Neenah, WI MSA",2022,2,91491,89228,2263,2.5
MT5539540000000,55,39540,"Racine-Mount Pleasant, WI MSA",2022,2,99743,96239,3504,3.5
MT5543100000000,55,43100,"Sheboygan, WI MSA",2022,2,62088,60598,1490,2.4
MT5548140000000,55,48140,"Wausau, WI MSA",2022,2,74712,72915,1797,2.4
MT5616220000000,56,16220,"Casper, WY MSA",2022,2,40615,39021,1594,3.9
MT5616940000000,56,16940,"Cheyenne, WY MSA",2022,2,47901,46264,1637,3.4
MT7210380000000,72,10380,"Aguadilla, PR MSA",2022,2,85819,79415,6404,7.5
MT7211640000000,72,11640,"Arecibo, PR MSA",2022,2,65249,60280,4969,7.6
MT7225020000000,72,25020,"Guayama, PR MSA",2022,2,19339,17739,1600,8.3
MT7232420000000,72,32420,"Mayaguez, PR MSA",2022,2,66710,61485,5225,7.8
MT7238660000000,72,38660,"Ponce, PR MSA",2022,2,88976,81459,7517,8.4
MT7241980000000,72,41980,"San Juan-Bayamon-Caguas, PR MSA",2022,2,814707,769627,45080,5.5
MT0111500000000,1,11500,"Anniston-Oxford, AL MSA",2022,3,49479,48066,1413,2.9
MT0112220000000,1,12220,"Auburn-Opelika, AL MSA",2022,3,91944,89754,2190,2.4
MT0113820000000,1,13820,"Birmingham, AL MSA",2022,3,558476,545151,13325,2.4
MT0119300000000,1,19300,"Daphne-Fairhope-Foley, AL MSA",2022,3,110323,107956,2367,2.1
MT0119460000000,1,19460,"Decatur, AL MSA",2022,3,72407,70859,1548,2.1
MT0120020000000,1,20020,"Dothan, AL MSA",2022,3,66398,64762,1636,2.5
MT0122520000000,1,22520,"Florence-Muscle Shoals, AL MSA",2022,3,67503,65715,1788,2.6
MT0123460000000,1,23460,"Gadsden, AL MSA",2022,3,41324,40177,1147,2.8
MT0126620000000,1,26620,"Huntsville, AL MSA",2022,3,255348,250181,5167,2
MT0133660000000,1,33660,"Mobile, AL MSA",2022,3,183429,177395,6034,3.3
MT0133860000000,1,33860,"Montgomery, AL MSA",2022,3,172068,167195,4873,2.8
MT0146220000000,1,46220,"Tuscaloosa, AL MSA",2022,3,120441,117144,3297,2.7
MT0211260000000,2,11260,"Anchorage, AK MSA",2022,3,198749,190217,8532,4.3
MT0221820000000,2,21820,"Fairbanks-College, AK MSA",2022,3,44819,42952,1867,4.2
MT0422380000000,4,22380,"Flagstaff, AZ MSA",2022,3,72056,68963,3093,4.3
MT0429420000000,4,29420,"Lake Havasu City-Kingman, AZ MSA",2022,3,85411,81570,3841,4.5
MT0438060000000,4,38060,"Phoenix-Mesa-Chandler, AZ MSA",2022,3,2566608,2483383,83225,3.2
MT0439150000000,4,39150,"Prescott Valley-Prescott, AZ MSA",2022,3,102075,98587,3488,3.4
MT0443420000000,4,43420,"Sierra Vista-Douglas, AZ MSA",2022,3,47374,45332,2042,4.3
MT0446060000000,4,46060,"Tucson, AZ MSA",2022,3,487354,469500,17854,3.7
MT0449740000000,4,49740,"Yuma, AZ MSA",2022,3,96263,84446,11817,12.3
MT0522220000000,5,22220,"Fayetteville-Springdale-Rogers, AR MSA",2022,3,286170,279310,6860,2.4
MT0522900000000,5,22900,"Fort Smith, AR-OK MSA",2022,3,100145,97134,3011,3
MT0526300000000,5,26300,"Hot Springs, AR MSA",2022,3,43614,42090,1524,3.5
MT0527860000000,5,27860,"Jonesboro, AR MSA",2022,3,64167,62362,1805,2.8
MT0530780000000,5,30780,"Little Rock-North Little Rock-Conway, AR MSA",2022,3,363084,351901,11183,3.1
MT0612540000000,6,12540,"Bakersfield-Delano, CA MSA",2022,3,391999,364945,27054,6.9
MT0617020000000,6,17020,"Chico, CA MSA",2022,3,89847,85793,4054,4.5
MT0620940000000,6,20940,"El Centro, CA MSA",2022,3,67129,57171,9958,14.8
MT0623420000000,6,23420,"Fresno, CA MSA",2022,3,508830,475076,33754,6.6
MT0625260000000,6,25260,"Hanford-Corcoran, CA MSA",2022,3,54111,50176,3935,7.3
MT0631080000000,6,31080,"Los Angeles-Long Beach-Anaheim, CA MSA",2022,3,6627853,6299053,328800,5
MT0632900000000,6,32900,"Merced, CA MSA",2022,3,115018,105889,9129,7.9
MT0633700000000,6,33700,"Modesto, CA MSA",2022,3,244669,231417,13252,5.4
MT0634900000000,6,34900,"Napa, CA MSA",2022,3,70551,68127,2424,3.4
MT0637100000000,6,37100,"Oxnard-Thousand Oaks-Ventura, CA MSA",2022,3,412389,396243,16146,3.9
MT0639820000000,6,39820,"Redding, CA MSA",2022,3,76030,72691,3339,4.4
MT0640140000000,6,40140,"Riverside-San Bernardino-Ontario, CA MSA",2022,3,2140567,2044458,96109,4.5
MT0640900000000,6,40900,"Sacramento-Roseville-Folsom, CA MSA",2022,3,1135711,1091369,44342,3.9
MT0641500000000,6,41500,"Salinas, CA MSA",2022,3,215011,202158,12853,6
MT0641740000000,6,41740,"San Diego-Chula Vista-Carlsbad, CA MSA",2022,3,1604947,1545986,58961,3.7
MT0641860000000,6,41860,"San Francisco-Oakland-Fremont, CA MSA",2022,3,2494569,2413025,81544,3.3
MT0641940000000,6,41940,"San Jose-Sunnyvale-Santa Clara, CA MSA",2022,3,1037561,1006271,31290,3
MT0642020000000,6,42020,"San Luis Obispo-Paso Robles, CA MSA",2022,3,131286,126825,4461,3.4
MT0642100000000,6,42100,"Santa Cruz-Watsonville, CA MSA",2022,3,133483,127172,6311,4.7
MT0642200000000,6,42200,"Santa Maria-Santa Barbara, CA MSA",2022,3,217864,209836,8028,3.7
MT0642220000000,6,42220,"Santa Rosa-Petaluma, CA MSA",2022,3,244548,236350,8198,3.4
MT0644700000000,6,44700,"Stockton-Lodi, CA MSA",2022,3,356147,337608,18539,5.2
MT0646700000000,6,46700,"Vallejo, CA MSA",2022,3,209391,200258,9133,4.4
MT0647300000000,6,47300,"Visalia, CA MSA",2022,3,206623,190426,16197,7.8
MT0649700000000,6,49700,"Yuba City, CA MSA",2022,3,77655,73028,4627,6
MT0814500000000,8,14500,"Boulder, CO MSA",2022,3,191593,185999,5594,2.9
MT0817820000000,8,17820,"Colorado Springs, CO MSA",2022,3,380527,367438,13089,3.4
MT0819740000000,8,19740,"Denver-Aurora-Centennial, CO MSA",2022,3,1737637,1681902,55735,3.2
MT0822660000000,8,22660,"Fort Collins-Loveland, CO MSA",2022,3,201886,195572,6314,3.1
MT0824300000000,8,24300,"Grand Junction, CO MSA",2022,3,78251,75440,2811,3.6
MT0824540000000,8,24540,"Greeley, CO MSA",2022,3,169713,163619,6094,3.6
MT0839380000000,8,39380,"Pueblo, CO MSA",2022,3,74444,70759,3685,5
MT0914860000000,9,14860,"Bridgeport-Stamford-Danbury, CT MSA",2022,3,511599,490275,21324,4.2
MT0925540000000,9,25540,"Hartford-West Hartford-East Hartford, CT MSA",2022,3,617249,589626,27623,4.5
MT0935300000000,9,35300,"New Haven, CT MSA",2022,3,316962,303074,13888,4.4
MT0935980000000,9,35980,"Norwich-New London-Willimantic, CT MSA",2022,3,142588,135904,6684,4.7
MT0947930000000,9,47930,"Waterbury-Shelton, CT MSA",2022,3,243034,231305,11729,4.8
MT1020100000000,10,20100,"Dover, DE MSA",2022,3,85045,81051,3994,4.7
MT1147900000000,11,47900,"Washington-Arlington-Alexandria, DC-VA-MD-WV MSA",2022,3,3427429,3329103,98326,2.9
MT1215980000000,12,15980,"Cape Coral-Fort Myers, FL MSA",2022,3,358941,347012,11929,3.3
MT1218880000000,12,18880,"Crestview-Fort Walton Beach-Destin, FL MSA",2022,3,138269,134563,3706,2.7
MT1219660000000,12,19660,"Deltona-Daytona Beach-Ormond Beach, FL MSA",2022,3,306743,295774,10969,3.6
MT1223540000000,12,23540,"Gainesville, FL MSA",2022,3,164287,158922,5365,3.3
MT1226140000000,12,26140,"Homosassa Springs, FL MSA",2022,3,52012,49767,2245,4.3
MT1227260000000,12,27260,"Jacksonville, FL MSA",2022,3,823710,797711,25999,3.2
MT1229460000000,12,29460,"Lakeland-Winter Haven, FL MSA",2022,3,342749,329449,13300,3.9
MT1233100000000,12,33100,"Miami-Fort Lauderdale-West Palm Beach, FL MSA",2022,3,3158939,3061154,97785,3.1
MT1234940000000,12,34940,"Naples-Marco Island, FL MSA",2022,3,172423,166755,5668,3.3
MT1235840000000,12,35840,"North Port-Bradenton-Sarasota, FL MSA",2022,3,370548,358622,11926,3.2
MT1236100000000,12,36100,"Ocala, FL MSA",2022,3,150841,145219,5622,3.7
MT1236740000000,12,36740,"Orlando-Kissimmee-Sanford, FL MSA",2022,3,1438777,1391654,47123,3.3
MT1237340000000,12,37340,"Palm Bay-Melbourne-Titusville, FL MSA",2022,3,292276,283050,9226,3.2
MT1237460000000,12,37460,"Panama City-Panama City Beach, FL MSA",2022,3,96513,93517,2996,3.1
MT1237860000000,12,37860,"Pensacola-Ferry Pass-Brent, FL MSA",2022,3,233481,225961,7520,3.2
MT1238940000000,12,38940,"Port St. Lucie, FL MSA",2022,3,227477,219304,8173,3.6
MT1239460000000,12,39460,"Punta Gorda, FL MSA",2022,3,71480,68736,2744,3.8
MT1242680000000,12,42680,"Sebastian-Vero Beach-West Vero Corridor, FL MSA",2022,3,65116,62508,2608,4
MT1242700000000,12,42700,"Sebring, FL MSA",2022,3,35394,33782,1612,4.6
MT1245220000000,12,45220,"Tallahassee, FL MSA",2022,3,198762,192155,6607,3.3
MT1245300000000,12,45300,"Tampa-St. Petersburg-Clearwater, FL MSA",2022,3,1630970,1580566,50404,3.1
MT1248680000000,12,48680,"Wildwood-The Villages, FL MSA",2022,3,31377,29755,1622,5.2
MT1310500000000,13,10500,"Albany, GA MSA",2022,3,63013,60568,2445,3.9
MT1312020000000,13,12020,"Athens-Clarke County, GA MSA",2022,3,102305,99283,3022,3
MT1312060000000,13,12060,"Atlanta-Sandy Springs-Roswell, GA MSA",2022,3,3187886,3091937,95949,3
MT1312260000000,13,12260,"Augusta-Richmond County, GA-SC MSA",2022,3,264195,254910,9285,3.5
MT1315260000000,13,15260,"Brunswick-St. Simons, GA MSA",2022,3,52277,50694,1583,3
MT1317980000000,13,17980,"Columbus, GA-AL MSA",2022,3,129812,125259,4553,3.5
MT1319140000000,13,19140,"Dalton, GA MSA",2022,3,66691,64593,2098,3.1
MT1323580000000,13,23580,"Gainesville, GA MSA",2022,3,102836,100238,2598,2.5
MT1325980000000,13,25980,"Hinesville, GA MSA",2022,3,30713,29563,1150,3.7
MT1331420000000,13,31420,"Macon-Bibb County, GA MSA",2022,3,98293,94789,3504,3.6
MT1340660000000,13,40660,"Rome, GA MSA",2022,3,44306,42930,1376,3.1
MT1342340000000,13,42340,"Savannah, GA MSA",2022,3,204212,198100,6112,3
MT1346660000000,13,46660,"Valdosta, GA MSA",2022,3,61488,59460,2028,3.3
MT1347580000000,13,47580,"Warner Robins, GA MSA",2022,3,88642,85939,2703,3
MT1527980000000,15,27980,"Kahului-Wailuku, HI MSA",2022,3,82626,79855,2771,3.4
MT1546520000000,15,46520,"Urban Honolulu, HI MSA",2022,3,463358,449130,14228,3.1
MT1614260000000,16,14260,"Boise City, ID MSA",2022,3,421090,410386,10704,2.5
MT1617660000000,16,17660,"Coeur d'Alene, ID MSA",2022,3,86062,83265,2797,3.2
MT1626820000000,16,26820,"Idaho Falls, ID MSA",2022,3,80178,78206,1972,2.5
MT1630300000000,16,30300,"Lewiston, ID-WA MSA",2022,3,30352,29452,900,3
MT1638540000000,16,38540,"Pocatello, ID MSA",2022,3,38922,37710,1212,3.1
MT1646300000000,16,46300,"Twin Falls, ID MSA",2022,3,58879,57306,1573,2.7
MT1714010000000,17,14010,"Bloomington, IL MSA",2022,3,90986,87598,3388,3.7
MT1716580000000,17,16580,"Champaign-Urbana, IL MSA",2022,3,123343,118383,4960,4
MT1716980000000,17,16980,"Chicago-Naperville-Elgin, IL-IN MSA",2022,3,4863406,4640293,223113,4.6
MT1719340000000,17,19340,"Davenport-Moline-Rock Island, IA-IL MSA",2022,3,189460,182201,7259,3.8
MT1719500000000,17,19500,"Decatur, IL MSA",2022,3,45370,42581,2789,6.1
MT1728100000000,17,28100,"Kankakee, IL MSA",2022,3,50751,47926,2825,5.6
MT1737900000000,17,37900,"Peoria, IL MSA",2022,3,173394,165129,8265,4.8
MT1740420000000,17,40420,"Rockford, IL MSA",2022,3,161521,150788,10733,6.6
MT1744100000000,17,44100,"Springfield, IL MSA",2022,3,101744,97099,4645,4.6
MT1814020000000,18,14020,"Bloomington, IN MSA",2022,3,84212,82147,2065,2.5
MT1818020000000,18,18020,"Columbus, IN MSA",2022,3,39066,38093,973,2.5
MT1821140000000,18,21140,"Elkhart-Goshen, IN MSA",2022,3,107644,105093,2551,2.4
MT1821780000000,18,21780,"Evansville, IN MSA",2022,3,134685,130780,3905,2.9
MT1823060000000,18,23060,"Fort Wayne, IN MSA",2022,3,225914,219743,6171,2.7
MT1826900000000,18,26900,"Indianapolis-Carmel-Greenwood, IN MSA",2022,3,1094451,1063777,30674,2.8
MT1829020000000,18,29020,"Kokomo, IN MSA",2022,3,35898,34401,1497,4.2
MT1829200000000,18,29200,"Lafayette-West Lafayette, IN MSA",2022,3,116268,113101,3167,2.7
MT1833140000000,18,33140,"Michigan City-La Porte, IN MSA",2022,3,50403,48720,1683,3.3
MT1834620000000,18,34620,"Muncie, IN MSA",2022,3,51269,49493,1776,3.5
MT1843780000000,18,43780,"South Bend-Mishawaka, IN-MI MSA",2022,3,153881,148645,5236,3.4
MT1845460000000,18,45460,"Terre Haute, IN MSA",2022,3,76778,74330,2448,3.2
MT1911180000000,19,11180,"Ames, IA MSA",2022,3,68384,66921,1463,2.1
MT1916300000000,19,16300,"Cedar Rapids, IA MSA",2022,3,148705,144457,4248,2.9
MT1919780000000,19,19780,"Des Moines-West Des Moines, IA MSA",2022,3,395941,385767,10174,2.6
MT1920220000000,19,20220,"Dubuque, IA MSA",2022,3,53690,52198,1492,2.8
MT1926980000000,19,26980,"Iowa City, IA MSA",2022,3,98190,95931,2259,2.3
MT1943580000000,19,43580,"Sioux City, IA-NE-SD MSA",2022,3,76203,74294,1909,2.5
MT1947940000000,19,47940,"Waterloo-Cedar Falls, IA MSA",2022,3,88654,86298,2356,2.7
MT2029940000000,20,29940,"Lawrence, KS MSA",2022,3,68397,66809,1588,2.3
MT2031740000000,20,31740,"Manhattan, KS MSA",2022,3,62717,61152,1565,2.5
MT2045820000000,20,45820,"Topeka, KS MSA",2022,3,115965,112797,3168,2.7
MT2048620000000,20,48620,"Wichita, KS MSA",2022,3,323951,314295,9656,3
MT2114540000000,21,14540,"Bowling Green, KY MSA",2022,3,88175,85040,3135,3.6
MT2121060000000,21,21060,"Elizabethtown, KY MSA",2022,3,53573,51357,2216,4.1
MT2130460000000,21,30460,"Lexington-Fayette, KY MSA",2022,3,267591,259162,8429,3.1
MT2131140000000,21,31140,"Louisville/Jefferson County, KY-IN MSA",2022,3,687982,663410,24572,3.6
MT2136980000000,21,36980,"Owensboro, KY MSA",2022,3,51094,49274,1820,3.6
MT2137140000000,21,37140,"Paducah, KY-IL MSA",2022,3,45564,43668,1896,4.2
MT2210780000000,22,10780,"Alexandria, LA MSA",2022,3,65380,63282,2098,3.2
MT2212940000000,22,12940,"Baton Rouge, LA MSA",2022,3,421812,406613,15199,3.6
MT2225220000000,22,25220,"Hammond, LA MSA",2022,3,59291,56776,2515,4.2
MT2226380000000,22,26380,"Houma-Bayou Cane-Thibodaux, LA MSA",2022,3,85772,82551,3221,3.8
MT2229180000000,22,29180,"Lafayette, LA MSA",2022,3,195471,189272,6199,3.2
MT2229340000000,22,29340,"Lake Charles, LA MSA",2022,3,100585,96741,3844,3.8
MT2233740000000,22,33740,"Monroe, LA MSA",2022,3,96608,92780,3828,4
MT2235380000000,22,35380,"New Orleans-Metairie, LA MSA",2022,3,468999,449081,19918,4.2
MT2243340000000,22,43340,"Shreveport-Bossier City, LA MSA",2022,3,168636,162247,6389,3.8
MT2243640000000,22,43640,"Slidell-Mandeville-Covington, LA MSA",2022,3,125348,121791,3557,2.8
MT2312620000000,23,12620,"Bangor, ME MSA",2022,3,73038,70638,2400,3.3
MT2330340000000,23,30340,"Lewiston-Auburn, ME MSA",2022,3,54130,52429,1701,3.1
MT2338860000000,23,38860,"Portland-South Portland, ME MSA",2022,3,301231,293339,7892,2.6
MT2412580000000,24,12580,"Baltimore-Columbia-Towson, MD MSA",2022,3,1457265,1410968,46297,3.2
MT2425180000000,24,25180,"Hagerstown-Martinsburg, MD-WV MSA",2022,3,141306,137070,4236,3
MT2430500000000,24,30500,"Lexington Park, MD MSA",2022,3,105025,101953,3072,2.9
MT2441540000000,24,41540,"Salisbury, MD MSA",2022,3,61268,59067,2201,3.6
MT2511200000000,25,11200,"Amherst Town-Northampton, MA MSA",2022,3,84165,81248,2917,3.5
MT2512700000000,25,12700,"Barnstable Town, MA MSA",2022,3,112818,107598,5220,4.6
MT2514460000000,25,14460,"Boston-Cambridge-Newton, MA-NH MSA",2022,3,2729704,2640444,89260,3.3
MT2538340000000,25,38340,"Pittsfield, MA MSA",2022,3,63834,61189,2645,4.1
MT2544140000000,25,44140,"Springfield, MA MSA",2022,3,223201,212444,10757,4.8
MT2549340000000,25,49340,"Worcester, MA MSA",2022,3,452417,435359,17058,3.8
MT2611460000000,26,11460,"Ann Arbor, MI MSA",2022,3,198400,191391,7009,3.5
MT2612980000000,26,12980,"Battle Creek, MI MSA",2022,3,59130,56319,2811,4.8
MT2613020000000,26,13020,"Bay City, MI MSA",2022,3,48133,45729,2404,5
MT2619820000000,26,19820,"Detroit-Warren-Dearborn, MI MSA",2022,3,2123710,2033867,89843,4.2
MT2622420000000,26,22420,"Flint, MI MSA",2022,3,179517,169833,9684,5.4
MT2624340000000,26,24340,"Grand Rapids-Wyoming-Kentwood, MI MSA",2022,3,597408,576476,20932,3.5
MT2627100000000,26,27100,"Jackson, MI MSA",2022,3,73075,69753,3322,4.5
MT2628020000000,26,28020,"Kalamazoo-Portage, MI MSA",2022,3,133626,128634,4992,3.7
MT2629620000000,26,29620,"Lansing-East Lansing, MI MSA",2022,3,236650,226598,10052,4.2
MT2633220000000,26,33220,"Midland, MI MSA",2022,3,39784,38180,1604,4
MT2633780000000,26,33780,"Monroe, MI MSA",2022,3,74643,70996,3647,4.9
MT2634740000000,26,34740,"Muskegon-Norton Shores, MI MSA",2022,3,81266,77441,3825,4.7
MT2635660000000,26,35660,"Niles, MI MSA",2022,3,73054,69904,3150,4.3
MT2640980000000,26,40980,"Saginaw, MI MSA",2022,3,83085,78669,4416,5.3
MT2645900000000,26,45900,"Traverse City, MI MSA",2022,3,77244,74146,3098,4
MT2720260000000,27,20260,"Duluth, MN-WI MSA",2022,3,137780,133430,4350,3.2
MT2731860000000,27,31860,"Mankato, MN MSA",2022,3,58644,57453,1191,2
MT2733460000000,27,33460,"Minneapolis-St. Paul-Bloomington, MN-WI MSA",2022,3,2035326,1988569,46757,2.3
MT2740340000000,27,40340,"Rochester, MN MSA",2022,3,123989,121350,2639,2.1
MT2741060000000,27,41060,"St. Cloud, MN MSA",2022,3,107767,104912,2855,2.6
MT2825060000000,28,25060,"Gulfport-Biloxi, MS MSA",2022,3,185026,178114,6912,3.7
MT2825620000000,28,25620,"Hattiesburg, MS MSA",2022,3,70130,67580,2550,3.6
MT2827140000000,28,27140,"Jackson, MS MSA",2022,3,276733,266785,9948,3.6
MT2916020000000,29,16020,"Cape Girardeau, MO-IL MSA",2022,3,47649,46501,1148,2.4
MT2917860000000,29,17860,"Columbia, MO MSA",2022,3,112002,109710,2292,2
MT2927620000000,29,27620,"Jefferson City, MO MSA",2022,3,73325,71803,1522,2.1
MT2927900000000,29,27900,"Joplin, MO-KS MSA",2022,3,94756,92527,2229,2.4
MT2928140000000,29,28140,"Kansas City, MO-KS MSA",2022,3,1155557,1124214,31343,2.7
MT2941140000000,29,41140,"St. Joseph, MO-KS MSA",2022,3,54668,53266,1402,2.6
MT2941180000000,29,41180,"St. Louis, MO-IL MSA",2022,3,1446817,1404560,42257,2.9
MT2944180000000,29,44180,"Springfield, MO MSA",2022,3,233423,228410,5013,2.1
MT3013740000000,30,13740,"Billings, MT MSA",2022,3,98485,96077,2408,2.4
MT3014580000000,30,14580,"Bozeman, MT MSA",2022,3,73771,72305,1466,2
MT3024500000000,30,24500,"Great Falls, MT MSA",2022,3,39621,38597,1024,2.6
MT3025740000000,30,25740,"Helena, MT MSA",2022,3,45927,44762,1165,2.5
MT3033540000000,30,33540,"Missoula, MT MSA",2022,3,71842,70005,1837,2.6
MT3124260000000,31,24260,"Grand Island, NE MSA",2022,3,41436,40578,858,2.1
MT3130700000000,31,30700,"Lincoln, NE MSA",2022,3,188124,184562,3562,1.9
MT3136540000000,31,36540,"Omaha, NE-IA MSA",2022,3,515294,503922,11372,2.2
MT3216180000000,32,16180,"Carson City, NV MSA",2022,3,27556,26519,1037,3.8
MT3229820000000,32,29820,"Las Vegas-Henderson-North Las Vegas, NV MSA",2022,3,1123107,1059778,63329,5.6
MT3239900000000,32,39900,"Reno, NV MSA",2022,3,285852,275235,10617,3.7
MT3331700000000,33,31700,"Manchester-Nashua, NH MSA",2022,3,237736,232145,5591,2.4
MT3412100000000,34,12100,"Atlantic City-Hammonton, NJ MSA",2022,3,177061,166471,10590,6
MT3445940000000,34,45940,"Trenton-Princeton, NJ MSA",2022,3,193838,185807,8031,4.1
MT3447220000000,34,47220,"Vineland, NJ MSA",2022,3,64449,60505,3944,6.1
MT3510740000000,35,10740,"Albuquerque, NM MSA",2022,3,447422,428006,19416,4.3
MT3522140000000,35,22140,"Farmington, NM MSA",2022,3,48069,45402,2667,5.5
MT3529740000000,35,29740,"Las Cruces, NM MSA",2022,3,97322,92383,4939,5.1
MT3542140000000,35,42140,"Santa Fe, NM MSA",2022,3,72817,69691,3126,4.3
MT3610580000000,36,10580,"Albany-Schenectady-Troy, NY MSA",2022,3,451385,437677,13708,3
MT3613780000000,36,13780,"Binghamton, NY MSA",2022,3,106188,102379,3809,3.6
MT3615380000000,36,15380,"Buffalo-Cheektowaga, NY MSA",2022,3,556826,536913,19913,3.6
MT3621300000000,36,21300,"Elmira, NY MSA",2022,3,35984,34753,1231,3.4
MT3624020000000,36,24020,"Glens Falls, NY MSA",2022,3,59581,57676,1905,3.2
MT3627060000000,36,27060,"Ithaca, NY MSA",2022,3,49283,47883,1400,2.8
MT3628740000000,36,28740,"Kingston, NY MSA",2022,3,85934,83091,2843,3.3
MT3628880000000,36,28880,"Kiryas Joel-Poughkeepsie-Newburgh, NY MSA",2022,3,331849,320904,10945,3.3
MT3635620000000,36,35620,"New York-Newark-Jersey City, NY-NJ MSA",2022,3,9852037,9361598,490439,5
MT3640380000000,36,40380,"Rochester, NY MSA",2022,3,512382,495013,17369,3.4
MT3645060000000,36,45060,"Syracuse, NY MSA",2022,3,309377,298863,10514,3.4
MT3646540000000,36,46540,"Utica-Rome, NY MSA",2022,3,127529,123090,4439,3.5
MT3648060000000,36,48060,"Watertown-Fort Drum, NY MSA",2022,3,45040,43338,1702,3.8
MT3711700000000,37,11700,"Asheville, NC MSA",2022,3,207521,201160,6361,3.1
MT3715500000000,37,15500,"Burlington, NC MSA",2022,3,83240,80193,3047,3.7
MT3716740000000,37,16740,"Charlotte-Concord-Gastonia, NC-SC MSA",2022,3,1434292,1384824,49468,3.4
MT3720500000000,37,20500,"Durham-Chapel Hill, NC MSA",2022,3,313314,303343,9971,3.2
MT3722180000000,37,22180,"Fayetteville, NC MSA",2022,3,153929,146549,7380,4.8
MT3724140000000,37,24140,"Goldsboro, NC MSA",2022,3,49702,47720,1982,4
MT3724660000000,37,24660,"Greensboro-High Point, NC MSA",2022,3,374503,359817,14686,3.9
MT3724780000000,37,24780,"Greenville, NC MSA",2022,3,81849,78397,3452,4.2
MT3725860000000,37,25860,"Hickory-Lenoir-Morganton, NC MSA",2022,3,171930,166098,5832,3.4
MT3727340000000,37,27340,"Jacksonville, NC MSA",2022,3,71914,69166,2748,3.8
MT3738240000000,37,38240,"Pinehurst-Southern Pines, NC MSA",2022,3,42866,41331,1535,3.6
MT3739580000000,37,39580,"Raleigh-Cary, NC MSA",2022,3,802560,778141,24419,3
MT3740580000000,37,40580,"Rocky Mount, NC MSA",2022,3,64333,60907,3426,5.3
MT3748900000000,37,48900,"Wilmington, NC MSA",2022,3,213370,205505,7865,3.7
MT3749180000000,37,49180,"Winston-Salem, NC MSA",2022,3,324349,312595,11754,3.6
MT3813900000000,38,13900,"Bismarck, ND MSA",2022,3,72771,71344,1427,2
MT3822020000000,38,22020,"Fargo, ND-MN MSA",2022,3,149013,146335,2678,1.8
MT3824220000000,38,24220,"Grand Forks, ND-MN MSA",2022,3,54403,53267,1136,2.1
MT3833500000000,38,33500,"Minot, ND MSA",2022,3,39618,38786,832,2.1
MT3910420000000,39,10420,"Akron, OH MSA",2022,3,351326,338077,13249,3.8
MT3915940000000,39,15940,"Canton-Massillon, OH MSA",2022,3,189484,182161,7323,3.9
MT3917140000000,39,17140,"Cincinnati, OH-KY-IN MSA",2022,3,1144943,1106326,38617,3.4
MT3917410000000,39,17410,"Cleveland, OH MSA",2022,3,1070751,1018961,51790,4.8
MT3918140000000,39,18140,"Columbus, OH MSA",2022,3,1123043,1086583,36460,3.2
MT3919430000000,39,19430,"Dayton-Kettering-Beavercreek, OH MSA",2022,3,381605,367447,14158,3.7
MT3930620000000,39,30620,"Lima, OH MSA",2022,3,47255,45434,1821,3.9
MT3931900000000,39,31900,"Mansfield, OH MSA",2022,3,52396,50191,2205,4.2
MT3941780000000,39,41780,"Sandusky, OH MSA",2022,3,56889,53753,3136,5.5
MT3944220000000,39,44220,"Springfield, OH MSA",2022,3,61603,59078,2525,4.1
MT3945780000000,39,45780,"Toledo, OH MSA",2022,3,289143,277565,11578,4
MT3948260000000,39,48260,"Weirton-Steubenville, WV-OH MSA",2022,3,52797,50308,2489,4.7
MT3949660000000,39,49660,"Youngstown-Warren, OH MSA",2022,3,188729,180247,8482,4.5
MT4021420000000,40,21420,"Enid, OK MSA",2022,3,28844,28078,766,2.7
MT4030020000000,40,30020,"Lawton, OK MSA",2022,3,50636,48929,1707,3.4
MT4036420000000,40,36420,"Oklahoma City, OK MSA",2022,3,724686,705051,19635,2.7
MT4046140000000,40,46140,"Tulsa, OK MSA",2022,3,493395,478654,14741,3
MT4110540000000,41,10540,"Albany, OR MSA",2022,3,61497,58949,2548,4.1
MT4113460000000,41,13460,"Bend, OR MSA",2022,3,127301,122480,4821,3.8
MT4118700000000,41,18700,"Corvallis, OR MSA",2022,3,48362,46758,1604,3.3
MT4121660000000,41,21660,"Eugene-Springfield, OR MSA",2022,3,186442,179026,7416,4
MT4124420000000,41,24420,"Grants Pass, OR MSA",2022,3,35422,33642,1780,5
MT4132780000000,41,32780,"Medford, OR MSA",2022,3,105206,100882,4324,4.1
MT4138900000000,41,38900,"Portland-Vancouver-Hillsboro, OR-WA MSA",2022,3,1369541,1321221,48320,3.5
MT4141420000000,41,41420,"Salem, OR MSA",2022,3,214344,206223,8121,3.8
MT4210900000000,42,10900,"Allentown-Bethlehem-Easton, PA-NJ MSA",2022,3,441765,422973,18792,4.3
MT4211020000000,42,11020,"Altoona, PA MSA",2022,3,57251,54763,2488,4.3
MT4216540000000,42,16540,"Chambersburg, PA MSA",2022,3,76722,74019,2703,3.5
MT4221500000000,42,21500,"Erie, PA MSA",2022,3,125911,119986,5925,4.7
MT4223900000000,42,23900,"Gettysburg, PA MSA",2022,3,51847,50107,1740,3.4
MT4225420000000,42,25420,"Harrisburg-Carlisle, PA MSA",2022,3,305060,294079,10981,3.6
MT4227780000000,42,27780,"Johnstown, PA MSA",2022,3,56860,54050,2810,4.9
MT4229540000000,42,29540,"Lancaster, PA MSA",2022,3,288464,278549,9915,3.4
MT4230140000000,42,30140,"Lebanon, PA MSA",2022,3,70936,68294,2642,3.7
MT4237980000000,42,37980,"Philadelphia-Camden-Wilmington, PA-NJ-DE-MD MSA",2022,3,3207770,3074472,133298,4.2
MT4238300000000,42,38300,"Pittsburgh, PA MSA",2022,3,1219187,1167149,52038,4.3
MT4239740000000,42,39740,"Reading, PA MSA",2022,3,214817,205800,9017,4.2
MT4242540000000,42,42540,"Scranton--Wilkes-Barre, PA MSA",2022,3,276569,262835,13734,5
MT4244300000000,42,44300,"State College, PA MSA",2022,3,74896,72324,2572,3.4
MT4248700000000,42,48700,"Williamsport, PA MSA",2022,3,52035,49569,2466,4.7
MT4249620000000,42,49620,"York-Hanover, PA MSA",2022,3,236022,227322,8700,3.7
MT4439300000000,44,39300,"Providence-Warwick, RI-MA MSA",2022,3,871289,839490,31799,3.6
MT4516700000000,45,16700,"Charleston-North Charleston, SC MSA",2022,3,406246,394263,11983,2.9
MT4517900000000,45,17900,"Columbia, SC MSA",2022,3,400417,387698,12719,3.2
MT4522500000000,45,22500,"Florence, SC MSA",2022,3,89402,86170,3232,3.6
MT4524860000000,45,24860,"Greenville-Anderson-Greer, SC MSA",2022,3,454906,441745,13161,2.9
MT4525940000000,45,25940,"Hilton Head Island-Bluffton-Port Royal, SC MSA",2022,3,92616,89811,2805,3
MT4534820000000,45,34820,"Myrtle Beach-Conway-North Myrtle Beach, SC MSA",2022,3,158258,152201,6057,3.8
MT4543900000000,45,43900,"Spartanburg, SC MSA",2022,3,167508,161929,5579,3.3
MT4544940000000,45,44940,"Sumter, SC MSA",2022,3,42047,40473,1574,3.7
MT4639660000000,46,39660,"Rapid City, SD MSA",2022,3,77453,76020,1433,1.9
MT4643620000000,46,43620,"Sioux Falls, SD-MN MSA",2022,3,166963,164149,2814,1.7
MT4716860000000,47,16860,"Chattanooga, TN-GA MSA",2022,3,275316,266213,9103,3.3
MT4717300000000,47,17300,"Clarksville, TN-KY MSA",2022,3,134796,129768,5028,3.7
MT4717420000000,47,17420,"Cleveland, TN MSA",2022,3,57702,55637,2065,3.6
MT4727180000000,47,27180,"Jackson, TN MSA",2022,3,78940,76087,2853,3.6
MT4727740000000,47,27740,"Johnson City, TN MSA",2022,3,96915,93840,3075,3.2
MT4728700000000,47,28700,"Kingsport-Bristol, TN-VA MSA",2022,3,130609,126318,4291,3.3
MT4728940000000,47,28940,"Knoxville, TN MSA",2022,3,442823,429289,13534,3.1
MT4732820000000,47,32820,"Memphis, TN-MS-AR MSA",2022,3,641253,614757,26496,4.1
MT4734100000000,47,34100,"Morristown, TN MSA",2022,3,53003,51113,1890,3.6
MT4734980000000,47,34980,"Nashville-Davidson--Murfreesboro--Franklin, TN MSA",2022,3,1128685,1097423,31262,2.8
MT4810180000000,48,10180,"Abilene, TX MSA",2022,3,82299,79434,2865,3.5
MT4811100000000,48,11100,"Amarillo, TX MSA",2022,3,132751,128555,4196,3.2
MT4812420000000,48,12420,"Austin-Round Rock-San Marcos, TX MSA",2022,3,1374915,1333503,41412,3
MT4813140000000,48,13140,"Beaumont-Port Arthur, TX MSA",2022,3,169784,159833,9951,5.9
MT4815180000000,48,15180,"Brownsville-Harlingen, TX MSA",2022,3,180600,170310,10290,5.7
MT4817780000000,48,17780,"College Station-Bryan, TX MSA",2022,3,140079,135246,4833,3.5
MT4818580000000,48,18580,"Corpus Christi, TX MSA",2022,3,201399,190974,10425,5.2
MT4819100000000,48,19100,"Dallas-Fort Worth-Arlington, TX MSA",2022,3,4203981,4053205,150776,3.6
MT4820580000000,48,20580,"Eagle Pass, TX MSA",2022,3,23342,21424,1918,8.2
MT4821340000000,48,21340,"El Paso, TX MSA",2022,3,388264,371829,16435,4.2
MT4826420000000,48,26420,"Houston-Pasadena-The Woodlands, TX MSA",2022,3,3573671,3419535,154136,4.3
MT4828660000000,48,28660,"Killeen-Temple, TX MSA",2022,3,194428,186162,8266,4.3
MT4829700000000,48,29700,"Laredo, TX MSA",2022,3,111977,106994,4983,4.5
MT4830980000000,48,30980,"Longview, TX MSA",2022,3,125939,120320,5619,4.5
MT4831180000000,48,31180,"Lubbock, TX MSA",2022,3,177279,171138,6141,3.5
MT4832580000000,48,32580,"McAllen-Edinburg-Mission, TX MSA",2022,3,376667,351976,24691,6.6
MT4833260000000,48,33260,"Midland, TX MSA",2022,3,92002,88634,3368,3.7
MT4836220000000,48,36220,"Odessa, TX MSA",2022,3,79235,75766,3469,4.4
MT4841660000000,48,41660,"San Angelo, TX MSA",2022,3,59057,57083,1974,3.3
MT4841700000000,48,41700,"San Antonio-New Braunfels, TX MSA",2022,3,1255161,1208519,46642,3.7
MT4843300000000,48,43300,"Sherman-Denison, TX MSA",2022,3,66380,63933,2447,3.7
MT4845500000000,48,45500,"Texarkana, TX-AR MSA",2022,3,60497,57783,2714,4.5
MT4846340000000,48,46340,"Tyler, TX MSA",2022,3,111890,107571,4319,3.9
MT4847020000000,48,47020,"Victoria, TX MSA",2022,3,44683,42751,1932,4.3
MT4847380000000,48,47380,"Waco, TX MSA",2022,3,140102,134778,5324,3.8
MT4848660000000,48,48660,"Wichita Falls, TX MSA",2022,3,65736,63215,2521,3.8
MT4930860000000,49,30860,"Logan, UT-ID MSA",2022,3,78794,77199,1595,2
MT4936260000000,49,36260,"Ogden, UT MSA",2022,3,331962,324660,7302,2.2
MT4939340000000,49,39340,"Provo-Orem-Lehi, UT MSA",2022,3,350544,343187,7357,2.1
MT4941100000000,49,41100,"St. George, UT MSA",2022,3,85625,83420,2205,2.6
MT4941620000000,49,41620,"Salt Lake City-Murray, UT MSA",2022,3,699642,683488,16154,2.3
MT5015540000000,50,15540,"Burlington-South Burlington, VT MSA",2022,3,126058,123400,2658,2.1
MT5113980000000,51,13980,"Blacksburg-Christiansburg-Radford, VA MSA",2022,3,89960,87579,2381,2.6
MT5116820000000,51,16820,"Charlottesville, VA MSA",2022,3,114033,111323,2710,2.4
MT5125500000000,51,25500,"Harrisonburg, VA MSA",2022,3,70273,68609,1664,2.4
MT5131340000000,51,31340,"Lynchburg, VA MSA",2022,3,126153,122730,3423,2.7
MT5140060000000,51,40060,"Richmond, VA MSA",2022,3,693173,675267,17906,2.6
MT5140220000000,51,40220,"Roanoke, VA MSA",2022,3,152250,148329,3921,2.6
MT5144420000000,51,44420,"Staunton-Stuarts Draft, VA MSA",2022,3,62827,61373,1454,2.3
MT5147260000000,51,47260,"Virginia Beach-Chesapeake-Norfolk, VA-NC MSA",2022,3,851475,826786,24689,2.9
MT5149020000000,51,49020,"Winchester, VA-WV MSA",2022,3,73520,71795,1725,2.3
MT5313380000000,53,13380,"Bellingham, WA MSA",2022,3,114295,109697,4598,4
MT5314740000000,53,14740,"Bremerton-Silverdale-Port Orchard, WA MSA",2022,3,122132,117313,4819,3.9
MT5328420000000,53,28420,"Kennewick-Richland, WA MSA",2022,3,145313,138647,6666,4.6
MT5331020000000,53,31020,"Longview-Kelso, WA MSA",2022,3,47631,45370,2261,4.7
MT5334580000000,53,34580,"Mount Vernon-Anacortes, WA MSA",2022,3,58516,55808,2708,4.6
MT5336500000000,53,36500,"Olympia-Lacey-Tumwater, WA MSA",2022,3,139761,134052,5709,4.1
MT5342660000000,53,42660,"Seattle-Tacoma-Bellevue, WA MSA",2022,3,2225655,2146235,79420,3.6
MT5344060000000,53,44060,"Spokane-Spokane Valley, WA MSA",2022,3,280973,269745,11228,4
MT5347460000000,53,47460,"Walla Walla, WA MSA",2022,3,29540,28376,1164,3.9
MT5348300000000,53,48300,"Wenatchee-East Wenatchee, WA MSA",2022,3,62287,59566,2721,4.4
MT5349420000000,53,49420,"Yakima, WA MSA",2022,3,127127,120400,6727,5.3
MT5413220000000,54,13220,"Beckley, WV MSA",2022,3,45122,43379,1743,3.9
MT5416620000000,54,16620,"Charleston, WV MSA",2022,3,89928,86445,3483,3.9
MT5426580000000,54,26580,"Huntington-Ashland, WV-KY-OH MSA",2022,3,155455,148864,6591,4.2
MT5434060000000,54,34060,"Morgantown, WV MSA",2022,3,71004,68389,2615,3.7
MT5437620000000,54,37620,"Parkersburg-Vienna, WV MSA",2022,3,39091,37488,1603,4.1
MT5448540000000,54,48540,"Wheeling, WV-OH MSA",2022,3,59553,56821,2732,4.6
MT5511540000000,55,11540,"Appleton, WI MSA",2022,3,134556,131375,3181,2.4
MT5520740000000,55,20740,"Eau Claire, WI MSA",2022,3,92942,90376,2566,2.8
MT5522540000000,55,22540,"Fond du Lac, WI MSA",2022,3,56516,55100,1416,2.5
MT5524580000000,55,24580,"Green Bay, WI MSA",2022,3,175239,170713,4526,2.6
MT5527500000000,55,27500,"Janesville-Beloit, WI MSA",2022,3,83949,80992,2957,3.5
MT5528450000000,55,28450,"Kenosha, WI MSA",2022,3,92909,89918,2991,3.2
MT5529100000000,55,29100,"La Crosse-Onalaska, WI-MN MSA",2022,3,88086,85891,2195,2.5
MT5531540000000,55,31540,"Madison, WI MSA",2022,3,393257,384580,8677,2.2
MT5533340000000,55,33340,"Milwaukee-Waukesha, WI MSA",2022,3,806959,781319,25640,3.2
MT5536780000000,55,36780,"Oshkosh-Neenah, WI MSA",2022,3,91435,89185,2250,2.5
MT5539540000000,55,39540,"Racine-Mount Pleasant, WI MSA",2022,3,99685,96203,3482,3.5
MT5543100000000,55,43100,"Sheboygan, WI MSA",2022,3,62038,60564,1474,2.4
MT5548140000000,55,48140,"Wausau, WI MSA",2022,3,74765,72973,1792,2.4
MT5616220000000,56,16220,"Casper, WY MSA",2022,3,40645,39081,1564,3.8
MT5616940000000,56,16940,"Cheyenne, WY MSA",2022,3,47905,46260,1645,3.4
MT7210380000000,72,10380,"Aguadilla, PR MSA",2022,3,85897,79597,6300,7.3
MT7211640000000,72,11640,"Arecibo, PR MSA",2022,3,65207,60220,4987,7.6
MT7225020000000,72,25020,"Guayama, PR MSA",2022,3,19136,17538,1598,8.4
MT7232420000000,72,32420,"Mayaguez, PR MSA",2022,3,66289,61219,5070,7.6
MT7238660000000,72,38660,"Ponce, PR MSA",2022,3,88344,80955,7389,8.4
MT7241980000000,72,41980,"San Juan-Bayamon-Caguas, PR MSA",2022,3,810178,766510,43668,5.4
MT0111500000000,1,11500,"Anniston-Oxford, AL MSA",2022,4,49368,47960,1408,2.9
MT0112220000000,1,12220,"Auburn-Opelika, AL MSA",2022,4,92074,89892,2182,2.4
MT0113820000000,1,13820,"Birmingham, AL MSA",2022,4,558645,545426,13219,2.4
MT0119300000000,1,19300,"Daphne-Fairhope-Foley, AL MSA",2022,4,110148,107695,2453,2.2
MT0119460000000,1,19460,"Decatur, AL MSA",2022,4,72442,70857,1585,2.2
MT0120020000000,1,20020,"Dothan, AL MSA",2022,4,66379,64726,1653,2.5
MT0122520000000,1,22520,"Florence-Muscle Shoals, AL MSA",2022,4,67494,65669,1825,2.7
MT0123460000000,1,23460,"Gadsden, AL MSA",2022,4,41281,40135,1146,2.8
MT0126620000000,1,26620,"Huntsville, AL MSA",2022,4,256170,250938,5232,2
MT0133660000000,1,33660,"Mobile, AL MSA",2022,4,183186,177208,5978,3.3
MT0133860000000,1,33860,"Montgomery, AL MSA",2022,4,171685,166863,4822,2.8
MT0146220000000,1,46220,"Tuscaloosa, AL MSA",2022,4,120650,117357,3293,2.7
MT0211260000000,2,11260,"Anchorage, AK MSA",2022,4,198271,190188,8083,4.1
MT0221820000000,2,21820,"Fairbanks-College, AK MSA",2022,4,44756,42967,1789,4
MT0422380000000,4,22380,"Flagstaff, AZ MSA",2022,4,72010,68882,3128,4.3
MT0429420000000,4,29420,"Lake Havasu City-Kingman, AZ MSA",2022,4,85573,81612,3961,4.6
MT0438060000000,4,38060,"Phoenix-Mesa-Chandler, AZ MSA",2022,4,2575442,2490331,85111,3.3
MT0439150000000,4,39150,"Prescott Valley-Prescott, AZ MSA",2022,4,102453,98845,3608,3.5
MT0443420000000,4,43420,"Sierra Vista-Douglas, AZ MSA",2022,4,47360,45309,2051,4.3
MT0446060000000,4,46060,"Tucson, AZ MSA",2022,4,487990,469826,18164,3.7
MT0449740000000,4,49740,"Yuma, AZ MSA",2022,4,96444,84696,11748,12.2
MT0522220000000,5,22220,"Fayetteville-Springdale-Rogers, AR MSA",2022,4,287417,280488,6929,2.4
MT0522900000000,5,22900,"Fort Smith, AR-OK MSA",2022,4,100216,97149,3067,3.1
MT0526300000000,5,26300,"Hot Springs, AR MSA",2022,4,43617,42076,1541,3.5
MT0527860000000,5,27860,"Jonesboro, AR MSA",2022,4,64369,62531,1838,2.9
MT0530780000000,5,30780,"Little Rock-North Little Rock-Conway, AR MSA",2022,4,363289,352064,11225,3.1
MT0612540000000,6,12540,"Bakersfield-Delano, CA MSA",2022,4,391005,364640,26365,6.7
MT0617020000000,6,17020,"Chico, CA MSA",2022,4,89780,85844,3936,4.4
MT0620940000000,6,20940,"El Centro, CA MSA",2022,4,67233,57387,9846,14.6
MT0623420000000,6,23420,"Fresno, CA MSA",2022,4,508735,475686,33049,6.5
MT0625260000000,6,25260,"Hanford-Corcoran, CA MSA",2022,4,54206,50346,3860,7.1
MT0631080000000,6,31080,"Los Angeles-Long Beach-Anaheim, CA MSA",2022,4,6618558,6308174,310384,4.7
MT0632900000000,6,32900,"Merced, CA MSA",2022,4,115087,106128,8959,7.8
MT0633700000000,6,33700,"Modesto, CA MSA",2022,4,244700,231899,12801,5.2
MT0634900000000,6,34900,"Napa, CA MSA",2022,4,70649,68332,2317,3.3
MT0637100000000,6,37100,"Oxnard-Thousand Oaks-Ventura, CA MSA",2022,4,412250,396790,15460,3.8
MT0639820000000,6,39820,"Redding, CA MSA",2022,4,76002,72737,3265,4.3
MT0640140000000,6,40140,"Riverside-San Bernardino-Ontario, CA MSA",2022,4,2139361,2048574,90787,4.2
MT0640900000000,6,40900,"Sacramento-Roseville-Folsom, CA MSA",2022,4,1136013,1093731,42282,3.7
MT0641500000000,6,41500,"Salinas, CA MSA",2022,4,215364,202702,12662,5.9
MT0641740000000,6,41740,"San Diego-Chula Vista-Carlsbad, CA MSA",2022,4,1605908,1550316,55592,3.5
MT0641860000000,6,41860,"San Francisco-Oakland-Fremont, CA MSA",2022,4,2496054,2419527,76527,3.1
MT0641940000000,6,41940,"San Jose-Sunnyvale-Santa Clara, CA MSA",2022,4,1039223,1009569,29654,2.9
MT0642020000000,6,42020,"San Luis Obispo-Paso Robles, CA MSA",2022,4,131302,127019,4283,3.3
MT0642100000000,6,42100,"Santa Cruz-Watsonville, CA MSA",2022,4,133514,127356,6158,4.6
MT0642200000000,6,42200,"Santa Maria-Santa Barbara, CA MSA",2022,4,217958,210132,7826,3.6
MT0642220000000,6,42220,"Santa Rosa-Petaluma, CA MSA",2022,4,244659,236817,7842,3.2
MT0644700000000,6,44700,"Stockton-Lodi, CA MSA",2022,4,356245,338378,17867,5
MT0646700000000,6,46700,"Vallejo, CA MSA",2022,4,209398,200777,8621,4.1
MT0647300000000,6,47300,"Visalia, CA MSA",2022,4,207410,191337,16073,7.7
MT0649700000000,6,49700,"Yuba City, CA MSA",2022,4,77721,73181,4540,5.8
MT0814500000000,8,14500,"Boulder, CO MSA",2022,4,191658,186347,5311,2.8
MT0817820000000,8,17820,"Colorado Springs, CO MSA",2022,4,380327,368009,12318,3.2
MT0819740000000,8,19740,"Denver-Aurora-Centennial, CO MSA",2022,4,1736044,1683641,52403,3
MT0822660000000,8,22660,"Fort Collins-Loveland, CO MSA",2022,4,201861,195873,5988,3
MT0824300000000,8,24300,"Grand Junction, CO MSA",2022,4,78145,75488,2657,3.4
MT0824540000000,8,24540,"Greeley, CO MSA",2022,4,169560,163804,5756,3.4
MT0839380000000,8,39380,"Pueblo, CO MSA",2022,4,74253,70821,3432,4.6
MT0914860000000,9,14860,"Bridgeport-Stamford-Danbury, CT MSA",2022,4,511138,490478,20660,4
MT0925540000000,9,25540,"Hartford-West Hartford-East Hartford, CT MSA",2022,4,615284,588583,26701,4.3
MT0935300000000,9,35300,"New Haven, CT MSA",2022,4,316242,302825,13417,4.2
MT0935980000000,9,35980,"Norwich-New London-Willimantic, CT MSA",2022,4,142096,135667,6429,4.5
MT0947930000000,9,47930,"Waterbury-Shelton, CT MSA",2022,4,242185,230834,11351,4.7
MT1020100000000,10,20100,"Dover, DE MSA",2022,4,84962,81011,3951,4.7
MT1147900000000,11,47900,"Washington-Arlington-Alexandria, DC-VA-MD-WV MSA",2022,4,3432949,3335999,96950,2.8
MT1215980000000,12,15980,"Cape Coral-Fort Myers, FL MSA",2022,4,359960,348420,11540,3.2
MT1218880000000,12,18880,"Crestview-Fort Walton Beach-Destin, FL MSA",2022,4,138340,134690,3650,2.6
MT1219660000000,12,19660,"Deltona-Daytona Beach-Ormond Beach, FL MSA",2022,4,306824,296179,10645,3.5
MT1223540000000,12,23540,"Gainesville, FL MSA",2022,4,164350,159085,5265,3.2
MT1226140000000,12,26140,"Homosassa Springs, FL MSA",2022,4,52106,49920,2186,4.2
MT1227260000000,12,27260,"Jacksonville, FL MSA",2022,4,824328,798986,25342,3.1
MT1229460000000,12,29460,"Lakeland-Winter Haven, FL MSA",2022,4,343441,330564,12877,3.7
MT1233100000000,12,33100,"Miami-Fort Lauderdale-West Palm Beach, FL MSA",2022,4,3165222,3070970,94252,3
MT1234940000000,12,34940,"Naples-Marco Island, FL MSA",2022,4,173424,167894,5530,3.2
MT1235840000000,12,35840,"North Port-Bradenton-Sarasota, FL MSA",2022,4,371506,359895,11611,3.1
MT1236100000000,12,36100,"Ocala, FL MSA",2022,4,150920,145420,5500,3.6
MT1236740000000,12,36740,"Orlando-Kissimmee-Sanford, FL MSA",2022,4,1443211,1398058,45153,3.1
MT1237340000000,12,37340,"Palm Bay-Melbourne-Titusville, FL MSA",2022,4,292334,283328,9006,3.1
MT1237460000000,12,37460,"Panama City-Panama City Beach, FL MSA",2022,4,96663,93729,2934,3
MT1237860000000,12,37860,"Pensacola-Ferry Pass-Brent, FL MSA",2022,4,233803,226516,7287,3.1
MT1238940000000,12,38940,"Port St. Lucie, FL MSA",2022,4,228015,220066,7949,3.5
MT1239460000000,12,39460,"Punta Gorda, FL MSA",2022,4,71667,69006,2661,3.7
MT1242680000000,12,42680,"Sebastian-Vero Beach-West Vero Corridor, FL MSA",2022,4,65287,62763,2524,3.9
MT1242700000000,12,42700,"Sebring, FL MSA",2022,4,35419,33855,1564,4.4
MT1245220000000,12,45220,"Tallahassee, FL MSA",2022,4,199363,192939,6424,3.2
MT1245300000000,12,45300,"Tampa-St. Petersburg-Clearwater, FL MSA",2022,4,1633615,1584838,48777,3
MT1248680000000,12,48680,"Wildwood-The Villages, FL MSA",2022,4,31560,29970,1590,5
MT1310500000000,13,10500,"Albany, GA MSA",2022,4,63014,60586,2428,3.9
MT1312020000000,13,12020,"Athens-Clarke County, GA MSA",2022,4,102367,99357,3010,2.9
MT1312060000000,13,12060,"Atlanta-Sandy Springs-Roswell, GA MSA",2022,4,3187839,3092912,94927,3
MT1312260000000,13,12260,"Augusta-Richmond County, GA-SC MSA",2022,4,264205,254912,9293,3.5
MT1315260000000,13,15260,"Brunswick-St. Simons, GA MSA",2022,4,52233,50659,1574,3
MT1317980000000,13,17980,"Columbus, GA-AL MSA",2022,4,129525,124980,4545,3.5
MT1319140000000,13,19140,"Dalton, GA MSA",2022,4,66721,64521,2200,3.3
MT1323580000000,13,23580,"Gainesville, GA MSA",2022,4,103043,100456,2587,2.5
MT1325980000000,13,25980,"Hinesville, GA MSA",2022,4,30699,29542,1157,3.8
MT1331420000000,13,31420,"Macon-Bibb County, GA MSA",2022,4,98082,94591,3491,3.6
MT1340660000000,13,40660,"Rome, GA MSA",2022,4,44511,43122,1389,3.1
MT1342340000000,13,42340,"Savannah, GA MSA",2022,4,203969,197932,6037,3
MT1346660000000,13,46660,"Valdosta, GA MSA",2022,4,61427,59402,2025,3.3
MT1347580000000,13,47580,"Warner Robins, GA MSA",2022,4,88576,85853,2723,3.1
MT1527980000000,15,27980,"Kahului-Wailuku, HI MSA",2022,4,82717,79947,2770,3.3
MT1546520000000,15,46520,"Urban Honolulu, HI MSA",2022,4,464604,449992,14612,3.1
MT1614260000000,16,14260,"Boise City, ID MSA",2022,4,422104,411283,10821,2.6
MT1617660000000,16,17660,"Coeur d'Alene, ID MSA",2022,4,86023,83185,2838,3.3
MT1626820000000,16,26820,"Idaho Falls, ID MSA",2022,4,80292,78289,2003,2.5
MT1630300000000,16,30300,"Lewiston, ID-WA MSA",2022,4,30372,29458,914,3
MT1638540000000,16,38540,"Pocatello, ID MSA",2022,4,39033,37796,1237,3.2
MT1646300000000,16,46300,"Twin Falls, ID MSA",2022,4,58988,57392,1596,2.7
MT1714010000000,17,14010,"Bloomington, IL MSA",2022,4,91129,87757,3372,3.7
MT1716580000000,17,16580,"Champaign-Urbana, IL MSA",2022,4,123300,118380,4920,4
MT1716980000000,17,16980,"Chicago-Naperville-Elgin, IL-IN MSA",2022,4,4865442,4641138,224304,4.6
MT1719340000000,17,19340,"Davenport-Moline-Rock Island, IA-IL MSA",2022,4,189465,182169,7296,3.9
MT1719500000000,17,19500,"Decatur, IL MSA",2022,4,45258,42531,2727,6
MT1728100000000,17,28100,"Kankakee, IL MSA",2022,4,50753,47950,2803,5.5
MT1737900000000,17,37900,"Peoria, IL MSA",2022,4,173286,165093,8193,4.7
MT1740420000000,17,40420,"Rockford, IL MSA",2022,4,160894,150525,10369,6.4
MT1744100000000,17,44100,"Springfield, IL MSA",2022,4,101935,97349,4586,4.5
MT1814020000000,18,14020,"Bloomington, IN MSA",2022,4,84056,81948,2108,2.5
MT1818020000000,18,18020,"Columbus, IN MSA",2022,4,39202,38198,1004,2.6
MT1821140000000,18,21140,"Elkhart-Goshen, IN MSA",2022,4,107985,105315,2670,2.5
MT1821780000000,18,21780,"Evansville, IN MSA",2022,4,134870,130938,3932,2.9
MT1823060000000,18,23060,"Fort Wayne, IN MSA",2022,4,226545,220276,6269,2.8
MT1826900000000,18,26900,"Indianapolis-Carmel-Greenwood, IN MSA",2022,4,1095716,1064737,30979,2.8
MT1829020000000,18,29020,"Kokomo, IN MSA",2022,4,35803,34299,1504,4.2
MT1829200000000,18,29200,"Lafayette-West Lafayette, IN MSA",2022,4,116252,113066,3186,2.7
MT1833140000000,18,33140,"Michigan City-La Porte, IN MSA",2022,4,50425,48712,1713,3.4
MT1834620000000,18,34620,"Muncie, IN MSA",2022,4,51346,49544,1802,3.5
MT1843780000000,18,43780,"South Bend-Mishawaka, IN-MI MSA",2022,4,154310,148928,5382,3.5
MT1845460000000,18,45460,"Terre Haute, IN MSA",2022,4,76887,74396,2491,3.2
MT1911180000000,19,11180,"Ames, IA MSA",2022,4,68570,67119,1451,2.1
MT1916300000000,19,16300,"Cedar Rapids, IA MSA",2022,4,148948,144708,4240,2.8
MT1919780000000,19,19780,"Des Moines-West Des Moines, IA MSA",2022,4,396787,386649,10138,2.6
MT1920220000000,19,20220,"Dubuque, IA MSA",2022,4,53782,52302,1480,2.8
MT1926980000000,19,26980,"Iowa City, IA MSA",2022,4,98334,96089,2245,2.3
MT1943580000000,19,43580,"Sioux City, IA-NE-SD MSA",2022,4,76248,74310,1938,2.5
MT1947940000000,19,47940,"Waterloo-Cedar Falls, IA MSA",2022,4,88922,86604,2318,2.6
MT2029940000000,20,29940,"Lawrence, KS MSA",2022,4,68426,66820,1606,2.3
MT2031740000000,20,31740,"Manhattan, KS MSA",2022,4,62788,61193,1595,2.5
MT2045820000000,20,45820,"Topeka, KS MSA",2022,4,116097,112862,3235,2.8
MT2048620000000,20,48620,"Wichita, KS MSA",2022,4,324204,314531,9673,3
MT2114540000000,21,14540,"Bowling Green, KY MSA",2022,4,88207,85047,3160,3.6
MT2121060000000,21,21060,"Elizabethtown, KY MSA",2022,4,53570,51318,2252,4.2
MT2130460000000,21,30460,"Lexington-Fayette, KY MSA",2022,4,267665,259162,8503,3.2
MT2131140000000,21,31140,"Louisville/Jefferson County, KY-IN MSA",2022,4,687124,663151,23973,3.5
MT2136980000000,21,36980,"Owensboro, KY MSA",2022,4,51099,49219,1880,3.7
MT2137140000000,21,37140,"Paducah, KY-IL MSA",2022,4,45568,43636,1932,4.2
MT2210780000000,22,10780,"Alexandria, LA MSA",2022,4,65395,63303,2092,3.2
MT2212940000000,22,12940,"Baton Rouge, LA MSA",2022,4,421361,406280,15081,3.6
MT2225220000000,22,25220,"Hammond, LA MSA",2022,4,59269,56782,2487,4.2
MT2226380000000,22,26380,"Houma-Bayou Cane-Thibodaux, LA MSA",2022,4,86044,82900,3144,3.7
MT2229180000000,22,29180,"Lafayette, LA MSA",2022,4,195613,189439,6174,3.2
MT2229340000000,22,29340,"Lake Charles, LA MSA",2022,4,100104,96294,3810,3.8
MT2233740000000,22,33740,"Monroe, LA MSA",2022,4,96582,92752,3830,4
MT2235380000000,22,35380,"New Orleans-Metairie, LA MSA",2022,4,469187,449818,19369,4.1
MT2243340000000,22,43340,"Shreveport-Bossier City, LA MSA",2022,4,168716,162358,6358,3.8
MT2243640000000,22,43640,"Slidell-Mandeville-Covington, LA MSA",2022,4,125845,122269,3576,2.8
MT2312620000000,23,12620,"Bangor, ME MSA",2022,4,72938,70694,2244,3.1
MT2330340000000,23,30340,"Lewiston-Auburn, ME MSA",2022,4,53970,52389,1581,2.9
MT2338860000000,23,38860,"Portland-South Portland, ME MSA",2022,4,300846,293445,7401,2.5
MT2412580000000,24,12580,"Baltimore-Columbia-Towson, MD MSA",2022,4,1456457,1411072,45385,3.1
MT2425180000000,24,25180,"Hagerstown-Martinsburg, MD-WV MSA",2022,4,141368,137094,4274,3
MT2430500000000,24,30500,"Lexington Park, MD MSA",2022,4,104832,101793,3039,2.9
MT2441540000000,24,41540,"Salisbury, MD MSA",2022,4,61519,59306,2213,3.6
MT2511200000000,25,11200,"Amherst Town-Northampton, MA MSA",2022,4,84247,81318,2929,3.5
MT2512700000000,25,12700,"Barnstable Town, MA MSA",2022,4,112923,107711,5212,4.6
MT2514460000000,25,14460,"Boston-Cambridge-Newton, MA-NH MSA",2022,4,2729432,2640776,88656,3.2
MT2538340000000,25,38340,"Pittsfield, MA MSA",2022,4,63808,61190,2618,4.1
MT2544140000000,25,44140,"Springfield, MA MSA",2022,4,223087,212458,10629,4.8
MT2549340000000,25,49340,"Worcester, MA MSA",2022,4,452273,435337,16936,3.7
MT2611460000000,26,11460,"Ann Arbor, MI MSA",2022,4,198893,191921,6972,3.5
MT2612980000000,26,12980,"Battle Creek, MI MSA",2022,4,59249,56474,2775,4.7
MT2613020000000,26,13020,"Bay City, MI MSA",2022,4,48237,45815,2422,5
MT2619820000000,26,19820,"Detroit-Warren-Dearborn, MI MSA",2022,4,2120842,2035116,85726,4
MT2622420000000,26,22420,"Flint, MI MSA",2022,4,179809,170222,9587,5.3
MT2624340000000,26,24340,"Grand Rapids-Wyoming-Kentwood, MI MSA",2022,4,599068,578050,21018,3.5
MT2627100000000,26,27100,"Jackson, MI MSA",2022,4,73207,69910,3297,4.5
MT2628020000000,26,28020,"Kalamazoo-Portage, MI MSA",2022,4,133998,129016,4982,3.7
MT2629620000000,26,29620,"Lansing-East Lansing, MI MSA",2022,4,238242,227934,10308,4.3
MT2633220000000,26,33220,"Midland, MI MSA",2022,4,39918,38285,1633,4.1
MT2633780000000,26,33780,"Monroe, MI MSA",2022,4,74844,71184,3660,4.9
MT2634740000000,26,34740,"Muskegon-Norton Shores, MI MSA",2022,4,81344,77585,3759,4.6
MT2635660000000,26,35660,"Niles, MI MSA",2022,4,73157,70018,3139,4.3
MT2640980000000,26,40980,"Saginaw, MI MSA",2022,4,83074,78646,4428,5.3
MT2645900000000,26,45900,"Traverse City, MI MSA",2022,4,77625,74499,3126,4
MT2720260000000,27,20260,"Duluth, MN-WI MSA",2022,4,137687,133382,4305,3.1
MT2731860000000,27,31860,"Mankato, MN MSA",2022,4,58533,57392,1141,1.9
MT2733460000000,27,33460,"Minneapolis-St. Paul-Bloomington, MN-WI MSA",2022,4,2036240,1991249,44991,2.2
MT2740340000000,27,40340,"Rochester, MN MSA",2022,4,123881,121312,2569,2.1
MT2741060000000,27,41060,"St. Cloud, MN MSA",2022,4,107714,104964,2750,2.6
MT2825060000000,28,25060,"Gulfport-Biloxi, MS MSA",2022,4,184408,177601,6807,3.7
MT2825620000000,28,25620,"Hattiesburg, MS MSA",2022,4,70121,67618,2503,3.6
MT2827140000000,28,27140,"Jackson, MS MSA",2022,4,276403,266628,9775,3.5
MT2916020000000,29,16020,"Cape Girardeau, MO-IL MSA",2022,4,47681,46575,1106,2.3
MT2917860000000,29,17860,"Columbia, MO MSA",2022,4,112278,110078,2200,2
MT2927620000000,29,27620,"Jefferson City, MO MSA",2022,4,73318,71852,1466,2
MT2927900000000,29,27900,"Joplin, MO-KS MSA",2022,4,94865,92722,2143,2.3
MT2928140000000,29,28140,"Kansas City, MO-KS MSA",2022,4,1154533,1124423,30110,2.6
MT2941140000000,29,41140,"St. Joseph, MO-KS MSA",2022,4,54474,53119,1355,2.5
MT2941180000000,29,41180,"St. Louis, MO-IL MSA",2022,4,1445351,1404878,40473,2.8
MT2944180000000,29,44180,"Springfield, MO MSA",2022,4,233566,228725,4841,2.1
MT3013740000000,30,13740,"Billings, MT MSA",2022,4,98841,96404,2437,2.5
MT3014580000000,30,14580,"Bozeman, MT MSA",2022,4,74125,72637,1488,2
MT3024500000000,30,24500,"Great Falls, MT MSA",2022,4,39750,38689,1061,2.7
MT3025740000000,30,25740,"Helena, MT MSA",2022,4,46092,44900,1192,2.6
MT3033540000000,30,33540,"Missoula, MT MSA",2022,4,72000,70133,1867,2.6
MT3124260000000,31,24260,"Grand Island, NE MSA",2022,4,41506,40631,875,2.1
MT3130700000000,31,30700,"Lincoln, NE MSA",2022,4,188451,184791,3660,1.9
MT3136540000000,31,36540,"Omaha, NE-IA MSA",2022,4,515424,503912,11512,2.2
MT3216180000000,32,16180,"Carson City, NV MSA",2022,4,27698,26590,1108,4
MT3229820000000,32,29820,"Las Vegas-Henderson-North Las Vegas, NV MSA",2022,4,1130722,1067224,63498,5.6
MT3239900000000,32,39900,"Reno, NV MSA",2022,4,287110,275927,11183,3.9
MT3331700000000,33,31700,"Manchester-Nashua, NH MSA",2022,4,238221,232662,5559,2.3
MT3412100000000,34,12100,"Atlantic City-Hammonton, NJ MSA",2022,4,177069,167044,10025,5.7
MT3445940000000,34,45940,"Trenton-Princeton, NJ MSA",2022,4,194052,186614,7438,3.8
MT3447220000000,34,47220,"Vineland, NJ MSA",2022,4,64597,60875,3722,5.8
MT3510740000000,35,10740,"Albuquerque, NM MSA",2022,4,447137,428950,18187,4.1
MT3522140000000,35,22140,"Farmington, NM MSA",2022,4,47915,45435,2480,5.2
MT3529740000000,35,29740,"Las Cruces, NM MSA",2022,4,97171,92467,4704,4.8
MT3542140000000,35,42140,"Santa Fe, NM MSA",2022,4,72872,69949,2923,4
MT3610580000000,36,10580,"Albany-Schenectady-Troy, NY MSA",2022,4,451845,438000,13845,3.1
MT3613780000000,36,13780,"Binghamton, NY MSA",2022,4,105986,102086,3900,3.7
MT3615380000000,36,15380,"Buffalo-Cheektowaga, NY MSA",2022,4,556957,536862,20095,3.6
MT3621300000000,36,21300,"Elmira, NY MSA",2022,4,35971,34724,1247,3.5
MT3624020000000,36,24020,"Glens Falls, NY MSA",2022,4,59601,57632,1969,3.3
MT3627060000000,36,27060,"Ithaca, NY MSA",2022,4,47789,46387,1402,2.9
MT3628740000000,36,28740,"Kingston, NY MSA",2022,4,85960,83106,2854,3.3
MT3628880000000,36,28880,"Kiryas Joel-Poughkeepsie-Newburgh, NY MSA",2022,4,332388,321401,10987,3.3
MT3635620000000,36,35620,"New York-Newark-Jersey City, NY-NJ MSA",2022,4,9861039,9399698,461341,4.7
MT3640380000000,36,40380,"Rochester, NY MSA",2022,4,511858,494283,17575,3.4
MT3645060000000,36,45060,"Syracuse, NY MSA",2022,4,309555,298818,10737,3.5
MT3646540000000,36,46540,"Utica-Rome, NY MSA",2022,4,127604,123074,4530,3.6
MT3648060000000,36,48060,"Watertown-Fort Drum, NY MSA",2022,4,45015,43233,1782,4
MT3711700000000,37,11700,"Asheville, NC MSA",2022,4,207714,201299,6415,3.1
MT3715500000000,37,15500,"Burlington, NC MSA",2022,4,83326,80261,3065,3.7
MT3716740000000,37,16740,"Charlotte-Concord-Gastonia, NC-SC MSA",2022,4,1437047,1387522,49525,3.4
MT3720500000000,37,20500,"Durham-Chapel Hill, NC MSA",2022,4,314210,304123,10087,3.2
MT3722180000000,37,22180,"Fayetteville, NC MSA",2022,4,153735,146377,7358,4.8
MT3724140000000,37,24140,"Goldsboro, NC MSA",2022,4,49739,47753,1986,4
MT3724660000000,37,24660,"Greensboro-High Point, NC MSA",2022,4,374123,359441,14682,3.9
MT3724780000000,37,24780,"Greenville, NC MSA",2022,4,81943,78522,3421,4.2
MT3725860000000,37,25860,"Hickory-Lenoir-Morganton, NC MSA",2022,4,172236,166308,5928,3.4
MT3727340000000,37,27340,"Jacksonville, NC MSA",2022,4,72102,69293,2809,3.9
MT3738240000000,37,38240,"Pinehurst-Southern Pines, NC MSA",2022,4,43014,41463,1551,3.6
MT3739580000000,37,39580,"Raleigh-Cary, NC MSA",2022,4,805548,780971,24577,3.1
MT3740580000000,37,40580,"Rocky Mount, NC MSA",2022,4,64094,60686,3408,5.3
MT3748900000000,37,48900,"Wilmington, NC MSA",2022,4,214038,206064,7974,3.7
MT3749180000000,37,49180,"Winston-Salem, NC MSA",2022,4,324802,312932,11870,3.7
MT3813900000000,38,13900,"Bismarck, ND MSA",2022,4,72729,71281,1448,2
MT3822020000000,38,22020,"Fargo, ND-MN MSA",2022,4,149257,146574,2683,1.8
MT3824220000000,38,24220,"Grand Forks, ND-MN MSA",2022,4,54437,53326,1111,2
MT3833500000000,38,33500,"Minot, ND MSA",2022,4,39620,38787,833,2.1
MT3910420000000,39,10420,"Akron, OH MSA",2022,4,351985,338495,13490,3.8
MT3915940000000,39,15940,"Canton-Massillon, OH MSA",2022,4,189362,181884,7478,3.9
MT3917140000000,39,17140,"Cincinnati, OH-KY-IN MSA",2022,4,1145482,1106469,39013,3.4
MT3917410000000,39,17410,"Cleveland, OH MSA",2022,4,1072410,1021325,51085,4.8
MT3918140000000,39,18140,"Columbus, OH MSA",2022,4,1121624,1084626,36998,3.3
MT3919430000000,39,19430,"Dayton-Kettering-Beavercreek, OH MSA",2022,4,382036,367642,14394,3.8
MT3930620000000,39,30620,"Lima, OH MSA",2022,4,47198,45375,1823,3.9
MT3931900000000,39,31900,"Mansfield, OH MSA",2022,4,52340,50091,2249,4.3
MT3941780000000,39,41780,"Sandusky, OH MSA",2022,4,56972,53866,3106,5.5
MT3944220000000,39,44220,"Springfield, OH MSA",2022,4,61526,58980,2546,4.1
MT3945780000000,39,45780,"Toledo, OH MSA",2022,4,289336,277647,11689,4
MT3948260000000,39,48260,"Weirton-Steubenville, WV-OH MSA",2022,4,52763,50271,2492,4.7
MT3949660000000,39,49660,"Youngstown-Warren, OH MSA",2022,4,188621,180072,8549,4.5
MT4021420000000,40,21420,"Enid, OK MSA",2022,4,28854,28080,774,2.7
MT4030020000000,40,30020,"Lawton, OK MSA",2022,4,50723,48962,1761,3.5
MT4036420000000,40,36420,"Oklahoma City, OK MSA",2022,4,725992,706104,19888,2.7
MT4046140000000,40,46140,"Tulsa, OK MSA",2022,4,494444,479380,15064,3
MT4110540000000,41,10540,"Albany, OR MSA",2022,4,61479,58925,2554,4.2
MT4113460000000,41,13460,"Bend, OR MSA",2022,4,127143,122272,4871,3.8
MT4118700000000,41,18700,"Corvallis, OR MSA",2022,4,48433,46810,1623,3.4
MT4121660000000,41,21660,"Eugene-Springfield, OR MSA",2022,4,186370,178946,7424,4
MT4124420000000,41,24420,"Grants Pass, OR MSA",2022,4,35356,33559,1797,5.1
MT4132780000000,41,32780,"Medford, OR MSA",2022,4,105176,100855,4321,4.1
MT4138900000000,41,38900,"Portland-Vancouver-Hillsboro, OR-WA MSA",2022,4,1369539,1321703,47836,3.5
MT4141420000000,41,41420,"Salem, OR MSA",2022,4,214298,206160,8138,3.8
MT4210900000000,42,10900,"Allentown-Bethlehem-Easton, PA-NJ MSA",2022,4,442699,424060,18639,4.2
MT4211020000000,42,11020,"Altoona, PA MSA",2022,4,57281,54761,2520,4.4
MT4216540000000,42,16540,"Chambersburg, PA MSA",2022,4,76844,74116,2728,3.6
MT4221500000000,42,21500,"Erie, PA MSA",2022,4,126095,120157,5938,4.7
MT4223900000000,42,23900,"Gettysburg, PA MSA",2022,4,51913,50137,1776,3.4
MT4225420000000,42,25420,"Harrisburg-Carlisle, PA MSA",2022,4,305401,294400,11001,3.6
MT4227780000000,42,27780,"Johnstown, PA MSA",2022,4,56918,54058,2860,5
MT4229540000000,42,29540,"Lancaster, PA MSA",2022,4,288848,278891,9957,3.4
MT4230140000000,42,30140,"Lebanon, PA MSA",2022,4,70929,68280,2649,3.7
MT4237980000000,42,37980,"Philadelphia-Camden-Wilmington, PA-NJ-DE-MD MSA",2022,4,3214372,3083533,130839,4.1
MT4238300000000,42,38300,"Pittsburgh, PA MSA",2022,4,1219983,1167401,52582,4.3
MT4239740000000,42,39740,"Reading, PA MSA",2022,4,215197,206192,9005,4.2
MT4242540000000,42,42540,"Scranton--Wilkes-Barre, PA MSA",2022,4,276687,263137,13550,4.9
MT4244300000000,42,44300,"State College, PA MSA",2022,4,75041,72438,2603,3.5
MT4248700000000,42,48700,"Williamsport, PA MSA",2022,4,52149,49644,2505,4.8
MT4249620000000,42,49620,"York-Hanover, PA MSA",2022,4,236385,227626,8759,3.7
MT4439300000000,44,39300,"Providence-Warwick, RI-MA MSA",2022,4,872027,840426,31601,3.6
MT4516700000000,45,16700,"Charleston-North Charleston, SC MSA",2022,4,406957,395214,11743,2.9
MT4517900000000,45,17900,"Columbia, SC MSA",2022,4,400156,387681,12475,3.1
MT4522500000000,45,22500,"Florence, SC MSA",2022,4,89488,86312,3176,3.5
MT4524860000000,45,24860,"Greenville-Anderson-Greer, SC MSA",2022,4,455007,442015,12992,2.9
MT4525940000000,45,25940,"Hilton Head Island-Bluffton-Port Royal, SC MSA",2022,4,92576,89806,2770,3
MT4534820000000,45,34820,"Myrtle Beach-Conway-North Myrtle Beach, SC MSA",2022,4,158708,152682,6026,3.8
MT4543900000000,45,43900,"Spartanburg, SC MSA",2022,4,167409,161914,5495,3.3
MT4544940000000,45,44940,"Sumter, SC MSA",2022,4,41964,40413,1551,3.7
MT4639660000000,46,39660,"Rapid City, SD MSA",2022,4,77587,76142,1445,1.9
MT4643620000000,46,43620,"Sioux Falls, SD-MN MSA",2022,4,167030,164230,2800,1.7
MT4716860000000,47,16860,"Chattanooga, TN-GA MSA",2022,4,275402,266383,9019,3.3
MT4717300000000,47,17300,"Clarksville, TN-KY MSA",2022,4,134656,129577,5079,3.8
MT4717420000000,47,17420,"Cleveland, TN MSA",2022,4,57655,55602,2053,3.6
MT4727180000000,47,27180,"Jackson, TN MSA",2022,4,78738,75860,2878,3.7
MT4727740000000,47,27740,"Johnson City, TN MSA",2022,4,96820,93667,3153,3.3
MT4728700000000,47,28700,"Kingsport-Bristol, TN-VA MSA",2022,4,130719,126307,4412,3.4
MT4728940000000,47,28940,"Knoxville, TN MSA",2022,4,442721,428931,13790,3.1
MT4732820000000,47,32820,"Memphis, TN-MS-AR MSA",2022,4,640604,614600,26004,4.1
MT4734100000000,47,34100,"Morristown, TN MSA",2022,4,53065,51144,1921,3.6
MT4734980000000,47,34980,"Nashville-Davidson--Murfreesboro--Franklin, TN MSA",2022,4,1129353,1098112,31241,2.8
MT4810180000000,48,10180,"Abilene, TX MSA",2022,4,82273,79454,2819,3.4
MT4811100000000,48,11100,"Amarillo, TX MSA",2022,4,132754,128633,4121,3.1
MT4812420000000,48,12420,"Austin-Round Rock-San Marcos, TX MSA",2022,4,1380089,1339156,40933,3
MT4813140000000,48,13140,"Beaumont-Port Arthur, TX MSA",2022,4,169577,159977,9600,5.7
MT4815180000000,48,15180,"Brownsville-Harlingen, TX MSA",2022,4,180651,170555,10096,5.6
MT4817780000000,48,17780,"College Station-Bryan, TX MSA",2022,4,140354,135614,4740,3.4
MT4818580000000,48,18580,"Corpus Christi, TX MSA",2022,4,201230,191153,10077,5
MT4819100000000,48,19100,"Dallas-Fort Worth-Arlington, TX MSA",2022,4,4212077,4063565,148512,3.5
MT4820580000000,48,20580,"Eagle Pass, TX MSA",2022,4,23302,21442,1860,8
MT4821340000000,48,21340,"El Paso, TX MSA",2022,4,388362,372311,16051,4.1
MT4826420000000,48,26420,"Houston-Pasadena-The Woodlands, TX MSA",2022,4,3578150,3427770,150380,4.2
MT4828660000000,48,28660,"Killeen-Temple, TX MSA",2022,4,194255,186094,8161,4.2
MT4829700000000,48,29700,"Laredo, TX MSA",2022,4,112079,107269,4810,4.3
MT4830980000000,48,30980,"Longview, TX MSA",2022,4,125897,120438,5459,4.3
MT4831180000000,48,31180,"Lubbock, TX MSA",2022,4,177042,171001,6041,3.4
MT4832580000000,48,32580,"McAllen-Edinburg-Mission, TX MSA",2022,4,376943,352679,24264,6.4
MT4833260000000,48,33260,"Midland, TX MSA",2022,4,92388,89157,3231,3.5
MT4836220000000,48,36220,"Odessa, TX MSA",2022,4,79427,76146,3281,4.1
MT4841660000000,48,41660,"San Angelo, TX MSA",2022,4,59107,57197,1910,3.2
MT4841700000000,48,41700,"San Antonio-New Braunfels, TX MSA",2022,4,1256223,1210211,46012,3.7
MT4843300000000,48,43300,"Sherman-Denison, TX MSA",2022,4,66529,64115,2414,3.6
MT4845500000000,48,45500,"Texarkana, TX-AR MSA",2022,4,60464,57791,2673,4.4
MT4846340000000,48,46340,"Tyler, TX MSA",2022,4,112112,107840,4272,3.8
MT4847020000000,48,47020,"Victoria, TX MSA",2022,4,44559,42704,1855,4.2
MT4847380000000,48,47380,"Waco, TX MSA",2022,4,139820,134597,5223,3.7
MT4848660000000,48,48660,"Wichita Falls, TX MSA",2022,4,65765,63282,2483,3.8
MT4930860000000,49,30860,"Logan, UT-ID MSA",2022,4,78870,77251,1619,2.1
MT4936260000000,49,36260,"Ogden, UT MSA",2022,4,332429,325037,7392,2.2
MT4939340000000,49,39340,"Provo-Orem-Lehi, UT MSA",2022,4,351602,344088,7514,2.1
MT4941100000000,49,41100,"St. George, UT MSA",2022,4,85865,83638,2227,2.6
MT4941620000000,49,41620,"Salt Lake City-Murray, UT MSA",2022,4,701489,685213,16276,2.3
MT5015540000000,50,15540,"Burlington-South Burlington, VT MSA",2022,4,126141,123545,2596,2.1
MT5113980000000,51,13980,"Blacksburg-Christiansburg-Radford, VA MSA",2022,4,90365,87927,2438,2.7
MT5116820000000,51,16820,"Charlottesville, VA MSA",2022,4,114334,111605,2729,2.4
MT5125500000000,51,25500,"Harrisonburg, VA MSA",2022,4,70449,68761,1688,2.4
MT5131340000000,51,31340,"Lynchburg, VA MSA",2022,4,126250,122781,3469,2.7
MT5140060000000,51,40060,"Richmond, VA MSA",2022,4,695411,677047,18364,2.6
MT5140220000000,51,40220,"Roanoke, VA MSA",2022,4,152739,148750,3989,2.6
MT5144420000000,51,44420,"Staunton-Stuarts Draft, VA MSA",2022,4,63050,61568,1482,2.4
MT5147260000000,51,47260,"Virginia Beach-Chesapeake-Norfolk, VA-NC MSA",2022,4,852741,827843,24898,2.9
MT5149020000000,51,49020,"Winchester, VA-WV MSA",2022,4,73722,71958,1764,2.4
MT5313380000000,53,13380,"Bellingham, WA MSA",2022,4,114253,109617,4636,4.1
MT5314740000000,53,14740,"Bremerton-Silverdale-Port Orchard, WA MSA",2022,4,121998,117132,4866,4
MT5328420000000,53,28420,"Kennewick-Richland, WA MSA",2022,4,145365,138575,6790,4.7
MT5331020000000,53,31020,"Longview-Kelso, WA MSA",2022,4,47621,45334,2287,4.8
MT5334580000000,53,34580,"Mount Vernon-Anacortes, WA MSA",2022,4,58434,55691,2743,4.7
MT5336500000000,53,36500,"Olympia-Lacey-Tumwater, WA MSA",2022,4,139777,134018,5759,4.1
MT5342660000000,53,42660,"Seattle-Tacoma-Bellevue, WA MSA",2022,4,2234324,2154665,79659,3.6
MT5344060000000,53,44060,"Spokane-Spokane Valley, WA MSA",2022,4,280878,269421,11457,4.1
MT5347460000000,53,47460,"Walla Walla, WA MSA",2022,4,29519,28332,1187,4
MT5348300000000,53,48300,"Wenatchee-East Wenatchee, WA MSA",2022,4,62251,59485,2766,4.4
MT5349420000000,53,49420,"Yakima, WA MSA",2022,4,127225,120399,6826,5.4
MT5413220000000,54,13220,"Beckley, WV MSA",2022,4,45189,43411,1778,3.9
MT5416620000000,54,16620,"Charleston, WV MSA",2022,4,89877,86392,3485,3.9
MT5426580000000,54,26580,"Huntington-Ashland, WV-KY-OH MSA",2022,4,155249,148636,6613,4.3
MT5434060000000,54,34060,"Morgantown, WV MSA",2022,4,70951,68316,2635,3.7
MT5437620000000,54,37620,"Parkersburg-Vienna, WV MSA",2022,4,39119,37522,1597,4.1
MT5448540000000,54,48540,"Wheeling, WV-OH MSA",2022,4,59479,56713,2766,4.7
MT5511540000000,55,11540,"Appleton, WI MSA",2022,4,134522,131329,3193,2.4
MT5520740000000,55,20740,"Eau Claire, WI MSA",2022,4,93058,90509,2549,2.7
MT5522540000000,55,22540,"Fond du Lac, WI MSA",2022,4,56395,54993,1402,2.5
MT5524580000000,55,24580,"Green Bay, WI MSA",2022,4,175011,170524,4487,2.6
MT5527500000000,55,27500,"Janesville-Beloit, WI MSA",2022,4,83885,80932,2953,3.5
MT5528450000000,55,28450,"Kenosha, WI MSA",2022,4,92785,89855,2930,3.2
MT5529100000000,55,29100,"La Crosse-Onalaska, WI-MN MSA",2022,4,87938,85750,2188,2.5
MT5531540000000,55,31540,"Madison, WI MSA",2022,4,393410,384775,8635,2.2
MT5533340000000,55,33340,"Milwaukee-Waukesha, WI MSA",2022,4,806385,781317,25068,3.1
MT5536780000000,55,36780,"Oshkosh-Neenah, WI MSA",2022,4,91408,89168,2240,2.5
MT5539540000000,55,39540,"Racine-Mount Pleasant, WI MSA",2022,4,99641,96193,3448,3.5
MT5543100000000,55,43100,"Sheboygan, WI MSA",2022,4,61955,60499,1456,2.4
MT5548140000000,55,48140,"Wausau, WI MSA",2022,4,74741,72953,1788,2.4
MT5616220000000,56,16220,"Casper, WY MSA",2022,4,40752,39216,1536,3.8
MT5616940000000,56,16940,"Cheyenne, WY MSA",2022,4,47959,46305,1654,3.4
MT7210380000000,72,10380,"Aguadilla, PR MSA",2022,4,85817,79630,6187,7.2
MT7211640000000,72,11640,"Arecibo, PR MSA",2022,4,65027,60099,4928,7.6
MT7225020000000,72,25020,"Guayama, PR MSA",2022,4,18877,17283,1594,8.4
MT7232420000000,72,32420,"Mayaguez, PR MSA",2022,4,65690,60790,4900,7.5
MT7238660000000,72,38660,"Ponce, PR MSA",2022,4,87531,80280,7251,8.3
MT7241980000000,72,41980,"San Juan-Bayamon-Caguas, PR MSA",2022,4,803304,760998,42306,5.3
MT0111500000000,1,11500,"Anniston-Oxford, AL MSA",2022,5,49262,47863,1399,2.8
MT0112220000000,1,12220,"Auburn-Opelika, AL MSA",2022,5,92152,89978,2174,2.4
MT0113820000000,1,13820,"Birmingham, AL MSA",2022,5,558665,545551,13114,2.3
MT0119300000000,1,19300,"Daphne-Fairhope-Foley, AL MSA",2022,5,109992,107471,2521,2.3
MT0119460000000,1,19460,"Decatur, AL MSA",2022,5,72466,70845,1621,2.2
MT0120020000000,1,20020,"Dothan, AL MSA",2022,5,66312,64647,1665,2.5
MT0122520000000,1,22520,"Florence-Muscle Shoals, AL MSA",2022,5,67418,65560,1858,2.8
MT0123460000000,1,23460,"Gadsden, AL MSA",2022,5,41180,40032,1148,2.8
MT0126620000000,1,26620,"Huntsville, AL MSA",2022,5,256945,251643,5302,2.1
MT0133660000000,1,33660,"Mobile, AL MSA",2022,5,182887,176943,5944,3.3
MT0133860000000,1,33860,"Montgomery, AL MSA",2022,5,171448,166663,4785,2.8
MT0146220000000,1,46220,"Tuscaloosa, AL MSA",2022,5,120890,117588,3302,2.7
MT0211260000000,2,11260,"Anchorage, AK MSA",2022,5,197823,190132,7691,3.9
MT0221820000000,2,21820,"Fairbanks-College, AK MSA",2022,5,44679,42966,1713,3.8
MT0422380000000,4,22380,"Flagstaff, AZ MSA",2022,5,71912,68762,3150,4.4
MT0429420000000,4,29420,"Lake Havasu City-Kingman, AZ MSA",2022,5,85675,81615,4060,4.7
MT0438060000000,4,38060,"Phoenix-Mesa-Chandler, AZ MSA",2022,5,2583913,2497263,86650,3.4
MT0439150000000,4,39150,"Prescott Valley-Prescott, AZ MSA",2022,5,102865,99138,3727,3.6
MT0443420000000,4,43420,"Sierra Vista-Douglas, AZ MSA",2022,5,47307,45238,2069,4.4
MT0446060000000,4,46060,"Tucson, AZ MSA",2022,5,488507,470080,18427,3.8
MT0449740000000,4,49740,"Yuma, AZ MSA",2022,5,96478,84917,11561,12
MT0522220000000,5,22220,"Fayetteville-Springdale-Rogers, AR MSA",2022,5,288445,281499,6946,2.4
MT0522900000000,5,22900,"Fort Smith, AR-OK MSA",2022,5,100222,97119,3103,3.1
MT0526300000000,5,26300,"Hot Springs, AR MSA",2022,5,43619,42064,1555,3.6
MT0527860000000,5,27860,"Jonesboro, AR MSA",2022,5,64563,62704,1859,2.9
MT0530780000000,5,30780,"Little Rock-North Little Rock-Conway, AR MSA",2022,5,363270,352038,11232,3.1
MT0612540000000,6,12540,"Bakersfield-Delano, CA MSA",2022,5,390327,364307,26020,6.7
MT0617020000000,6,17020,"Chico, CA MSA",2022,5,89687,85821,3866,4.3
MT0620940000000,6,20940,"El Centro, CA MSA",2022,5,67411,57625,9786,14.5
MT0623420000000,6,23420,"Fresno, CA MSA",2022,5,508813,476197,32616,6.4
MT0625260000000,6,25260,"Hanford-Corcoran, CA MSA",2022,5,54301,50473,3828,7
MT0631080000000,6,31080,"Los Angeles-Long Beach-Anaheim, CA MSA",2022,5,6608504,6315042,293462,4.4
MT0632900000000,6,32900,"Merced, CA MSA",2022,5,115220,106357,8863,7.7
MT0633700000000,6,33700,"Modesto, CA MSA",2022,5,244693,232170,12523,5.1
MT0634900000000,6,34900,"Napa, CA MSA",2022,5,70733,68503,2230,3.2
MT0637100000000,6,37100,"Oxnard-Thousand Oaks-Ventura, CA MSA",2022,5,412148,397290,14858,3.6
MT0639820000000,6,39820,"Redding, CA MSA",2022,5,75988,72746,3242,4.3
MT0640140000000,6,40140,"Riverside-San Bernardino-Ontario, CA MSA",2022,5,2137462,2051064,86398,4
MT0640900000000,6,40900,"Sacramento-Roseville-Folsom, CA MSA",2022,5,1136285,1095493,40792,3.6
MT0641500000000,6,41500,"Salinas, CA MSA",2022,5,215812,203206,12606,5.8
MT0641740000000,6,41740,"San Diego-Chula Vista-Carlsbad, CA MSA",2022,5,1606382,1553564,52818,3.3
MT0641860000000,6,41860,"San Francisco-Oakland-Fremont, CA MSA",2022,5,2496880,2424615,72265,2.9
MT0641940000000,6,41940,"San Jose-Sunnyvale-Santa Clara, CA MSA",2022,5,1040679,1012363,28316,2.7
MT0642020000000,6,42020,"San Luis Obispo-Paso Robles, CA MSA",2022,5,131277,127152,4125,3.1
MT0642100000000,6,42100,"Santa Cruz-Watsonville, CA MSA",2022,5,133563,127499,6064,4.5
MT0642200000000,6,42200,"Santa Maria-Santa Barbara, CA MSA",2022,5,217999,210337,7662,3.5
MT0642220000000,6,42220,"Santa Rosa-Petaluma, CA MSA",2022,5,244638,237083,7555,3.1
MT0644700000000,6,44700,"Stockton-Lodi, CA MSA",2022,5,356287,338848,17439,4.9
MT0646700000000,6,46700,"Vallejo, CA MSA",2022,5,209431,201206,8225,3.9
MT0647300000000,6,47300,"Visalia, CA MSA",2022,5,208250,192121,16129,7.7
MT0649700000000,6,49700,"Yuba City, CA MSA",2022,5,77807,73273,4534,5.8
MT0814500000000,8,14500,"Boulder, CO MSA",2022,5,191703,186632,5071,2.6
MT0817820000000,8,17820,"Colorado Springs, CO MSA",2022,5,380179,368435,11744,3.1
MT0819740000000,8,19740,"Denver-Aurora-Centennial, CO MSA",2022,5,1734386,1684535,49851,2.9
MT0822660000000,8,22660,"Fort Collins-Loveland, CO MSA",2022,5,201868,196141,5727,2.8
MT0824300000000,8,24300,"Grand Junction, CO MSA",2022,5,78050,75502,2548,3.3
MT0824540000000,8,24540,"Greeley, CO MSA",2022,5,169523,164036,5487,3.2
MT0839380000000,8,39380,"Pueblo, CO MSA",2022,5,74091,70854,3237,4.4
MT0914860000000,9,14860,"Bridgeport-Stamford-Danbury, CT MSA",2022,5,510155,490180,19975,3.9
MT0925540000000,9,25540,"Hartford-West Hartford-East Hartford, CT MSA",2022,5,612676,586901,25775,4.2
MT0935300000000,9,35300,"New Haven, CT MSA",2022,5,314921,301960,12961,4.1
MT0935980000000,9,35980,"Norwich-New London-Willimantic, CT MSA",2022,5,141357,135166,6191,4.4
MT0947930000000,9,47930,"Waterbury-Shelton, CT MSA",2022,5,241147,230137,11010,4.6
MT1020100000000,10,20100,"Dover, DE MSA",2022,5,84882,80974,3908,4.6
MT1147900000000,11,47900,"Washington-Arlington-Alexandria, DC-VA-MD-WV MSA",2022,5,3438277,3342408,95869,2.8
MT1215980000000,12,15980,"Cape Coral-Fort Myers, FL MSA",2022,5,361038,349893,11145,3.1
MT1218880000000,12,18880,"Crestview-Fort Walton Beach-Destin, FL MSA",2022,5,138416,134832,3584,2.6
MT1219660000000,12,19660,"Deltona-Daytona Beach-Ormond Beach, FL MSA",2022,5,307174,296828,10346,3.4
MT1223540000000,12,23540,"Gainesville, FL MSA",2022,5,164485,159335,5150,3.1
MT1226140000000,12,26140,"Homosassa Springs, FL MSA",2022,5,52179,50048,2131,4.1
MT1227260000000,12,27260,"Jacksonville, FL MSA",2022,5,824811,800111,24700,3
MT1229460000000,12,29460,"Lakeland-Winter Haven, FL MSA",2022,5,344130,331711,12419,3.6
MT1233100000000,12,33100,"Miami-Fort Lauderdale-West Palm Beach, FL MSA",2022,5,3170049,3079121,90928,2.9
MT1234940000000,12,34940,"Naples-Marco Island, FL MSA",2022,5,174499,169150,5349,3.1
MT1235840000000,12,35840,"North Port-Bradenton-Sarasota, FL MSA",2022,5,372692,361418,11274,3
MT1236100000000,12,36100,"Ocala, FL MSA",2022,5,150932,145543,5389,3.6
MT1236740000000,12,36740,"Orlando-Kissimmee-Sanford, FL MSA",2022,5,1447509,1404203,43306,3
MT1237340000000,12,37340,"Palm Bay-Melbourne-Titusville, FL MSA",2022,5,292308,283530,8778,3
MT1237460000000,12,37460,"Panama City-Panama City Beach, FL MSA",2022,5,96848,93978,2870,3
MT1237860000000,12,37860,"Pensacola-Ferry Pass-Brent, FL MSA",2022,5,234072,227019,7053,3
MT1238940000000,12,38940,"Port St. Lucie, FL MSA",2022,5,228626,220919,7707,3.4
MT1239460000000,12,39460,"Punta Gorda, FL MSA",2022,5,71876,69298,2578,3.6
MT1242680000000,12,42680,"Sebastian-Vero Beach-West Vero Corridor, FL MSA",2022,5,65437,63012,2425,3.7
MT1242700000000,12,42700,"Sebring, FL MSA",2022,5,35399,33889,1510,4.3
MT1245220000000,12,45220,"Tallahassee, FL MSA",2022,5,199964,193735,6229,3.1
MT1245300000000,12,45300,"Tampa-St. Petersburg-Clearwater, FL MSA",2022,5,1635906,1588661,47245,2.9
MT1248680000000,12,48680,"Wildwood-The Villages, FL MSA",2022,5,31724,30161,1563,4.9
MT1310500000000,13,10500,"Albany, GA MSA",2022,5,62967,60542,2425,3.9
MT1312020000000,13,12020,"Athens-Clarke County, GA MSA",2022,5,102450,99449,3001,2.9
MT1312060000000,13,12060,"Atlanta-Sandy Springs-Roswell, GA MSA",2022,5,3186971,3092929,94042,3
MT1312260000000,13,12260,"Augusta-Richmond County, GA-SC MSA",2022,5,264124,254834,9290,3.5
MT1315260000000,13,15260,"Brunswick-St. Simons, GA MSA",2022,5,52214,50651,1563,3
MT1317980000000,13,17980,"Columbus, GA-AL MSA",2022,5,129293,124742,4551,3.5
MT1319140000000,13,19140,"Dalton, GA MSA",2022,5,66687,64408,2279,3.4
MT1323580000000,13,23580,"Gainesville, GA MSA",2022,5,103161,100574,2587,2.5
MT1325980000000,13,25980,"Hinesville, GA MSA",2022,5,30703,29539,1164,3.8
MT1331420000000,13,31420,"Macon-Bibb County, GA MSA",2022,5,97816,94320,3496,3.6
MT1340660000000,13,40660,"Rome, GA MSA",2022,5,44718,43321,1397,3.1
MT1342340000000,13,42340,"Savannah, GA MSA",2022,5,203609,197638,5971,2.9
MT1346660000000,13,46660,"Valdosta, GA MSA",2022,5,61347,59319,2028,3.3
MT1347580000000,13,47580,"Warner Robins, GA MSA",2022,5,88446,85688,2758,3.1
MT1527980000000,15,27980,"Kahului-Wailuku, HI MSA",2022,5,82872,80111,2761,3.3
MT1546520000000,15,46520,"Urban Honolulu, HI MSA",2022,5,465702,450803,14899,3.2
MT1614260000000,16,14260,"Boise City, ID MSA",2022,5,423085,412087,10998,2.6
MT1617660000000,16,17660,"Coeur d'Alene, ID MSA",2022,5,86004,83113,2891,3.4
MT1626820000000,16,26820,"Idaho Falls, ID MSA",2022,5,80299,78277,2022,2.5
MT1630300000000,16,30300,"Lewiston, ID-WA MSA",2022,5,30396,29469,927,3
MT1638540000000,16,38540,"Pocatello, ID MSA",2022,5,39161,37896,1265,3.2
MT1646300000000,16,46300,"Twin Falls, ID MSA",2022,5,58992,57372,1620,2.7
MT1714010000000,17,14010,"Bloomington, IL MSA",2022,5,91208,87887,3321,3.6
MT1716580000000,17,16580,"Champaign-Urbana, IL MSA",2022,5,123187,118344,4843,3.9
MT1716980000000,17,16980,"Chicago-Naperville-Elgin, IL-IN MSA",2022,5,4865924,4640906,225018,4.6
MT1719340000000,17,19340,"Davenport-Moline-Rock Island, IA-IL MSA",2022,5,189444,182111,7333,3.9
MT1719500000000,17,19500,"Decatur, IL MSA",2022,5,45145,42498,2647,5.9
MT1728100000000,17,28100,"Kankakee, IL MSA",2022,5,50686,47909,2777,5.5
MT1737900000000,17,37900,"Peoria, IL MSA",2022,5,173144,165091,8053,4.7
MT1740420000000,17,40420,"Rockford, IL MSA",2022,5,160192,150270,9922,6.2
MT1744100000000,17,44100,"Springfield, IL MSA",2022,5,102144,97659,4485,4.4
MT1814020000000,18,14020,"Bloomington, IN MSA",2022,5,83716,81575,2141,2.6
MT1818020000000,18,18020,"Columbus, IN MSA",2022,5,39273,38238,1035,2.6
MT1821140000000,18,21140,"Elkhart-Goshen, IN MSA",2022,5,108113,105323,2790,2.6
MT1821780000000,18,21780,"Evansville, IN MSA",2022,5,134955,131015,3940,2.9
MT1823060000000,18,23060,"Fort Wayne, IN MSA",2022,5,227051,220730,6321,2.8
MT1826900000000,18,26900,"Indianapolis-Carmel-Greenwood, IN MSA",2022,5,1096937,1065758,31179,2.8
MT1829020000000,18,29020,"Kokomo, IN MSA",2022,5,35691,34169,1522,4.3
MT1829200000000,18,29200,"Lafayette-West Lafayette, IN MSA",2022,5,116198,113001,3197,2.8
MT1833140000000,18,33140,"Michigan City-La Porte, IN MSA",2022,5,50463,48719,1744,3.5
MT1834620000000,18,34620,"Muncie, IN MSA",2022,5,51424,49604,1820,3.5
MT1843780000000,18,43780,"South Bend-Mishawaka, IN-MI MSA",2022,5,154641,149125,5516,3.6
MT1845460000000,18,45460,"Terre Haute, IN MSA",2022,5,76934,74396,2538,3.3
MT1911180000000,19,11180,"Ames, IA MSA",2022,5,68766,67301,1465,2.1
MT1916300000000,19,16300,"Cedar Rapids, IA MSA",2022,5,149221,144936,4285,2.9
MT1919780000000,19,19780,"Des Moines-West Des Moines, IA MSA",2022,5,397547,387366,10181,2.6
MT1920220000000,19,20220,"Dubuque, IA MSA",2022,5,53876,52371,1505,2.8
MT1926980000000,19,26980,"Iowa City, IA MSA",2022,5,98497,96248,2249,2.3
MT1943580000000,19,43580,"Sioux City, IA-NE-SD MSA",2022,5,76254,74252,2002,2.6
MT1947940000000,19,47940,"Waterloo-Cedar Falls, IA MSA",2022,5,89210,86890,2320,2.6
MT2029940000000,20,29940,"Lawrence, KS MSA",2022,5,68477,66844,1633,2.4
MT2031740000000,20,31740,"Manhattan, KS MSA",2022,5,62839,61212,1627,2.6
MT2045820000000,20,45820,"Topeka, KS MSA",2022,5,116245,112950,3295,2.8
MT2048620000000,20,48620,"Wichita, KS MSA",2022,5,324549,314839,9710,3
MT2114540000000,21,14540,"Bowling Green, KY MSA",2022,5,88350,85161,3189,3.6
MT2121060000000,21,21060,"Elizabethtown, KY MSA",2022,5,53571,51277,2294,4.3
MT2130460000000,21,30460,"Lexington-Fayette, KY MSA",2022,5,267842,259245,8597,3.2
MT2131140000000,21,31140,"Louisville/Jefferson County, KY-IN MSA",2022,5,686256,662598,23658,3.4
MT2136980000000,21,36980,"Owensboro, KY MSA",2022,5,51134,49183,1951,3.8
MT2137140000000,21,37140,"Paducah, KY-IL MSA",2022,5,45525,43557,1968,4.3
MT2210780000000,22,10780,"Alexandria, LA MSA",2022,5,65368,63295,2073,3.2
MT2212940000000,22,12940,"Baton Rouge, LA MSA",2022,5,420655,405760,14895,3.5
MT2225220000000,22,25220,"Hammond, LA MSA",2022,5,59201,56755,2446,4.1
MT2226380000000,22,26380,"Houma-Bayou Cane-Thibodaux, LA MSA",2022,5,86306,83228,3078,3.6
MT2229180000000,22,29180,"Lafayette, LA MSA",2022,5,195596,189455,6141,3.1
MT2229340000000,22,29340,"Lake Charles, LA MSA",2022,5,99662,95899,3763,3.8
MT2233740000000,22,33740,"Monroe, LA MSA",2022,5,96538,92713,3825,4
MT2235380000000,22,35380,"New Orleans-Metairie, LA MSA",2022,5,469180,450422,18758,4
MT2243340000000,22,43340,"Shreveport-Bossier City, LA MSA",2022,5,168667,162363,6304,3.7
MT2243640000000,22,43640,"Slidell-Mandeville-Covington, LA MSA",2022,5,126273,122690,3583,2.8
MT2312620000000,23,12620,"Bangor, ME MSA",2022,5,72881,70741,2140,2.9
MT2330340000000,23,30340,"Lewiston-Auburn, ME MSA",2022,5,53842,52347,1495,2.8
MT2338860000000,23,38860,"Portland-South Portland, ME MSA",2022,5,300594,293558,7036,2.3
MT2412580000000,24,12580,"Baltimore-Columbia-Towson, MD MSA",2022,5,1456061,1411405,44656,3.1
MT2425180000000,24,25180,"Hagerstown-Martinsburg, MD-WV MSA",2022,5,141409,137084,4325,3.1
MT2430500000000,24,30500,"Lexington Park, MD MSA",2022,5,104691,101675,3016,2.9
MT2441540000000,24,41540,"Salisbury, MD MSA",2022,5,61675,59453,2222,3.6
MT2511200000000,25,11200,"Amherst Town-Northampton, MA MSA",2022,5,84302,81362,2940,3.5
MT2512700000000,25,12700,"Barnstable Town, MA MSA",2022,5,113026,107819,5207,4.6
MT2514460000000,25,14460,"Boston-Cambridge-Newton, MA-NH MSA",2022,5,2729477,2641126,88351,3.2
MT2538340000000,25,38340,"Pittsfield, MA MSA",2022,5,63743,61141,2602,4.1
MT2544140000000,25,44140,"Springfield, MA MSA",2022,5,222990,212438,10552,4.7
MT2549340000000,25,49340,"Worcester, MA MSA",2022,5,452134,435236,16898,3.7
MT2611460000000,26,11460,"Ann Arbor, MI MSA",2022,5,199173,192332,6841,3.4
MT2612980000000,26,12980,"Battle Creek, MI MSA",2022,5,59365,56617,2748,4.6
MT2613020000000,26,13020,"Bay City, MI MSA",2022,5,48320,45880,2440,5
MT2619820000000,26,19820,"Detroit-Warren-Dearborn, MI MSA",2022,5,2116434,2035455,80979,3.8
MT2622420000000,26,22420,"Flint, MI MSA",2022,5,180173,170694,9479,5.3
MT2624340000000,26,24340,"Grand Rapids-Wyoming-Kentwood, MI MSA",2022,5,600445,579424,21021,3.5
MT2627100000000,26,27100,"Jackson, MI MSA",2022,5,73219,69965,3254,4.4
MT2628020000000,26,28020,"Kalamazoo-Portage, MI MSA",2022,5,134245,129298,4947,3.7
MT2629620000000,26,29620,"Lansing-East Lansing, MI MSA",2022,5,239559,229126,10433,4.4
MT2633220000000,26,33220,"Midland, MI MSA",2022,5,40049,38392,1657,4.1
MT2633780000000,26,33780,"Monroe, MI MSA",2022,5,74854,71246,3608,4.8
MT2634740000000,26,34740,"Muskegon-Norton Shores, MI MSA",2022,5,81366,77656,3710,4.6
MT2635660000000,26,35660,"Niles, MI MSA",2022,5,73209,70089,3120,4.3
MT2640980000000,26,40980,"Saginaw, MI MSA",2022,5,83008,78580,4428,5.3
MT2645900000000,26,45900,"Traverse City, MI MSA",2022,5,77968,74805,3163,4.1
MT2720260000000,27,20260,"Duluth, MN-WI MSA",2022,5,137779,133467,4312,3.1
MT2731860000000,27,31860,"Mankato, MN MSA",2022,5,58457,57352,1105,1.9
MT2733460000000,27,33460,"Minneapolis-St. Paul-Bloomington, MN-WI MSA",2022,5,2037305,1993466,43839,2.2
MT2740340000000,27,40340,"Rochester, MN MSA",2022,5,123798,121265,2533,2
MT2741060000000,27,41060,"St. Cloud, MN MSA",2022,5,107688,105016,2672,2.5
MT2825060000000,28,25060,"Gulfport-Biloxi, MS MSA",2022,5,183859,177152,6707,3.6
MT2825620000000,28,25620,"Hattiesburg, MS MSA",2022,5,70170,67726,2444,3.5
MT2827140000000,28,27140,"Jackson, MS MSA",2022,5,276249,266651,9598,3.5
MT2916020000000,29,16020,"Cape Girardeau, MO-IL MSA",2022,5,47724,46635,1089,2.3
MT2917860000000,29,17860,"Columbia, MO MSA",2022,5,112638,110478,2160,1.9
MT2927620000000,29,27620,"Jefferson City, MO MSA",2022,5,73256,71806,1450,2
MT2927900000000,29,27900,"Joplin, MO-KS MSA",2022,5,94992,92893,2099,2.2
MT2928140000000,29,28140,"Kansas City, MO-KS MSA",2022,5,1153814,1124726,29088,2.5
MT2941140000000,29,41140,"St. Joseph, MO-KS MSA",2022,5,54294,52956,1338,2.5
MT2941180000000,29,41180,"St. Louis, MO-IL MSA",2022,5,1444245,1405033,39212,2.7
MT2944180000000,29,44180,"Springfield, MO MSA",2022,5,233797,228999,4798,2.1
MT3013740000000,30,13740,"Billings, MT MSA",2022,5,99099,96639,2460,2.5
MT3014580000000,30,14580,"Bozeman, MT MSA",2022,5,74491,72977,1514,2
MT3024500000000,30,24500,"Great Falls, MT MSA",2022,5,39876,38788,1088,2.7
MT3025740000000,30,25740,"Helena, MT MSA",2022,5,46287,45072,1215,2.6
MT3033540000000,30,33540,"Missoula, MT MSA",2022,5,72170,70278,1892,2.6
MT3124260000000,31,24260,"Grand Island, NE MSA",2022,5,41543,40654,889,2.1
MT3130700000000,31,30700,"Lincoln, NE MSA",2022,5,188864,185103,3761,2
MT3136540000000,31,36540,"Omaha, NE-IA MSA",2022,5,515691,503919,11772,2.3
MT3216180000000,32,16180,"Carson City, NV MSA",2022,5,27837,26660,1177,4.2
MT3229820000000,32,29820,"Las Vegas-Henderson-North Las Vegas, NV MSA",2022,5,1138579,1075058,63521,5.6
MT3239900000000,32,39900,"Reno, NV MSA",2022,5,288398,276663,11735,4.1
MT3331700000000,33,31700,"Manchester-Nashua, NH MSA",2022,5,238813,233210,5603,2.3
MT3412100000000,34,12100,"Atlantic City-Hammonton, NJ MSA",2022,5,177153,167610,9543,5.4
MT3445940000000,34,45940,"Trenton-Princeton, NJ MSA",2022,5,194259,187386,6873,3.5
MT3447220000000,34,47220,"Vineland, NJ MSA",2022,5,64750,61230,3520,5.4
MT3510740000000,35,10740,"Albuquerque, NM MSA",2022,5,446918,429949,16969,3.8
MT3522140000000,35,22140,"Farmington, NM MSA",2022,5,47798,45495,2303,4.8
MT3529740000000,35,29740,"Las Cruces, NM MSA",2022,5,97105,92619,4486,4.6
MT3542140000000,35,42140,"Santa Fe, NM MSA",2022,5,72877,70149,2728,3.7
MT3610580000000,36,10580,"Albany-Schenectady-Troy, NY MSA",2022,5,452332,438365,13967,3.1
MT3613780000000,36,13780,"Binghamton, NY MSA",2022,5,105773,101792,3981,3.8
MT3615380000000,36,15380,"Buffalo-Cheektowaga, NY MSA",2022,5,556551,536318,20233,3.6
MT3621300000000,36,21300,"Elmira, NY MSA",2022,5,35948,34681,1267,3.5
MT3624020000000,36,24020,"Glens Falls, NY MSA",2022,5,59572,57539,2033,3.4
MT3627060000000,36,27060,"Ithaca, NY MSA",2022,5,47796,46395,1401,2.9
MT3628740000000,36,28740,"Kingston, NY MSA",2022,5,85916,83061,2855,3.3
MT3628880000000,36,28880,"Kiryas Joel-Poughkeepsie-Newburgh, NY MSA",2022,5,332863,321879,10984,3.3
MT3635620000000,36,35620,"New York-Newark-Jersey City, NY-NJ MSA",2022,5,9870072,9437092,432980,4.4
MT3640380000000,36,40380,"Rochester, NY MSA",2022,5,511076,493351,17725,3.5
MT3645060000000,36,45060,"Syracuse, NY MSA",2022,5,309681,298751,10930,3.5
MT3646540000000,36,46540,"Utica-Rome, NY MSA",2022,5,127697,123063,4634,3.6
MT3648060000000,36,48060,"Watertown-Fort Drum, NY MSA",2022,5,44960,43102,1858,4.1
MT3711700000000,37,11700,"Asheville, NC MSA",2022,5,207851,201369,6482,3.1
MT3715500000000,37,15500,"Burlington, NC MSA",2022,5,83391,80286,3105,3.7
MT3716740000000,37,16740,"Charlotte-Concord-Gastonia, NC-SC MSA",2022,5,1439071,1389209,49862,3.5
MT3720500000000,37,20500,"Durham-Chapel Hill, NC MSA",2022,5,315058,304846,10212,3.2
MT3722180000000,37,22180,"Fayetteville, NC MSA",2022,5,153528,146155,7373,4.8
MT3724140000000,37,24140,"Goldsboro, NC MSA",2022,5,49743,47752,1991,4
MT3724660000000,37,24660,"Greensboro-High Point, NC MSA",2022,5,373620,358839,14781,4
MT3724780000000,37,24780,"Greenville, NC MSA",2022,5,82031,78628,3403,4.1
MT3725860000000,37,25860,"Hickory-Lenoir-Morganton, NC MSA",2022,5,172504,166458,6046,3.5
MT3727340000000,37,27340,"Jacksonville, NC MSA",2022,5,72294,69429,2865,4
MT3738240000000,37,38240,"Pinehurst-Southern Pines, NC MSA",2022,5,43146,41578,1568,3.6
MT3739580000000,37,39580,"Raleigh-Cary, NC MSA",2022,5,808121,783333,24788,3.1
MT3740580000000,37,40580,"Rocky Mount, NC MSA",2022,5,63926,60517,3409,5.3
MT3748900000000,37,48900,"Wilmington, NC MSA",2022,5,214577,206497,8080,3.8
MT3749180000000,37,49180,"Winston-Salem, NC MSA",2022,5,325123,313090,12033,3.7
MT3813900000000,38,13900,"Bismarck, ND MSA",2022,5,72682,71208,1474,2
MT3822020000000,38,22020,"Fargo, ND-MN MSA",2022,5,149465,146777,2688,1.8
MT3824220000000,38,24220,"Grand Forks, ND-MN MSA",2022,5,54462,53364,1098,2
MT3833500000000,38,33500,"Minot, ND MSA",2022,5,39620,38781,839,2.1
MT3910420000000,39,10420,"Akron, OH MSA",2022,5,352776,338974,13802,3.9
MT3915940000000,39,15940,"Canton-Massillon, OH MSA",2022,5,189304,181606,7698,4.1
MT3917140000000,39,17140,"Cincinnati, OH-KY-IN MSA",2022,5,1146011,1106442,39569,3.5
MT3917410000000,39,17410,"Cleveland, OH MSA",2022,5,1074040,1023794,50246,4.7
MT3918140000000,39,18140,"Columbus, OH MSA",2022,5,1119759,1082032,37727,3.4
MT3919430000000,39,19430,"Dayton-Kettering-Beavercreek, OH MSA",2022,5,382435,367733,14702,3.8
MT3930620000000,39,30620,"Lima, OH MSA",2022,5,47129,45288,1841,3.9
MT3931900000000,39,31900,"Mansfield, OH MSA",2022,5,52275,49970,2305,4.4
MT3941780000000,39,41780,"Sandusky, OH MSA",2022,5,56977,53901,3076,5.4
MT3944220000000,39,44220,"Springfield, OH MSA",2022,5,61419,58838,2581,4.2
MT3945780000000,39,45780,"Toledo, OH MSA",2022,5,289487,277579,11908,4.1
MT3948260000000,39,48260,"Weirton-Steubenville, WV-OH MSA",2022,5,52751,50247,2504,4.7
MT3949660000000,39,49660,"Youngstown-Warren, OH MSA",2022,5,188534,179877,8657,4.6
MT4021420000000,40,21420,"Enid, OK MSA",2022,5,28790,28011,779,2.7
MT4030020000000,40,30020,"Lawton, OK MSA",2022,5,50815,49009,1806,3.6
MT4036420000000,40,36420,"Oklahoma City, OK MSA",2022,5,727295,707194,20101,2.8
MT4046140000000,40,46140,"Tulsa, OK MSA",2022,5,495559,480159,15400,3.1
MT4110540000000,41,10540,"Albany, OR MSA",2022,5,61446,58873,2573,4.2
MT4113460000000,41,13460,"Bend, OR MSA",2022,5,126899,121931,4968,3.9
MT4118700000000,41,18700,"Corvallis, OR MSA",2022,5,48511,46871,1640,3.4
MT4121660000000,41,21660,"Eugene-Springfield, OR MSA",2022,5,186312,178826,7486,4
MT4124420000000,41,24420,"Grants Pass, OR MSA",2022,5,35279,33454,1825,5.2
MT4132780000000,41,32780,"Medford, OR MSA",2022,5,105125,100748,4377,4.2
MT4138900000000,41,38900,"Portland-Vancouver-Hillsboro, OR-WA MSA",2022,5,1370026,1322421,47605,3.5
MT4141420000000,41,41420,"Salem, OR MSA",2022,5,214211,206010,8201,3.8
MT4210900000000,42,10900,"Allentown-Bethlehem-Easton, PA-NJ MSA",2022,5,443631,425100,18531,4.2
MT4211020000000,42,11020,"Altoona, PA MSA",2022,5,57247,54701,2546,4.4
MT4216540000000,42,16540,"Chambersburg, PA MSA",2022,5,76886,74139,2747,3.6
MT4221500000000,42,21500,"Erie, PA MSA",2022,5,126102,120160,5942,4.7
MT4223900000000,42,23900,"Gettysburg, PA MSA",2022,5,51943,50134,1809,3.5
MT4225420000000,42,25420,"Harrisburg-Carlisle, PA MSA",2022,5,305643,294621,11022,3.6
MT4227780000000,42,27780,"Johnstown, PA MSA",2022,5,56939,54032,2907,5.1
MT4229540000000,42,29540,"Lancaster, PA MSA",2022,5,289023,279059,9964,3.4
MT4230140000000,42,30140,"Lebanon, PA MSA",2022,5,70914,68259,2655,3.7
MT4237980000000,42,37980,"Philadelphia-Camden-Wilmington, PA-NJ-DE-MD MSA",2022,5,3220259,3091828,128431,4
MT4238300000000,42,38300,"Pittsburgh, PA MSA",2022,5,1220486,1167469,53017,4.3
MT4239740000000,42,39740,"Reading, PA MSA",2022,5,215411,206432,8979,4.2
MT4242540000000,42,42540,"Scranton--Wilkes-Barre, PA MSA",2022,5,276756,263338,13418,4.8
MT4244300000000,42,44300,"State College, PA MSA",2022,5,75206,72587,2619,3.5
MT4248700000000,42,48700,"Williamsport, PA MSA",2022,5,52203,49662,2541,4.9
MT4249620000000,42,49620,"York-Hanover, PA MSA",2022,5,236536,227737,8799,3.7
MT4439300000000,44,39300,"Providence-Warwick, RI-MA MSA",2022,5,872770,841074,31696,3.6
MT4516700000000,45,16700,"Charleston-North Charleston, SC MSA",2022,5,407821,396339,11482,2.8
MT4517900000000,45,17900,"Columbia, SC MSA",2022,5,399542,387358,12184,3
MT4522500000000,45,22500,"Florence, SC MSA",2022,5,89546,86431,3115,3.5
MT4524860000000,45,24860,"Greenville-Anderson-Greer, SC MSA",2022,5,454861,442027,12834,2.8
MT4525940000000,45,25940,"Hilton Head Island-Bluffton-Port Royal, SC MSA",2022,5,92560,89824,2736,3
MT4534820000000,45,34820,"Myrtle Beach-Conway-North Myrtle Beach, SC MSA",2022,5,159176,153166,6010,3.8
MT4543900000000,45,43900,"Spartanburg, SC MSA",2022,5,167255,161830,5425,3.2
MT4544940000000,45,44940,"Sumter, SC MSA",2022,5,41847,40323,1524,3.6
MT4639660000000,46,39660,"Rapid City, SD MSA",2022,5,77713,76248,1465,1.9
MT4643620000000,46,43620,"Sioux Falls, SD-MN MSA",2022,5,167227,164424,2803,1.7
MT4716860000000,47,16860,"Chattanooga, TN-GA MSA",2022,5,275443,266541,8902,3.2
MT4717300000000,47,17300,"Clarksville, TN-KY MSA",2022,5,134469,129347,5122,3.8
MT4717420000000,47,17420,"Cleveland, TN MSA",2022,5,57487,55456,2031,3.5
MT4727180000000,47,27180,"Jackson, TN MSA",2022,5,78498,75609,2889,3.7
MT4727740000000,47,27740,"Johnson City, TN MSA",2022,5,96642,93424,3218,3.3
MT4728700000000,47,28700,"Kingsport-Bristol, TN-VA MSA",2022,5,130783,126262,4521,3.5
MT4728940000000,47,28940,"Knoxville, TN MSA",2022,5,442253,428310,13943,3.2
MT4732820000000,47,32820,"Memphis, TN-MS-AR MSA",2022,5,639449,613859,25590,4
MT4734100000000,47,34100,"Morristown, TN MSA",2022,5,53122,51178,1944,3.7
MT4734980000000,47,34980,"Nashville-Davidson--Murfreesboro--Franklin, TN MSA",2022,5,1129391,1098277,31114,2.8
MT4810180000000,48,10180,"Abilene, TX MSA",2022,5,82234,79451,2783,3.4
MT4811100000000,48,11100,"Amarillo, TX MSA",2022,5,132629,128574,4055,3.1
MT4812420000000,48,12420,"Austin-Round Rock-San Marcos, TX MSA",2022,5,1385588,1344906,40682,2.9
MT4813140000000,48,13140,"Beaumont-Port Arthur, TX MSA",2022,5,169423,160087,9336,5.5
MT4815180000000,48,15180,"Brownsville-Harlingen, TX MSA",2022,5,180732,170792,9940,5.5
MT4817780000000,48,17780,"College Station-Bryan, TX MSA",2022,5,140588,135931,4657,3.3
MT4818580000000,48,18580,"Corpus Christi, TX MSA",2022,5,200981,191212,9769,4.9
MT4819100000000,48,19100,"Dallas-Fort Worth-Arlington, TX MSA",2022,5,4219794,4072577,147217,3.5
MT4820580000000,48,20580,"Eagle Pass, TX MSA",2022,5,23249,21433,1816,7.8
MT4821340000000,48,21340,"El Paso, TX MSA",2022,5,388404,372648,15756,4.1
MT4826420000000,48,26420,"Houston-Pasadena-The Woodlands, TX MSA",2022,5,3583392,3435863,147529,4.1
MT4828660000000,48,28660,"Killeen-Temple, TX MSA",2022,5,194034,185923,8111,4.2
MT4829700000000,48,29700,"Laredo, TX MSA",2022,5,112132,107489,4643,4.1
MT4830980000000,48,30980,"Longview, TX MSA",2022,5,125809,120477,5332,4.2
MT4831180000000,48,31180,"Lubbock, TX MSA",2022,5,176693,170699,5994,3.4
MT4832580000000,48,32580,"McAllen-Edinburg-Mission, TX MSA",2022,5,377273,353304,23969,6.4
MT4833260000000,48,33260,"Midland, TX MSA",2022,5,92811,89700,3111,3.4
MT4836220000000,48,36220,"Odessa, TX MSA",2022,5,79584,76462,3122,3.9
MT4841660000000,48,41660,"San Angelo, TX MSA",2022,5,59119,57262,1857,3.1
MT4841700000000,48,41700,"San Antonio-New Braunfels, TX MSA",2022,5,1256943,1211339,45604,3.6
MT4843300000000,48,43300,"Sherman-Denison, TX MSA",2022,5,66687,64292,2395,3.6
MT4845500000000,48,45500,"Texarkana, TX-AR MSA",2022,5,60402,57754,2648,4.4
MT4846340000000,48,46340,"Tyler, TX MSA",2022,5,112206,107986,4220,3.8
MT4847020000000,48,47020,"Victoria, TX MSA",2022,5,44407,42613,1794,4
MT4847380000000,48,47380,"Waco, TX MSA",2022,5,139511,134381,5130,3.7
MT4848660000000,48,48660,"Wichita Falls, TX MSA",2022,5,65723,63274,2449,3.7
MT4930860000000,49,30860,"Logan, UT-ID MSA",2022,5,78841,77209,1632,2.1
MT4936260000000,49,36260,"Ogden, UT MSA",2022,5,332891,325450,7441,2.2
MT4939340000000,49,39340,"Provo-Orem-Lehi, UT MSA",2022,5,352505,344851,7654,2.2
MT4941100000000,49,41100,"St. George, UT MSA",2022,5,86027,83782,2245,2.6
MT4941620000000,49,41620,"Salt Lake City-Murray, UT MSA",2022,5,703424,687029,16395,2.3
MT5015540000000,50,15540,"Burlington-South Burlington, VT MSA",2022,5,126228,123681,2547,2
MT5113980000000,51,13980,"Blacksburg-Christiansburg-Radford, VA MSA",2022,5,90642,88172,2470,2.7
MT5116820000000,51,16820,"Charlottesville, VA MSA",2022,5,114609,111835,2774,2.4
MT5125500000000,51,25500,"Harrisonburg, VA MSA",2022,5,70623,68881,1742,2.5
MT5131340000000,51,31340,"Lynchburg, VA MSA",2022,5,126309,122741,3568,2.8
MT5140060000000,51,40060,"Richmond, VA MSA",2022,5,697654,678738,18916,2.7
MT5140220000000,51,40220,"Roanoke, VA MSA",2022,5,153266,149151,4115,2.7
MT5144420000000,51,44420,"Staunton-Stuarts Draft, VA MSA",2022,5,63319,61784,1535,2.4
MT5147260000000,51,47260,"Virginia Beach-Chesapeake-Norfolk, VA-NC MSA",2022,5,854111,828671,25440,3
MT5149020000000,51,49020,"Winchester, VA-WV MSA",2022,5,73936,72123,1813,2.5
MT5313380000000,53,13380,"Bellingham, WA MSA",2022,5,114200,109545,4655,4.1
MT5314740000000,53,14740,"Bremerton-Silverdale-Port Orchard, WA MSA",2022,5,121829,116949,4880,4
MT5328420000000,53,28420,"Kennewick-Richland, WA MSA",2022,5,145359,138498,6861,4.7
MT5331020000000,53,31020,"Longview-Kelso, WA MSA",2022,5,47630,45332,2298,4.8
MT5334580000000,53,34580,"Mount Vernon-Anacortes, WA MSA",2022,5,58314,55556,2758,4.7
MT5336500000000,53,36500,"Olympia-Lacey-Tumwater, WA MSA",2022,5,139761,133991,5770,4.1
MT5342660000000,53,42660,"Seattle-Tacoma-Bellevue, WA MSA",2022,5,2240309,2160257,80052,3.6
MT5344060000000,53,44060,"Spokane-Spokane Valley, WA MSA",2022,5,280918,269283,11635,4.1
MT5347460000000,53,47460,"Walla Walla, WA MSA",2022,5,29539,28340,1199,4.1
MT5348300000000,53,48300,"Wenatchee-East Wenatchee, WA MSA",2022,5,62253,59463,2790,4.5
MT5349420000000,53,49420,"Yakima, WA MSA",2022,5,127348,120426,6922,5.4
MT5413220000000,54,13220,"Beckley, WV MSA",2022,5,45264,43443,1821,4
MT5416620000000,54,16620,"Charleston, WV MSA",2022,5,89770,86280,3490,3.9
MT5426580000000,54,26580,"Huntington-Ashland, WV-KY-OH MSA",2022,5,154971,148320,6651,4.3
MT5434060000000,54,34060,"Morgantown, WV MSA",2022,5,70874,68229,2645,3.7
MT5437620000000,54,37620,"Parkersburg-Vienna, WV MSA",2022,5,39131,37539,1592,4.1
MT5448540000000,54,48540,"Wheeling, WV-OH MSA",2022,5,59351,56542,2809,4.7
MT5511540000000,55,11540,"Appleton, WI MSA",2022,5,134555,131343,3212,2.4
MT5520740000000,55,20740,"Eau Claire, WI MSA",2022,5,93206,90674,2532,2.7
MT5522540000000,55,22540,"Fond du Lac, WI MSA",2022,5,56246,54854,1392,2.5
MT5524580000000,55,24580,"Green Bay, WI MSA",2022,5,174818,170350,4468,2.6
MT5527500000000,55,27500,"Janesville-Beloit, WI MSA",2022,5,83835,80897,2938,3.5
MT5528450000000,55,28450,"Kenosha, WI MSA",2022,5,92661,89797,2864,3.1
MT5529100000000,55,29100,"La Crosse-Onalaska, WI-MN MSA",2022,5,87835,85645,2190,2.5
MT5531540000000,55,31540,"Madison, WI MSA",2022,5,393739,385113,8626,2.2
MT5533340000000,55,33340,"Milwaukee-Waukesha, WI MSA",2022,5,806345,781879,24466,3
MT5536780000000,55,36780,"Oshkosh-Neenah, WI MSA",2022,5,91445,89209,2236,2.4
MT5539540000000,55,39540,"Racine-Mount Pleasant, WI MSA",2022,5,99646,96240,3406,3.4
MT5543100000000,55,43100,"Sheboygan, WI MSA",2022,5,61862,60417,1445,2.3
MT5548140000000,55,48140,"Wausau, WI MSA",2022,5,74648,72859,1789,2.4
MT5616220000000,56,16220,"Casper, WY MSA",2022,5,40927,39413,1514,3.7
MT5616940000000,56,16940,"Cheyenne, WY MSA",2022,5,48058,46395,1663,3.5
MT7210380000000,72,10380,"Aguadilla, PR MSA",2022,5,85649,79544,6105,7.1
MT7211640000000,72,11640,"Arecibo, PR MSA",2022,5,64783,59953,4830,7.5
MT7225020000000,72,25020,"Guayama, PR MSA",2022,5,18608,17019,1589,8.5
MT7232420000000,72,32420,"Mayaguez, PR MSA",2022,5,65065,60306,4759,7.3
MT7238660000000,72,38660,"Ponce, PR MSA",2022,5,86712,79561,7151,8.2
MT7241980000000,72,41980,"San Juan-Bayamon-Caguas, PR MSA",2022,5,795586,754392,41194,5.2
MT0111500000000,1,11500,"Anniston-Oxford, AL MSA",2022,6,49171,47786,1385,2.8
MT0112220000000,1,12220,"Auburn-Opelika, AL MSA",2022,6,92168,90002,2166,2.4
MT0113820000000,1,13820,"Birmingham, AL MSA",2022,6,558446,545422,13024,2.3
MT0119300000000,1,19300,"Daphne-Fairhope-Foley, AL MSA",2022,6,109963,107409,2554,2.3
MT0119460000000,1,19460,"Decatur, AL MSA",2022,6,72504,70859,1645,2.3
MT0120020000000,1,20020,"Dothan, AL MSA",2022,6,66243,64572,1671,2.5
MT0122520000000,1,22520,"Florence-Muscle Shoals, AL MSA",2022,6,67284,65409,1875,2.8
MT0123460000000,1,23460,"Gadsden, AL MSA",2022,6,41044,39894,1150,2.8
MT0126620000000,1,26620,"Huntsville, AL MSA",2022,6,257693,252334,5359,2.1
MT0133660000000,1,33660,"Mobile, AL MSA",2022,6,182629,176700,5929,3.2
MT0133860000000,1,33860,"Montgomery, AL MSA",2022,6,171382,166613,4769,2.8
MT0146220000000,1,46220,"Tuscaloosa, AL MSA",2022,6,121162,117837,3325,2.7
MT0211260000000,2,11260,"Anchorage, AK MSA",2022,6,197517,190123,7394,3.7
MT0221820000000,2,21820,"Fairbanks-College, AK MSA",2022,6,44606,42958,1648,3.7
MT0422380000000,4,22380,"Flagstaff, AZ MSA",2022,6,71840,68671,3169,4.4
MT0429420000000,4,29420,"Lake Havasu City-Kingman, AZ MSA",2022,6,85756,81622,4134,4.8
MT0438060000000,4,38060,"Phoenix-Mesa-Chandler, AZ MSA",2022,6,2591279,2503436,87843,3.4
MT0439150000000,4,39150,"Prescott Valley-Prescott, AZ MSA",2022,6,103283,99452,3831,3.7
MT0443420000000,4,43420,"Sierra Vista-Douglas, AZ MSA",2022,6,47253,45160,2093,4.4
MT0446060000000,4,46060,"Tucson, AZ MSA",2022,6,488900,470243,18657,3.8
MT0449740000000,4,49740,"Yuma, AZ MSA",2022,6,96528,85123,11405,11.8
MT0522220000000,5,22220,"Fayetteville-Springdale-Rogers, AR MSA",2022,6,289307,282376,6931,2.4
MT0522900000000,5,22900,"Fort Smith, AR-OK MSA",2022,6,100174,97057,3117,3.1
MT0526300000000,5,26300,"Hot Springs, AR MSA",2022,6,43631,42066,1565,3.6
MT0527860000000,5,27860,"Jonesboro, AR MSA",2022,6,64698,62828,1870,2.9
MT0530780000000,5,30780,"Little Rock-North Little Rock-Conway, AR MSA",2022,6,363173,351947,11226,3.1
MT0612540000000,6,12540,"Bakersfield-Delano, CA MSA",2022,6,390249,364182,26067,6.7
MT0617020000000,6,17020,"Chico, CA MSA",2022,6,89625,85770,3855,4.3
MT0620940000000,6,20940,"El Centro, CA MSA",2022,6,67670,57834,9836,14.5
MT0623420000000,6,23420,"Fresno, CA MSA",2022,6,509259,476778,32481,6.4
MT0625260000000,6,25260,"Hanford-Corcoran, CA MSA",2022,6,54422,50574,3848,7.1
MT0631080000000,6,31080,"Los Angeles-Long Beach-Anaheim, CA MSA",2022,6,6599663,6319436,280227,4.2
MT0632900000000,6,32900,"Merced, CA MSA",2022,6,115387,106539,8848,7.7
MT0633700000000,6,33700,"Modesto, CA MSA",2022,6,244757,232307,12450,5.1
MT0634900000000,6,34900,"Napa, CA MSA",2022,6,70845,68671,2174,3.1
MT0637100000000,6,37100,"Oxnard-Thousand Oaks-Ventura, CA MSA",2022,6,412216,397775,14441,3.5
MT0639820000000,6,39820,"Redding, CA MSA",2022,6,76001,72740,3261,4.3
MT0640140000000,6,40140,"Riverside-San Bernardino-Ontario, CA MSA",2022,6,2136105,2052522,83583,3.9
MT0640900000000,6,40900,"Sacramento-Roseville-Folsom, CA MSA",2022,6,1136820,1096788,40032,3.5
MT0641500000000,6,41500,"Salinas, CA MSA",2022,6,216231,203531,12700,5.9
MT0641740000000,6,41740,"San Diego-Chula Vista-Carlsbad, CA MSA",2022,6,1606953,1555970,50983,3.2
MT0641860000000,6,41860,"San Francisco-Oakland-Fremont, CA MSA",2022,6,2497567,2428199,69368,2.8
MT0641940000000,6,41940,"San Jose-Sunnyvale-Santa Clara, CA MSA",2022,6,1042181,1014726,27455,2.6
MT0642020000000,6,42020,"San Luis Obispo-Paso Robles, CA MSA",2022,6,131218,127209,4009,3.1
MT0642100000000,6,42100,"Santa Cruz-Watsonville, CA MSA",2022,6,133649,127602,6047,4.5
MT0642200000000,6,42200,"Santa Maria-Santa Barbara, CA MSA",2022,6,218004,210447,7557,3.5
MT0642220000000,6,42220,"Santa Rosa-Petaluma, CA MSA",2022,6,244558,237191,7367,3
MT0644700000000,6,44700,"Stockton-Lodi, CA MSA",2022,6,356387,339089,17298,4.9
MT0646700000000,6,46700,"Vallejo, CA MSA",2022,6,209472,201481,7991,3.8
MT0647300000000,6,47300,"Visalia, CA MSA",2022,6,209024,192636,16388,7.8
MT0649700000000,6,49700,"Yuba City, CA MSA",2022,6,77908,73305,4603,5.9
MT0814500000000,8,14500,"Boulder, CO MSA",2022,6,191756,186854,4902,2.6
MT0817820000000,8,17820,"Colorado Springs, CO MSA",2022,6,380197,368775,11422,3
MT0819740000000,8,19740,"Denver-Aurora-Centennial, CO MSA",2022,6,1733623,1685317,48306,2.8
MT0822660000000,8,22660,"Fort Collins-Loveland, CO MSA",2022,6,201904,196350,5554,2.8
MT0824300000000,8,24300,"Grand Junction, CO MSA",2022,6,77980,75485,2495,3.2
MT0824540000000,8,24540,"Greeley, CO MSA",2022,6,169575,164264,5311,3.1
MT0839380000000,8,39380,"Pueblo, CO MSA",2022,6,73978,70858,3120,4.2
MT0914860000000,9,14860,"Bridgeport-Stamford-Danbury, CT MSA",2022,6,508941,489631,19310,3.8
MT0925540000000,9,25540,"Hartford-West Hartford-East Hartford, CT MSA",2022,6,610031,585146,24885,4.1
MT0935300000000,9,35300,"New Haven, CT MSA",2022,6,313336,300800,12536,4
MT0935980000000,9,35980,"Norwich-New London-Willimantic, CT MSA",2022,6,140593,134613,5980,4.3
MT0947930000000,9,47930,"Waterbury-Shelton, CT MSA",2022,6,240160,229442,10718,4.5
MT1020100000000,10,20100,"Dover, DE MSA",2022,6,84793,80918,3875,4.6
MT1147900000000,11,47900,"Washington-Arlington-Alexandria, DC-VA-MD-WV MSA",2022,6,3443605,3348388,95217,2.8
MT1215980000000,12,15980,"Cape Coral-Fort Myers, FL MSA",2022,6,362193,351399,10794,3
MT1218880000000,12,18880,"Crestview-Fort Walton Beach-Destin, FL MSA",2022,6,138557,135036,3521,2.5
MT1219660000000,12,19660,"Deltona-Daytona Beach-Ormond Beach, FL MSA",2022,6,307838,297707,10131,3.3
MT1223540000000,12,23540,"Gainesville, FL MSA",2022,6,164729,159682,5047,3.1
MT1226140000000,12,26140,"Homosassa Springs, FL MSA",2022,6,52259,50166,2093,4
MT1227260000000,12,27260,"Jacksonville, FL MSA",2022,6,825604,801433,24171,2.9
MT1229460000000,12,29460,"Lakeland-Winter Haven, FL MSA",2022,6,344800,332792,12008,3.5
MT1233100000000,12,33100,"Miami-Fort Lauderdale-West Palm Beach, FL MSA",2022,6,3174555,3086351,88204,2.8
MT1234940000000,12,34940,"Naples-Marco Island, FL MSA",2022,6,175519,170363,5156,2.9
MT1235840000000,12,35840,"North Port-Bradenton-Sarasota, FL MSA",2022,6,373981,362982,10999,2.9
MT1236100000000,12,36100,"Ocala, FL MSA",2022,6,151019,145715,5304,3.5
MT1236740000000,12,36740,"Orlando-Kissimmee-Sanford, FL MSA",2022,6,1452113,1410272,41841,2.9
MT1237340000000,12,37340,"Palm Bay-Melbourne-Titusville, FL MSA",2022,6,292409,283826,8583,2.9
MT1237460000000,12,37460,"Panama City-Panama City Beach, FL MSA",2022,6,97105,94294,2811,2.9
MT1237860000000,12,37860,"Pensacola-Ferry Pass-Brent, FL MSA",2022,6,234337,227482,6855,2.9
MT1238940000000,12,38940,"Port St. Lucie, FL MSA",2022,6,229318,221827,7491,3.3
MT1239460000000,12,39460,"Punta Gorda, FL MSA",2022,6,72124,69617,2507,3.5
MT1242680000000,12,42680,"Sebastian-Vero Beach-West Vero Corridor, FL MSA",2022,6,65595,63266,2329,3.6
MT1242700000000,12,42700,"Sebring, FL MSA",2022,6,35378,33916,1462,4.1
MT1245220000000,12,45220,"Tallahassee, FL MSA",2022,6,200537,194479,6058,3
MT1245300000000,12,45300,"Tampa-St. Petersburg-Clearwater, FL MSA",2022,6,1638513,1592457,46056,2.8
MT1248680000000,12,48680,"Wildwood-The Villages, FL MSA",2022,6,31870,30323,1547,4.9
MT1310500000000,13,10500,"Albany, GA MSA",2022,6,62934,60495,2439,3.9
MT1312020000000,13,12020,"Athens-Clarke County, GA MSA",2022,6,102537,99524,3013,2.9
MT1312060000000,13,12060,"Atlanta-Sandy Springs-Roswell, GA MSA",2022,6,3186816,3093047,93769,2.9
MT1312260000000,13,12260,"Augusta-Richmond County, GA-SC MSA",2022,6,263990,254669,9321,3.5
MT1315260000000,13,15260,"Brunswick-St. Simons, GA MSA",2022,6,52271,50712,1559,3
MT1317980000000,13,17980,"Columbus, GA-AL MSA",2022,6,129119,124529,4590,3.6
MT1319140000000,13,19140,"Dalton, GA MSA",2022,6,66608,64268,2340,3.5
MT1323580000000,13,23580,"Gainesville, GA MSA",2022,6,103264,100651,2613,2.5
MT1325980000000,13,25980,"Hinesville, GA MSA",2022,6,30737,29564,1173,3.8
MT1331420000000,13,31420,"Macon-Bibb County, GA MSA",2022,6,97522,94000,3522,3.6
MT1340660000000,13,40660,"Rome, GA MSA",2022,6,44906,43500,1406,3.1
MT1342340000000,13,42340,"Savannah, GA MSA",2022,6,203278,197331,5947,2.9
MT1346660000000,13,46660,"Valdosta, GA MSA",2022,6,61262,59216,2046,3.3
MT1347580000000,13,47580,"Warner Robins, GA MSA",2022,6,88248,85450,2798,3.2
MT1527980000000,15,27980,"Kahului-Wailuku, HI MSA",2022,6,83071,80316,2755,3.3
MT1546520000000,15,46520,"Urban Honolulu, HI MSA",2022,6,466664,451529,15135,3.2
MT1614260000000,16,14260,"Boise City, ID MSA",2022,6,424070,412868,11202,2.6
MT1617660000000,16,17660,"Coeur d'Alene, ID MSA",2022,6,86034,83089,2945,3.4
MT1626820000000,16,26820,"Idaho Falls, ID MSA",2022,6,80240,78208,2032,2.5
MT1630300000000,16,30300,"Lewiston, ID-WA MSA",2022,6,30421,29483,938,3.1
MT1638540000000,16,38540,"Pocatello, ID MSA",2022,6,39299,38005,1294,3.3
MT1646300000000,16,46300,"Twin Falls, ID MSA",2022,6,58873,57235,1638,2.8
MT1714010000000,17,14010,"Bloomington, IL MSA",2022,6,91249,87995,3254,3.6
MT1716580000000,17,16580,"Champaign-Urbana, IL MSA",2022,6,123043,118287,4756,3.9
MT1716980000000,17,16980,"Chicago-Naperville-Elgin, IL-IN MSA",2022,6,4866608,4641045,225563,4.6
MT1719340000000,17,19340,"Davenport-Moline-Rock Island, IA-IL MSA",2022,6,189373,182027,7346,3.9
MT1719500000000,17,19500,"Decatur, IL MSA",2022,6,45073,42503,2570,5.7
MT1728100000000,17,28100,"Kankakee, IL MSA",2022,6,50569,47807,2762,5.5
MT1737900000000,17,37900,"Peoria, IL MSA",2022,6,172966,165082,7884,4.6
MT1740420000000,17,40420,"Rockford, IL MSA",2022,6,159539,150071,9468,5.9
MT1744100000000,17,44100,"Springfield, IL MSA",2022,6,102264,97894,4370,4.3
MT1814020000000,18,14020,"Bloomington, IN MSA",2022,6,83322,81143,2179,2.6
MT1818020000000,18,18020,"Columbus, IN MSA",2022,6,39295,38230,1065,2.7
MT1821140000000,18,21140,"Elkhart-Goshen, IN MSA",2022,6,107966,105054,2912,2.7
MT1821780000000,18,21780,"Evansville, IN MSA",2022,6,134936,130989,3947,2.9
MT1823060000000,18,23060,"Fort Wayne, IN MSA",2022,6,227444,221099,6345,2.8
MT1826900000000,18,26900,"Indianapolis-Carmel-Greenwood, IN MSA",2022,6,1098183,1066838,31345,2.9
MT1829020000000,18,29020,"Kokomo, IN MSA",2022,6,35589,34038,1551,4.4
MT1829200000000,18,29200,"Lafayette-West Lafayette, IN MSA",2022,6,116250,113034,3216,2.8
MT1833140000000,18,33140,"Michigan City-La Porte, IN MSA",2022,6,50514,48740,1774,3.5
MT1834620000000,18,34620,"Muncie, IN MSA",2022,6,51487,49653,1834,3.6
MT1843780000000,18,43780,"South Bend-Mishawaka, IN-MI MSA",2022,6,154816,149187,5629,3.6
MT1845460000000,18,45460,"Terre Haute, IN MSA",2022,6,76913,74328,2585,3.4
MT1911180000000,19,11180,"Ames, IA MSA",2022,6,68955,67451,1504,2.2
MT1916300000000,19,16300,"Cedar Rapids, IA MSA",2022,6,149505,145134,4371,2.9
MT1919780000000,19,19780,"Des Moines-West Des Moines, IA MSA",2022,6,398320,388018,10302,2.6
MT1920220000000,19,20220,"Dubuque, IA MSA",2022,6,53963,52400,1563,2.9
MT1926980000000,19,26980,"Iowa City, IA MSA",2022,6,98688,96413,2275,2.3
MT1943580000000,19,43580,"Sioux City, IA-NE-SD MSA",2022,6,76263,74181,2082,2.7
MT1947940000000,19,47940,"Waterloo-Cedar Falls, IA MSA",2022,6,89430,87071,2359,2.6
MT2029940000000,20,29940,"Lawrence, KS MSA",2022,6,68560,66892,1668,2.4
MT2031740000000,20,31740,"Manhattan, KS MSA",2022,6,62879,61217,1662,2.6
MT2045820000000,20,45820,"Topeka, KS MSA",2022,6,116405,113056,3349,2.9
MT2048620000000,20,48620,"Wichita, KS MSA",2022,6,324960,315188,9772,3
MT2114540000000,21,14540,"Bowling Green, KY MSA",2022,6,88557,85333,3224,3.6
MT2121060000000,21,21060,"Elizabethtown, KY MSA",2022,6,53557,51224,2333,4.4
MT2130460000000,21,30460,"Lexington-Fayette, KY MSA",2022,6,268113,259396,8717,3.3
MT2131140000000,21,31140,"Louisville/Jefferson County, KY-IN MSA",2022,6,685569,661912,23657,3.5
MT2136980000000,21,36980,"Owensboro, KY MSA",2022,6,51148,49121,2027,4
MT2137140000000,21,37140,"Paducah, KY-IL MSA",2022,6,45442,43446,1996,4.4
MT2210780000000,22,10780,"Alexandria, LA MSA",2022,6,65303,63259,2044,3.1
MT2212940000000,22,12940,"Baton Rouge, LA MSA",2022,6,419874,405223,14651,3.5
MT2225220000000,22,25220,"Hammond, LA MSA",2022,6,59129,56728,2401,4.1
MT2226380000000,22,26380,"Houma-Bayou Cane-Thibodaux, LA MSA",2022,6,86520,83513,3007,3.5
MT2229180000000,22,29180,"Lafayette, LA MSA",2022,6,195532,189441,6091,3.1
MT2229340000000,22,29340,"Lake Charles, LA MSA",2022,6,99290,95586,3704,3.7
MT2233740000000,22,33740,"Monroe, LA MSA",2022,6,96477,92671,3806,3.9
MT2235380000000,22,35380,"New Orleans-Metairie, LA MSA",2022,6,468921,450830,18091,3.9
MT2243340000000,22,43340,"Shreveport-Bossier City, LA MSA",2022,6,168542,162321,6221,3.7
MT2243640000000,22,43640,"Slidell-Mandeville-Covington, LA MSA",2022,6,126592,123021,3571,2.8
MT2312620000000,23,12620,"Bangor, ME MSA",2022,6,72850,70758,2092,2.9
MT2330340000000,23,30340,"Lewiston-Auburn, ME MSA",2022,6,53732,52289,1443,2.7
MT2338860000000,23,38860,"Portland-South Portland, ME MSA",2022,6,300510,293702,6808,2.3
MT2412580000000,24,12580,"Baltimore-Columbia-Towson, MD MSA",2022,6,1456375,1412357,44018,3
MT2425180000000,24,25180,"Hagerstown-Martinsburg, MD-WV MSA",2022,6,141470,137103,4367,3.1
MT2430500000000,24,30500,"Lexington Park, MD MSA",2022,6,104611,101617,2994,2.9
MT2441540000000,24,41540,"Salisbury, MD MSA",2022,6,61746,59526,2220,3.6
MT2511200000000,25,11200,"Amherst Town-Northampton, MA MSA",2022,6,84415,81471,2944,3.5
MT2512700000000,25,12700,"Barnstable Town, MA MSA",2022,6,113133,107928,5205,4.6
MT2514460000000,25,14460,"Boston-Cambridge-Newton, MA-NH MSA",2022,6,2730098,2641834,88264,3.2
MT2538340000000,25,38340,"Pittsfield, MA MSA",2022,6,63650,61055,2595,4.1
MT2544140000000,25,44140,"Springfield, MA MSA",2022,6,222871,212352,10519,4.7
MT2549340000000,25,49340,"Worcester, MA MSA",2022,6,452010,435099,16911,3.7
MT2611460000000,26,11460,"Ann Arbor, MI MSA",2022,6,199327,192628,6699,3.4
MT2612980000000,26,12980,"Battle Creek, MI MSA",2022,6,59500,56761,2739,4.6
MT2613020000000,26,13020,"Bay City, MI MSA",2022,6,48385,45923,2462,5.1
MT2619820000000,26,19820,"Detroit-Warren-Dearborn, MI MSA",2022,6,2111664,2035024,76640,3.6
MT2622420000000,26,22420,"Flint, MI MSA",2022,6,180639,171225,9414,5.2
MT2624340000000,26,24340,"Grand Rapids-Wyoming-Kentwood, MI MSA",2022,6,601479,580452,21027,3.5
MT2627100000000,26,27100,"Jackson, MI MSA",2022,6,73166,69951,3215,4.4
MT2628020000000,26,28020,"Kalamazoo-Portage, MI MSA",2022,6,134387,129470,4917,3.7
MT2629620000000,26,29620,"Lansing-East Lansing, MI MSA",2022,6,240509,230048,10461,4.3
MT2633220000000,26,33220,"Midland, MI MSA",2022,6,40162,38486,1676,4.2
MT2633780000000,26,33780,"Monroe, MI MSA",2022,6,74745,71216,3529,4.7
MT2634740000000,26,34740,"Muskegon-Norton Shores, MI MSA",2022,6,81363,77665,3698,4.5
MT2635660000000,26,35660,"Niles, MI MSA",2022,6,73258,70150,3108,4.2
MT2640980000000,26,40980,"Saginaw, MI MSA",2022,6,82931,78507,4424,5.3
MT2645900000000,26,45900,"Traverse City, MI MSA",2022,6,78225,75014,3211,4.1
MT2720260000000,27,20260,"Duluth, MN-WI MSA",2022,6,138002,133632,4370,3.2
MT2731860000000,27,31860,"Mankato, MN MSA",2022,6,58458,57370,1088,1.9
MT2733460000000,27,33460,"Minneapolis-St. Paul-Bloomington, MN-WI MSA",2022,6,2038050,1994556,43494,2.1
MT2740340000000,27,40340,"Rochester, MN MSA",2022,6,123783,121248,2535,2
MT2741060000000,27,41060,"St. Cloud, MN MSA",2022,6,107718,105079,2639,2.4
MT2825060000000,28,25060,"Gulfport-Biloxi, MS MSA",2022,6,183444,176802,6642,3.6
MT2825620000000,28,25620,"Hattiesburg, MS MSA",2022,6,70246,67855,2391,3.4
MT2827140000000,28,27140,"Jackson, MS MSA",2022,6,276336,266866,9470,3.4
MT2916020000000,29,16020,"Cape Girardeau, MO-IL MSA",2022,6,47771,46673,1098,2.3
MT2917860000000,29,17860,"Columbia, MO MSA",2022,6,112998,110825,2173,1.9
MT2927620000000,29,27620,"Jefferson City, MO MSA",2022,6,73179,71708,1471,2
MT2927900000000,29,27900,"Joplin, MO-KS MSA",2022,6,95116,93008,2108,2.2
MT2928140000000,29,28140,"Kansas City, MO-KS MSA",2022,6,1154134,1125447,28687,2.5
MT2941140000000,29,41140,"St. Joseph, MO-KS MSA",2022,6,54134,52781,1353,2.5
MT2941180000000,29,41180,"St. Louis, MO-IL MSA",2022,6,1443871,1405116,38755,2.7
MT2944180000000,29,44180,"Springfield, MO MSA",2022,6,234133,229251,4882,2.1
MT3013740000000,30,13740,"Billings, MT MSA",2022,6,99246,96781,2465,2.5
MT3014580000000,30,14580,"Bozeman, MT MSA",2022,6,74802,73265,1537,2.1
MT3024500000000,30,24500,"Great Falls, MT MSA",2022,6,39988,38892,1096,2.7
MT3025740000000,30,25740,"Helena, MT MSA",2022,6,46482,45256,1226,2.6
MT3033540000000,30,33540,"Missoula, MT MSA",2022,6,72332,70433,1899,2.6
MT3124260000000,31,24260,"Grand Island, NE MSA",2022,6,41551,40654,897,2.2
MT3130700000000,31,30700,"Lincoln, NE MSA",2022,6,189244,185392,3852,2
MT3136540000000,31,36540,"Omaha, NE-IA MSA",2022,6,516060,503951,12109,2.3
MT3216180000000,32,16180,"Carson City, NV MSA",2022,6,27955,26725,1230,4.4
MT3229820000000,32,29820,"Las Vegas-Henderson-North Las Vegas, NV MSA",2022,6,1146152,1082616,63536,5.5
MT3239900000000,32,39900,"Reno, NV MSA",2022,6,289533,277327,12206,4.2
MT3331700000000,33,31700,"Manchester-Nashua, NH MSA",2022,6,239393,233660,5733,2.4
MT3412100000000,34,12100,"Atlantic City-Hammonton, NJ MSA",2022,6,177412,168219,9193,5.2
MT3445940000000,34,45940,"Trenton-Princeton, NJ MSA",2022,6,194612,188189,6423,3.3
MT3447220000000,34,47220,"Vineland, NJ MSA",2022,6,64926,61560,3366,5.2
MT3510740000000,35,10740,"Albuquerque, NM MSA",2022,6,446882,431005,15877,3.6
MT3522140000000,35,22140,"Farmington, NM MSA",2022,6,47745,45593,2152,4.5
MT3529740000000,35,29740,"Las Cruces, NM MSA",2022,6,97110,92807,4303,4.4
MT3542140000000,35,42140,"Santa Fe, NM MSA",2022,6,72819,70260,2559,3.5
MT3610580000000,36,10580,"Albany-Schenectady-Troy, NY MSA",2022,6,452710,438707,14003,3.1
MT3613780000000,36,13780,"Binghamton, NY MSA",2022,6,105633,101613,4020,3.8
MT3615380000000,36,15380,"Buffalo-Cheektowaga, NY MSA",2022,6,555860,535639,20221,3.6
MT3621300000000,36,21300,"Elmira, NY MSA",2022,6,35894,34613,1281,3.6
MT3624020000000,36,24020,"Glens Falls, NY MSA",2022,6,59498,57425,2073,3.5
MT3627060000000,36,27060,"Ithaca, NY MSA",2022,6,47802,46408,1394,2.9
MT3628740000000,36,28740,"Kingston, NY MSA",2022,6,85845,83010,2835,3.3
MT3628880000000,36,28880,"Kiryas Joel-Poughkeepsie-Newburgh, NY MSA",2022,6,333225,322328,10897,3.3
MT3635620000000,36,35620,"New York-Newark-Jersey City, NY-NJ MSA",2022,6,9881816,9472878,408938,4.1
MT3640380000000,36,40380,"Rochester, NY MSA",2022,6,510314,492593,17721,3.5
MT3645060000000,36,45060,"Syracuse, NY MSA",2022,6,309859,298853,11006,3.6
MT3646540000000,36,46540,"Utica-Rome, NY MSA",2022,6,127749,123041,4708,3.7
MT3648060000000,36,48060,"Watertown-Fort Drum, NY MSA",2022,6,44897,42990,1907,4.2
MT3711700000000,37,11700,"Asheville, NC MSA",2022,6,207928,201381,6547,3.1
MT3715500000000,37,15500,"Burlington, NC MSA",2022,6,83440,80286,3154,3.8
MT3716740000000,37,16740,"Charlotte-Concord-Gastonia, NC-SC MSA",2022,6,1440446,1390075,50371,3.5
MT3720500000000,37,20500,"Durham-Chapel Hill, NC MSA",2022,6,315741,305420,10321,3.3
MT3722180000000,37,22180,"Fayetteville, NC MSA",2022,6,153337,145931,7406,4.8
MT3724140000000,37,24140,"Goldsboro, NC MSA",2022,6,49720,47727,1993,4
MT3724660000000,37,24660,"Greensboro-High Point, NC MSA",2022,6,373187,358256,14931,4
MT3724780000000,37,24780,"Greenville, NC MSA",2022,6,82129,78729,3400,4.1
MT3725860000000,37,25860,"Hickory-Lenoir-Morganton, NC MSA",2022,6,172691,166533,6158,3.6
MT3727340000000,37,27340,"Jacksonville, NC MSA",2022,6,72468,69563,2905,4
MT3738240000000,37,38240,"Pinehurst-Southern Pines, NC MSA",2022,6,43265,41681,1584,3.7
MT3739580000000,37,39580,"Raleigh-Cary, NC MSA",2022,6,810231,785225,25006,3.1
MT3740580000000,37,40580,"Rocky Mount, NC MSA",2022,6,63831,60410,3421,5.4
MT3748900000000,37,48900,"Wilmington, NC MSA",2022,6,215037,206874,8163,3.8
MT3749180000000,37,49180,"Winston-Salem, NC MSA",2022,6,325358,313167,12191,3.7
MT3813900000000,38,13900,"Bismarck, ND MSA",2022,6,72626,71130,1496,2.1
MT3822020000000,38,22020,"Fargo, ND-MN MSA",2022,6,149649,146958,2691,1.8
MT3824220000000,38,24220,"Grand Forks, ND-MN MSA",2022,6,54489,53389,1100,2
MT3833500000000,38,33500,"Minot, ND MSA",2022,6,39608,38761,847,2.1
MT3910420000000,39,10420,"Akron, OH MSA",2022,6,353474,339368,14106,4
MT3915940000000,39,15940,"Canton-Massillon, OH MSA",2022,6,189253,181321,7932,4.2
MT3917140000000,39,17140,"Cincinnati, OH-KY-IN MSA",2022,6,1146569,1106344,40225,3.5
MT3917410000000,39,17410,"Cleveland, OH MSA",2022,6,1075345,1025858,49487,4.6
MT3918140000000,39,18140,"Columbus, OH MSA",2022,6,1117955,1079458,38497,3.4
MT3919430000000,39,19430,"Dayton-Kettering-Beavercreek, OH MSA",2022,6,382717,367700,15017,3.9
MT3930620000000,39,30620,"Lima, OH MSA",2022,6,47049,45173,1876,4
MT3931900000000,39,31900,"Mansfield, OH MSA",2022,6,52200,49838,2362,4.5
MT3941780000000,39,41780,"Sandusky, OH MSA",2022,6,56913,53856,3057,5.4
MT3944220000000,39,44220,"Springfield, OH MSA",2022,6,61299,58684,2615,4.3
MT3945780000000,39,45780,"Toledo, OH MSA",2022,6,289600,277415,12185,4.2
MT3948260000000,39,48260,"Weirton-Steubenville, WV-OH MSA",2022,6,52737,50220,2517,4.8
MT3949660000000,39,49660,"Youngstown-Warren, OH MSA",2022,6,188514,179727,8787,4.7
MT4021420000000,40,21420,"Enid, OK MSA",2022,6,28661,27876,785,2.7
MT4030020000000,40,30020,"Lawton, OK MSA",2022,6,50898,49054,1844,3.6
MT4036420000000,40,36420,"Oklahoma City, OK MSA",2022,6,728777,708437,20340,2.8
MT4046140000000,40,46140,"Tulsa, OK MSA",2022,6,496765,481048,15717,3.2
MT4110540000000,41,10540,"Albany, OR MSA",2022,6,61403,58789,2614,4.3
MT4113460000000,41,13460,"Bend, OR MSA",2022,6,126630,121520,5110,4
MT4118700000000,41,18700,"Corvallis, OR MSA",2022,6,48603,46939,1664,3.4
MT4121660000000,41,21660,"Eugene-Springfield, OR MSA",2022,6,186252,178619,7633,4.1
MT4124420000000,41,24420,"Grants Pass, OR MSA",2022,6,35206,33339,1867,5.3
MT4132780000000,41,32780,"Medford, OR MSA",2022,6,105065,100563,4502,4.3
MT4138900000000,41,38900,"Portland-Vancouver-Hillsboro, OR-WA MSA",2022,6,1370907,1323036,47871,3.5
MT4141420000000,41,41420,"Salem, OR MSA",2022,6,214210,205862,8348,3.9
MT4210900000000,42,10900,"Allentown-Bethlehem-Easton, PA-NJ MSA",2022,6,444360,425962,18398,4.1
MT4211020000000,42,11020,"Altoona, PA MSA",2022,6,57144,54593,2551,4.5
MT4216540000000,42,16540,"Chambersburg, PA MSA",2022,6,76845,74095,2750,3.6
MT4221500000000,42,21500,"Erie, PA MSA",2022,6,125949,120027,5922,4.7
MT4223900000000,42,23900,"Gettysburg, PA MSA",2022,6,51921,50095,1826,3.5
MT4225420000000,42,25420,"Harrisburg-Carlisle, PA MSA",2022,6,305861,294865,10996,3.6
MT4227780000000,42,27780,"Johnstown, PA MSA",2022,6,56914,53986,2928,5.1
MT4229540000000,42,29540,"Lancaster, PA MSA",2022,6,288995,279101,9894,3.4
MT4230140000000,42,30140,"Lebanon, PA MSA",2022,6,70916,68271,2645,3.7
MT4237980000000,42,37980,"Philadelphia-Camden-Wilmington, PA-NJ-DE-MD MSA",2022,6,3225473,3099307,126166,3.9
MT4238300000000,42,38300,"Pittsburgh, PA MSA",2022,6,1220595,1167508,53087,4.3
MT4239740000000,42,39740,"Reading, PA MSA",2022,6,215464,206568,8896,4.1
MT4242540000000,42,42540,"Scranton--Wilkes-Barre, PA MSA",2022,6,276735,263431,13304,4.8
MT4244300000000,42,44300,"State College, PA MSA",2022,6,75397,72786,2611,3.5
MT4248700000000,42,48700,"Williamsport, PA MSA",2022,6,52188,49636,2552,4.9
MT4249620000000,42,49620,"York-Hanover, PA MSA",2022,6,236501,227732,8769,3.7
MT4439300000000,44,39300,"Providence-Warwick, RI-MA MSA",2022,6,873362,841360,32002,3.7
MT4516700000000,45,16700,"Charleston-North Charleston, SC MSA",2022,6,409017,397719,11298,2.8
MT4517900000000,45,17900,"Columbia, SC MSA",2022,6,398911,386939,11972,3
MT4522500000000,45,22500,"Florence, SC MSA",2022,6,89586,86514,3072,3.4
MT4524860000000,45,24860,"Greenville-Anderson-Greer, SC MSA",2022,6,454797,442031,12766,2.8
MT4525940000000,45,25940,"Hilton Head Island-Bluffton-Port Royal, SC MSA",2022,6,92637,89920,2717,2.9
MT4534820000000,45,34820,"Myrtle Beach-Conway-North Myrtle Beach, SC MSA",2022,6,159684,153660,6024,3.8
MT4543900000000,45,43900,"Spartanburg, SC MSA",2022,6,167161,161760,5401,3.2
MT4544940000000,45,44940,"Sumter, SC MSA",2022,6,41715,40209,1506,3.6
MT4639660000000,46,39660,"Rapid City, SD MSA",2022,6,77836,76347,1489,1.9
MT4643620000000,46,43620,"Sioux Falls, SD-MN MSA",2022,6,167561,164744,2817,1.7
MT4716860000000,47,16860,"Chattanooga, TN-GA MSA",2022,6,275665,266843,8822,3.2
MT4717300000000,47,17300,"Clarksville, TN-KY MSA",2022,6,134299,129142,5157,3.8
MT4717420000000,47,17420,"Cleveland, TN MSA",2022,6,57238,55223,2015,3.5
MT4727180000000,47,27180,"Jackson, TN MSA",2022,6,78275,75381,2894,3.7
MT4727740000000,47,27740,"Johnson City, TN MSA",2022,6,96429,93162,3267,3.4
MT4728700000000,47,28700,"Kingsport-Bristol, TN-VA MSA",2022,6,130807,126197,4610,3.5
MT4728940000000,47,28940,"Knoxville, TN MSA",2022,6,441690,427671,14019,3.2
MT4732820000000,47,32820,"Memphis, TN-MS-AR MSA",2022,6,637793,612406,25387,4
MT4734100000000,47,34100,"Morristown, TN MSA",2022,6,53151,51191,1960,3.7
MT4734980000000,47,34980,"Nashville-Davidson--Murfreesboro--Franklin, TN MSA",2022,6,1129308,1098300,31008,2.7
MT4810180000000,48,10180,"Abilene, TX MSA",2022,6,82209,79451,2758,3.4
MT4811100000000,48,11100,"Amarillo, TX MSA",2022,6,132385,128376,4009,3
MT4812420000000,48,12420,"Austin-Round Rock-San Marcos, TX MSA",2022,6,1391262,1350581,40681,2.9
MT4813140000000,48,13140,"Beaumont-Port Arthur, TX MSA",2022,6,169486,160322,9164,5.4
MT4815180000000,48,15180,"Brownsville-Harlingen, TX MSA",2022,6,180848,171012,9836,5.4
MT4817780000000,48,17780,"College Station-Bryan, TX MSA",2022,6,140752,136141,4611,3.3
MT4818580000000,48,18580,"Corpus Christi, TX MSA",2022,6,200695,191148,9547,4.8
MT4819100000000,48,19100,"Dallas-Fort Worth-Arlington, TX MSA",2022,6,4228377,4081380,146997,3.5
MT4820580000000,48,20580,"Eagle Pass, TX MSA",2022,6,23195,21411,1784,7.7
MT4821340000000,48,21340,"El Paso, TX MSA",2022,6,388454,372857,15597,4
MT4826420000000,48,26420,"Houston-Pasadena-The Woodlands, TX MSA",2022,6,3589853,3443996,145857,4.1
MT4828660000000,48,28660,"Killeen-Temple, TX MSA",2022,6,193872,185769,8103,4.2
MT4829700000000,48,29700,"Laredo, TX MSA",2022,6,112123,107618,4505,4
MT4830980000000,48,30980,"Longview, TX MSA",2022,6,125742,120493,5249,4.2
MT4831180000000,48,31180,"Lubbock, TX MSA",2022,6,176315,170316,5999,3.4
MT4832580000000,48,32580,"McAllen-Edinburg-Mission, TX MSA",2022,6,377637,353818,23819,6.3
MT4833260000000,48,33260,"Midland, TX MSA",2022,6,93270,90254,3016,3.2
MT4836220000000,48,36220,"Odessa, TX MSA",2022,6,79753,76748,3005,3.8
MT4841660000000,48,41660,"San Angelo, TX MSA",2022,6,59091,57271,1820,3.1
MT4841700000000,48,41700,"San Antonio-New Braunfels, TX MSA",2022,6,1257822,1212392,45430,3.6
MT4843300000000,48,43300,"Sherman-Denison, TX MSA",2022,6,66840,64447,2393,3.6
MT4845500000000,48,45500,"Texarkana, TX-AR MSA",2022,6,60336,57698,2638,4.4
MT4846340000000,48,46340,"Tyler, TX MSA",2022,6,112214,108042,4172,3.7
MT4847020000000,48,47020,"Victoria, TX MSA",2022,6,44275,42518,1757,4
MT4847380000000,48,47380,"Waco, TX MSA",2022,6,139287,134229,5058,3.6
MT4848660000000,48,48660,"Wichita Falls, TX MSA",2022,6,65631,63210,2421,3.7
MT4930860000000,49,30860,"Logan, UT-ID MSA",2022,6,78766,77125,1641,2.1
MT4936260000000,49,36260,"Ogden, UT MSA",2022,6,333405,325928,7477,2.2
MT4939340000000,49,39340,"Provo-Orem-Lehi, UT MSA",2022,6,353316,345532,7784,2.2
MT4941100000000,49,41100,"St. George, UT MSA",2022,6,86157,83893,2264,2.6
MT4941620000000,49,41620,"Salt Lake City-Murray, UT MSA",2022,6,705440,688889,16551,2.3
MT5015540000000,50,15540,"Burlington-South Burlington, VT MSA",2022,6,126316,123807,2509,2
MT5113980000000,51,13980,"Blacksburg-Christiansburg-Radford, VA MSA",2022,6,90808,88309,2499,2.8
MT5116820000000,51,16820,"Charlottesville, VA MSA",2022,6,114838,112004,2834,2.5
MT5125500000000,51,25500,"Harrisonburg, VA MSA",2022,6,70761,68949,1812,2.6
MT5131340000000,51,31340,"Lynchburg, VA MSA",2022,6,126339,122651,3688,2.9
MT5140060000000,51,40060,"Richmond, VA MSA",2022,6,699916,680415,19501,2.8
MT5140220000000,51,40220,"Roanoke, VA MSA",2022,6,153760,149519,4241,2.8
MT5144420000000,51,44420,"Staunton-Stuarts Draft, VA MSA",2022,6,63612,62014,1598,2.5
MT5147260000000,51,47260,"Virginia Beach-Chesapeake-Norfolk, VA-NC MSA",2022,6,855497,829430,26067,3
MT5149020000000,51,49020,"Winchester, VA-WV MSA",2022,6,74189,72316,1873,2.5
MT5313380000000,53,13380,"Bellingham, WA MSA",2022,6,114196,109537,4659,4.1
MT5314740000000,53,14740,"Bremerton-Silverdale-Port Orchard, WA MSA",2022,6,121657,116780,4877,4
MT5328420000000,53,28420,"Kennewick-Richland, WA MSA",2022,6,145299,138419,6880,4.7
MT5331020000000,53,31020,"Longview-Kelso, WA MSA",2022,6,47637,45334,2303,4.8
MT5334580000000,53,34580,"Mount Vernon-Anacortes, WA MSA",2022,6,58148,55397,2751,4.7
MT5336500000000,53,36500,"Olympia-Lacey-Tumwater, WA MSA",2022,6,139739,133977,5762,4.1
MT5342660000000,53,42660,"Seattle-Tacoma-Bellevue, WA MSA",2022,6,2245719,2164238,81481,3.6
MT5344060000000,53,44060,"Spokane-Spokane Valley, WA MSA",2022,6,280949,269189,11760,4.2
MT5347460000000,53,47460,"Walla Walla, WA MSA",2022,6,29575,28378,1197,4
MT5348300000000,53,48300,"Wenatchee-East Wenatchee, WA MSA",2022,6,62290,59501,2789,4.5
MT5349420000000,53,49420,"Yakima, WA MSA",2022,6,127502,120496,7006,5.5
MT5413220000000,54,13220,"Beckley, WV MSA",2022,6,45337,43477,1860,4.1
MT5416620000000,54,16620,"Charleston, WV MSA",2022,6,89645,86149,3496,3.9
MT5426580000000,54,26580,"Huntington-Ashland, WV-KY-OH MSA",2022,6,154688,147995,6693,4.3
MT5434060000000,54,34060,"Morgantown, WV MSA",2022,6,70791,68151,2640,3.7
MT5437620000000,54,37620,"Parkersburg-Vienna, WV MSA",2022,6,39136,37544,1592,4.1
MT5448540000000,54,48540,"Wheeling, WV-OH MSA",2022,6,59186,56329,2857,4.8
MT5511540000000,55,11540,"Appleton, WI MSA",2022,6,134695,131456,3239,2.4
MT5520740000000,55,20740,"Eau Claire, WI MSA",2022,6,93371,90844,2527,2.7
MT5522540000000,55,22540,"Fond du Lac, WI MSA",2022,6,56106,54716,1390,2.5
MT5524580000000,55,24580,"Green Bay, WI MSA",2022,6,174776,170291,4485,2.6
MT5527500000000,55,27500,"Janesville-Beloit, WI MSA",2022,6,83840,80918,2922,3.5
MT5528450000000,55,28450,"Kenosha, WI MSA",2022,6,92559,89746,2813,3
MT5529100000000,55,29100,"La Crosse-Onalaska, WI-MN MSA",2022,6,87847,85642,2205,2.5
MT5531540000000,55,31540,"Madison, WI MSA",2022,6,394282,385608,8674,2.2
MT5533340000000,55,33340,"Milwaukee-Waukesha, WI MSA",2022,6,806848,782790,24058,3
MT5536780000000,55,36780,"Oshkosh-Neenah, WI MSA",2022,6,91554,89310,2244,2.5
MT5539540000000,55,39540,"Racine-Mount Pleasant, WI MSA",2022,6,99709,96332,3377,3.4
MT5543100000000,55,43100,"Sheboygan, WI MSA",2022,6,61785,60335,1450,2.3
MT5548140000000,55,48140,"Wausau, WI MSA",2022,6,74514,72716,1798,2.4
MT5616220000000,56,16220,"Casper, WY MSA",2022,6,41132,39632,1500,3.6
MT5616940000000,56,16940,"Cheyenne, WY MSA",2022,6,48170,46497,1673,3.5
MT7210380000000,72,10380,"Aguadilla, PR MSA",2022,6,85498,79408,6090,7.1
MT7211640000000,72,11640,"Arecibo, PR MSA",2022,6,64558,59826,4732,7.3
MT7225020000000,72,25020,"Guayama, PR MSA",2022,6,18385,16798,1587,8.6
MT7232420000000,72,32420,"Mayaguez, PR MSA",2022,6,64545,59869,4676,7.2
MT7238660000000,72,38660,"Ponce, PR MSA",2022,6,86059,78925,7134,8.3
MT7241980000000,72,41980,"San Juan-Bayamon-Caguas, PR MSA",2022,6,788719,748327,40392,5.1
MT0111500000000,1,11500,"Anniston-Oxford, AL MSA",2022,7,49117,47751,1366,2.8
MT0112220000000,1,12220,"Auburn-Opelika, AL MSA",2022,7,92110,89951,2159,2.3
MT0113820000000,1,13820,"Birmingham, AL MSA",2022,7,557895,544953,12942,2.3
MT0119300000000,1,19300,"Daphne-Fairhope-Foley, AL MSA",2022,7,110105,107561,2544,2.3
MT0119460000000,1,19460,"Decatur, AL MSA",2022,7,72563,70911,1652,2.3
MT0120020000000,1,20020,"Dothan, AL MSA",2022,7,66207,64541,1666,2.5
MT0122520000000,1,22520,"Florence-Muscle Shoals, AL MSA",2022,7,67134,65261,1873,2.8
MT0123460000000,1,23460,"Gadsden, AL MSA",2022,7,40907,39758,1149,2.8
MT0126620000000,1,26620,"Huntsville, AL MSA",2022,7,258370,252986,5384,2.1
MT0133660000000,1,33660,"Mobile, AL MSA",2022,7,182451,176525,5926,3.2
MT0133860000000,1,33860,"Montgomery, AL MSA",2022,7,171432,166673,4759,2.8
MT0146220000000,1,46220,"Tuscaloosa, AL MSA",2022,7,121414,118061,3353,2.8
MT0211260000000,2,11260,"Anchorage, AK MSA",2022,7,197379,190173,7206,3.7
MT0221820000000,2,21820,"Fairbanks-College, AK MSA",2022,7,44564,42960,1604,3.6
MT0422380000000,4,22380,"Flagstaff, AZ MSA",2022,7,71892,68701,3191,4.4
MT0429420000000,4,29420,"Lake Havasu City-Kingman, AZ MSA",2022,7,85844,81659,4185,4.9
MT0438060000000,4,38060,"Phoenix-Mesa-Chandler, AZ MSA",2022,7,2596728,2508097,88631,3.4
MT0439150000000,4,39150,"Prescott Valley-Prescott, AZ MSA",2022,7,103655,99752,3903,3.8
MT0443420000000,4,43420,"Sierra Vista-Douglas, AZ MSA",2022,7,47241,45121,2120,4.5
MT0446060000000,4,46060,"Tucson, AZ MSA",2022,7,489088,470244,18844,3.9
MT0449740000000,4,49740,"Yuma, AZ MSA",2022,7,96771,85380,11391,11.8
MT0522220000000,5,22220,"Fayetteville-Springdale-Rogers, AR MSA",2022,7,290062,283153,6909,2.4
MT0522900000000,5,22900,"Fort Smith, AR-OK MSA",2022,7,100079,96968,3111,3.1
MT0526300000000,5,26300,"Hot Springs, AR MSA",2022,7,43650,42079,1571,3.6
MT0527860000000,5,27860,"Jonesboro, AR MSA",2022,7,64746,62872,1874,2.9
MT0530780000000,5,30780,"Little Rock-North Little Rock-Conway, AR MSA",2022,7,363136,351928,11208,3.1
MT0612540000000,6,12540,"Bakersfield-Delano, CA MSA",2022,7,390954,364449,26505,6.8
MT0617020000000,6,17020,"Chico, CA MSA",2022,7,89623,85716,3907,4.4
MT0620940000000,6,20940,"El Centro, CA MSA",2022,7,68005,57976,10029,14.7
MT0623420000000,6,23420,"Fresno, CA MSA",2022,7,510266,477611,32655,6.4
MT0625260000000,6,25260,"Hanford-Corcoran, CA MSA",2022,7,54602,50684,3918,7.2
MT0631080000000,6,31080,"Los Angeles-Long Beach-Anaheim, CA MSA",2022,7,6594710,6321919,272791,4.1
MT0632900000000,6,32900,"Merced, CA MSA",2022,7,115572,106655,8917,7.7
MT0633700000000,6,33700,"Modesto, CA MSA",2022,7,244928,232334,12594,5.1
MT0634900000000,6,34900,"Napa, CA MSA",2022,7,70994,68839,2155,3
MT0637100000000,6,37100,"Oxnard-Thousand Oaks-Ventura, CA MSA",2022,7,412389,398105,14284,3.5
MT0639820000000,6,39820,"Redding, CA MSA",2022,7,76040,72731,3309,4.4
MT0640140000000,6,40140,"Riverside-San Bernardino-Ontario, CA MSA",2022,7,2136079,2053388,82691,3.9
MT0640900000000,6,40900,"Sacramento-Roseville-Folsom, CA MSA",2022,7,1137919,1097873,40046,3.5
MT0641500000000,6,41500,"Salinas, CA MSA",2022,7,216492,203543,12949,6
MT0641740000000,6,41740,"San Diego-Chula Vista-Carlsbad, CA MSA",2022,7,1608067,1557787,50280,3.1
MT0641860000000,6,41860,"San Francisco-Oakland-Fremont, CA MSA",2022,7,2498344,2430129,68215,2.7
MT0641940000000,6,41940,"San Jose-Sunnyvale-Santa Clara, CA MSA",2022,7,1043701,1016517,27184,2.6
MT0642020000000,6,42020,"San Luis Obispo-Paso Robles, CA MSA",2022,7,131132,127176,3956,3
MT0642100000000,6,42100,"Santa Cruz-Watsonville, CA MSA",2022,7,133775,127659,6116,4.6
MT0642200000000,6,42200,"Santa Maria-Santa Barbara, CA MSA",2022,7,217998,210453,7545,3.5
MT0642220000000,6,42220,"Santa Rosa-Petaluma, CA MSA",2022,7,244477,237174,7303,3
MT0644700000000,6,44700,"Stockton-Lodi, CA MSA",2022,7,356619,339167,17452,4.9
MT0646700000000,6,46700,"Vallejo, CA MSA",2022,7,209513,201571,7942,3.8
MT0647300000000,6,47300,"Visalia, CA MSA",2022,7,209780,192938,16842,8
MT0649700000000,6,49700,"Yuba City, CA MSA",2022,7,78006,73274,4732,6.1
MT0814500000000,8,14500,"Boulder, CO MSA",2022,7,191815,186987,4828,2.5
MT0817820000000,8,17820,"Colorado Springs, CO MSA",2022,7,380430,369060,11370,3
MT0819740000000,8,19740,"Denver-Aurora-Centennial, CO MSA",2022,7,1734199,1686324,47875,2.8
MT0822660000000,8,22660,"Fort Collins-Loveland, CO MSA",2022,7,201939,196453,5486,2.7
MT0824300000000,8,24300,"Grand Junction, CO MSA",2022,7,77935,75433,2502,3.2
MT0824540000000,8,24540,"Greeley, CO MSA",2022,7,169741,164496,5245,3.1
MT0839380000000,8,39380,"Pueblo, CO MSA",2022,7,73912,70822,3090,4.2
MT0914860000000,9,14860,"Bridgeport-Stamford-Danbury, CT MSA",2022,7,507762,489031,18731,3.7
MT0925540000000,9,25540,"Hartford-West Hartford-East Hartford, CT MSA",2022,7,607668,583567,24101,4
MT0935300000000,9,35300,"New Haven, CT MSA",2022,7,311833,299666,12167,3.9
MT0935980000000,9,35980,"Norwich-New London-Willimantic, CT MSA",2022,7,140001,134197,5804,4.1
MT0947930000000,9,47930,"Waterbury-Shelton, CT MSA",2022,7,239354,228870,10484,4.4
MT1020100000000,10,20100,"Dover, DE MSA",2022,7,84677,80817,3860,4.6
MT1147900000000,11,47900,"Washington-Arlington-Alexandria, DC-VA-MD-WV MSA",2022,7,3448508,3353548,94960,2.8
MT1215980000000,12,15980,"Cape Coral-Fort Myers, FL MSA",2022,7,363429,352871,10558,2.9
MT1218880000000,12,18880,"Crestview-Fort Walton Beach-Destin, FL MSA",2022,7,138784,135310,3474,2.5
MT1219660000000,12,19660,"Deltona-Daytona Beach-Ormond Beach, FL MSA",2022,7,308696,298661,10035,3.3
MT1223540000000,12,23540,"Gainesville, FL MSA",2022,7,165068,160087,4981,3
MT1226140000000,12,26140,"Homosassa Springs, FL MSA",2022,7,52359,50280,2079,4
MT1227260000000,12,27260,"Jacksonville, FL MSA",2022,7,826832,802986,23846,2.9
MT1229460000000,12,29460,"Lakeland-Winter Haven, FL MSA",2022,7,345486,333757,11729,3.4
MT1233100000000,12,33100,"Miami-Fort Lauderdale-West Palm Beach, FL MSA",2022,7,3180137,3093775,86362,2.7
MT1234940000000,12,34940,"Naples-Marco Island, FL MSA",2022,7,176397,171419,4978,2.8
MT1235840000000,12,35840,"North Port-Bradenton-Sarasota, FL MSA",2022,7,375142,364292,10850,2.9
MT1236100000000,12,36100,"Ocala, FL MSA",2022,7,151277,146023,5254,3.5
MT1236740000000,12,36740,"Orlando-Kissimmee-Sanford, FL MSA",2022,7,1457181,1416223,40958,2.8
MT1237340000000,12,37340,"Palm Bay-Melbourne-Titusville, FL MSA",2022,7,292767,284308,8459,2.9
MT1237460000000,12,37460,"Panama City-Panama City Beach, FL MSA",2022,7,97421,94653,2768,2.8
MT1237860000000,12,37860,"Pensacola-Ferry Pass-Brent, FL MSA",2022,7,234638,227902,6736,2.9
MT1238940000000,12,38940,"Port St. Lucie, FL MSA",2022,7,230039,222700,7339,3.2
MT1239460000000,12,39460,"Punta Gorda, FL MSA",2022,7,72418,69963,2455,3.4
MT1242680000000,12,42680,"Sebastian-Vero Beach-West Vero Corridor, FL MSA",2022,7,65772,63516,2256,3.4
MT1242700000000,12,42700,"Sebring, FL MSA",2022,7,35406,33973,1433,4
MT1245220000000,12,45220,"Tallahassee, FL MSA",2022,7,200980,195028,5952,3
MT1245300000000,12,45300,"Tampa-St. Petersburg-Clearwater, FL MSA",2022,7,1641748,1596338,45410,2.8
MT1248680000000,12,48680,"Wildwood-The Villages, FL MSA",2022,7,31997,30453,1544,4.8
MT1310500000000,13,10500,"Albany, GA MSA",2022,7,62977,60502,2475,3.9
MT1312020000000,13,12020,"Athens-Clarke County, GA MSA",2022,7,102610,99560,3050,3
MT1312060000000,13,12060,"Atlanta-Sandy Springs-Roswell, GA MSA",2022,7,3188586,3094146,94440,3
MT1312260000000,13,12260,"Augusta-Richmond County, GA-SC MSA",2022,7,263808,254398,9410,3.6
MT1315260000000,13,15260,"Brunswick-St. Simons, GA MSA",2022,7,52417,50849,1568,3
MT1317980000000,13,17980,"Columbus, GA-AL MSA",2022,7,128963,124300,4663,3.6
MT1319140000000,13,19140,"Dalton, GA MSA",2022,7,66523,64130,2393,3.6
MT1323580000000,13,23580,"Gainesville, GA MSA",2022,7,103438,100775,2663,2.6
MT1325980000000,13,25980,"Hinesville, GA MSA",2022,7,30786,29601,1185,3.8
MT1331420000000,13,31420,"Macon-Bibb County, GA MSA",2022,7,97235,93661,3574,3.7
MT1340660000000,13,40660,"Rome, GA MSA",2022,7,45052,43632,1420,3.2
MT1342340000000,13,42340,"Savannah, GA MSA",2022,7,203044,197064,5980,2.9
MT1346660000000,13,46660,"Valdosta, GA MSA",2022,7,61168,59089,2079,3.4
MT1347580000000,13,47580,"Warner Robins, GA MSA",2022,7,88026,85179,2847,3.2
MT1527980000000,15,27980,"Kahului-Wailuku, HI MSA",2022,7,83268,80513,2755,3.3
MT1546520000000,15,46520,"Urban Honolulu, HI MSA",2022,7,467443,452100,15343,3.3
MT1614260000000,16,14260,"Boise City, ID MSA",2022,7,425006,413612,11394,2.7
MT1617660000000,16,17660,"Coeur d'Alene, ID MSA",2022,7,86131,83132,2999,3.5
MT1626820000000,16,26820,"Idaho Falls, ID MSA",2022,7,80177,78134,2043,2.5
MT1630300000000,16,30300,"Lewiston, ID-WA MSA",2022,7,30444,29492,952,3.1
MT1638540000000,16,38540,"Pocatello, ID MSA",2022,7,39410,38090,1320,3.3
MT1646300000000,16,46300,"Twin Falls, ID MSA",2022,7,58644,56995,1649,2.8
MT1714010000000,17,14010,"Bloomington, IL MSA",2022,7,91341,88146,3195,3.5
MT1716580000000,17,16580,"Champaign-Urbana, IL MSA",2022,7,122838,118151,4687,3.8
MT1716980000000,17,16980,"Chicago-Naperville-Elgin, IL-IN MSA",2022,7,4867613,4641031,226582,4.7
MT1719340000000,17,19340,"Davenport-Moline-Rock Island, IA-IL MSA",2022,7,189253,181907,7346,3.9
MT1719500000000,17,19500,"Decatur, IL MSA",2022,7,45046,42535,2511,5.6
MT1728100000000,17,28100,"Kankakee, IL MSA",2022,7,50429,47665,2764,5.5
MT1737900000000,17,37900,"Peoria, IL MSA",2022,7,172744,165012,7732,4.5
MT1740420000000,17,40420,"Rockford, IL MSA",2022,7,159068,149952,9116,5.7
MT1744100000000,17,44100,"Springfield, IL MSA",2022,7,102238,97967,4271,4.2
MT1814020000000,18,14020,"Bloomington, IN MSA",2022,7,82984,80757,2227,2.7
MT1818020000000,18,18020,"Columbus, IN MSA",2022,7,39303,38210,1093,2.8
MT1821140000000,18,21140,"Elkhart-Goshen, IN MSA",2022,7,107565,104520,3045,2.8
MT1821780000000,18,21780,"Evansville, IN MSA",2022,7,134813,130842,3971,2.9
MT1823060000000,18,23060,"Fort Wayne, IN MSA",2022,7,227745,221378,6367,2.8
MT1826900000000,18,26900,"Indianapolis-Carmel-Greenwood, IN MSA",2022,7,1099466,1067907,31559,2.9
MT1829020000000,18,29020,"Kokomo, IN MSA",2022,7,35523,33930,1593,4.5
MT1829200000000,18,29200,"Lafayette-West Lafayette, IN MSA",2022,7,116492,113248,3244,2.8
MT1833140000000,18,33140,"Michigan City-La Porte, IN MSA",2022,7,50558,48755,1803,3.6
MT1834620000000,18,34620,"Muncie, IN MSA",2022,7,51522,49674,1848,3.6
MT1843780000000,18,43780,"South Bend-Mishawaka, IN-MI MSA",2022,7,154823,149106,5717,3.7
MT1845460000000,18,45460,"Terre Haute, IN MSA",2022,7,76821,74185,2636,3.4
MT1911180000000,19,11180,"Ames, IA MSA",2022,7,69123,67560,1563,2.3
MT1916300000000,19,16300,"Cedar Rapids, IA MSA",2022,7,149751,145259,4492,3
MT1919780000000,19,19780,"Des Moines-West Des Moines, IA MSA",2022,7,399132,388628,10504,2.6
MT1920220000000,19,20220,"Dubuque, IA MSA",2022,7,54037,52390,1647,3
MT1926980000000,19,26980,"Iowa City, IA MSA",2022,7,98874,96547,2327,2.4
MT1943580000000,19,43580,"Sioux City, IA-NE-SD MSA",2022,7,76333,74165,2168,2.8
MT1947940000000,19,47940,"Waterloo-Cedar Falls, IA MSA",2022,7,89533,87100,2433,2.7
MT2029940000000,20,29940,"Lawrence, KS MSA",2022,7,68666,66950,1716,2.5
MT2031740000000,20,31740,"Manhattan, KS MSA",2022,7,62900,61194,1706,2.7
MT2045820000000,20,45820,"Topeka, KS MSA",2022,7,116572,113161,3411,2.9
MT2048620000000,20,48620,"Wichita, KS MSA",2022,7,325395,315503,9892,3
MT2114540000000,21,14540,"Bowling Green, KY MSA",2022,7,88747,85479,3268,3.7
MT2121060000000,21,21060,"Elizabethtown, KY MSA",2022,7,53499,51140,2359,4.4
MT2130460000000,21,30460,"Lexington-Fayette, KY MSA",2022,7,268370,259508,8862,3.3
MT2131140000000,21,31140,"Louisville/Jefferson County, KY-IN MSA",2022,7,685047,661236,23811,3.5
MT2136980000000,21,36980,"Owensboro, KY MSA",2022,7,51122,49017,2105,4.1
MT2137140000000,21,37140,"Paducah, KY-IL MSA",2022,7,45340,43319,2021,4.5
MT2210780000000,22,10780,"Alexandria, LA MSA",2022,7,65224,63201,2023,3.1
MT2212940000000,22,12940,"Baton Rouge, LA MSA",2022,7,419175,404743,14432,3.4
MT2225220000000,22,25220,"Hammond, LA MSA",2022,7,59083,56718,2365,4
MT2226380000000,22,26380,"Houma-Bayou Cane-Thibodaux, LA MSA",2022,7,86678,83732,2946,3.4
MT2229180000000,22,29180,"Lafayette, LA MSA",2022,7,195525,189482,6043,3.1
MT2229340000000,22,29340,"Lake Charles, LA MSA",2022,7,99003,95351,3652,3.7
MT2233740000000,22,33740,"Monroe, LA MSA",2022,7,96394,92608,3786,3.9
MT2235380000000,22,35380,"New Orleans-Metairie, LA MSA",2022,7,468511,451025,17486,3.7
MT2243340000000,22,43340,"Shreveport-Bossier City, LA MSA",2022,7,168400,162266,6134,3.6
MT2243640000000,22,43640,"Slidell-Mandeville-Covington, LA MSA",2022,7,126798,123243,3555,2.8
MT2312620000000,23,12620,"Bangor, ME MSA",2022,7,72850,70759,2091,2.9
MT2330340000000,23,30340,"Lewiston-Auburn, ME MSA",2022,7,53635,52212,1423,2.7
MT2338860000000,23,38860,"Portland-South Portland, ME MSA",2022,7,300590,293883,6707,2.2
MT2412580000000,24,12580,"Baltimore-Columbia-Towson, MD MSA",2022,7,1457262,1413801,43461,3
MT2425180000000,24,25180,"Hagerstown-Martinsburg, MD-WV MSA",2022,7,141560,137177,4383,3.1
MT2430500000000,24,30500,"Lexington Park, MD MSA",2022,7,104560,101594,2966,2.8
MT2441540000000,24,41540,"Salisbury, MD MSA",2022,7,61769,59567,2202,3.6
MT2511200000000,25,11200,"Amherst Town-Northampton, MA MSA",2022,7,84595,81652,2943,3.5
MT2512700000000,25,12700,"Barnstable Town, MA MSA",2022,7,113242,108017,5225,4.6
MT2514460000000,25,14460,"Boston-Cambridge-Newton, MA-NH MSA",2022,7,2730854,2642469,88385,3.2
MT2538340000000,25,38340,"Pittsfield, MA MSA",2022,7,63533,60927,2606,4.1
MT2544140000000,25,44140,"Springfield, MA MSA",2022,7,222666,212132,10534,4.7
MT2549340000000,25,49340,"Worcester, MA MSA",2022,7,451893,434924,16969,3.8
MT2611460000000,26,11460,"Ann Arbor, MI MSA",2022,7,199430,192811,6619,3.3
MT2612980000000,26,12980,"Battle Creek, MI MSA",2022,7,59653,56899,2754,4.6
MT2613020000000,26,13020,"Bay City, MI MSA",2022,7,48435,45946,2489,5.1
MT2619820000000,26,19820,"Detroit-Warren-Dearborn, MI MSA",2022,7,2108124,2034239,73885,3.5
MT2622420000000,26,22420,"Flint, MI MSA",2022,7,181173,171741,9432,5.2
MT2624340000000,26,24340,"Grand Rapids-Wyoming-Kentwood, MI MSA",2022,7,602312,581200,21112,3.5
MT2627100000000,26,27100,"Jackson, MI MSA",2022,7,73116,69918,3198,4.4
MT2628020000000,26,28020,"Kalamazoo-Portage, MI MSA",2022,7,134436,129514,4922,3.7
MT2629620000000,26,29620,"Lansing-East Lansing, MI MSA",2022,7,241130,230738,10392,4.3
MT2633220000000,26,33220,"Midland, MI MSA",2022,7,40239,38543,1696,4.2
MT2633780000000,26,33780,"Monroe, MI MSA",2022,7,74595,71130,3465,4.6
MT2634740000000,26,34740,"Muskegon-Norton Shores, MI MSA",2022,7,81377,77642,3735,4.6
MT2635660000000,26,35660,"Niles, MI MSA",2022,7,73327,70206,3121,4.3
MT2640980000000,26,40980,"Saginaw, MI MSA",2022,7,82892,78459,4433,5.3
MT2645900000000,26,45900,"Traverse City, MI MSA",2022,7,78400,75135,3265,4.2
MT2720260000000,27,20260,"Duluth, MN-WI MSA",2022,7,138267,133795,4472,3.2
MT2731860000000,27,31860,"Mankato, MN MSA",2022,7,58560,57458,1102,1.9
MT2733460000000,27,33460,"Minneapolis-St. Paul-Bloomington, MN-WI MSA",2022,7,2038134,1993966,44168,2.2
MT2740340000000,27,40340,"Rochester, MN MSA",2022,7,123831,121253,2578,2.1
MT2741060000000,27,41060,"St. Cloud, MN MSA",2022,7,107823,105150,2673,2.5
MT2825060000000,28,25060,"Gulfport-Biloxi, MS MSA",2022,7,183184,176549,6635,3.6
MT2825620000000,28,25620,"Hattiesburg, MS MSA",2022,7,70304,67940,2364,3.4
MT2827140000000,28,27140,"Jackson, MS MSA",2022,7,276581,267141,9440,3.4
MT2916020000000,29,16020,"Cape Girardeau, MO-IL MSA",2022,7,47824,46691,1133,2.4
MT2917860000000,29,17860,"Columbia, MO MSA",2022,7,113260,111019,2241,2
MT2927620000000,29,27620,"Jefferson City, MO MSA",2022,7,73134,71605,1529,2.1
MT2927900000000,29,27900,"Joplin, MO-KS MSA",2022,7,95214,93038,2176,2.3
MT2928140000000,29,28140,"Kansas City, MO-KS MSA",2022,7,1155861,1126787,29074,2.5
MT2941140000000,29,41140,"St. Joseph, MO-KS MSA",2022,7,53994,52594,1400,2.6
MT2941180000000,29,41180,"St. Louis, MO-IL MSA",2022,7,1444293,1405109,39184,2.7
MT2944180000000,29,44180,"Springfield, MO MSA",2022,7,234582,229498,5084,2.2
MT3013740000000,30,13740,"Billings, MT MSA",2022,7,99284,96835,2449,2.5
MT3014580000000,30,14580,"Bozeman, MT MSA",2022,7,75020,73473,1547,2.1
MT3024500000000,30,24500,"Great Falls, MT MSA",2022,7,40073,38981,1092,2.7
MT3025740000000,30,25740,"Helena, MT MSA",2022,7,46639,45415,1224,2.6
MT3033540000000,30,33540,"Missoula, MT MSA",2022,7,72442,70554,1888,2.6
MT3124260000000,31,24260,"Grand Island, NE MSA",2022,7,41538,40636,902,2.2
MT3130700000000,31,30700,"Lincoln, NE MSA",2022,7,189521,185577,3944,2.1
MT3136540000000,31,36540,"Omaha, NE-IA MSA",2022,7,516369,503870,12499,2.4
MT3216180000000,32,16180,"Carson City, NV MSA",2022,7,28050,26788,1262,4.5
MT3229820000000,32,29820,"Las Vegas-Henderson-North Las Vegas, NV MSA",2022,7,1152923,1089221,63702,5.5
MT3239900000000,32,39900,"Reno, NV MSA",2022,7,290374,277831,12543,4.3
MT3331700000000,33,31700,"Manchester-Nashua, NH MSA",2022,7,239850,233917,5933,2.5
MT3412100000000,34,12100,"Atlantic City-Hammonton, NJ MSA",2022,7,177839,168840,8999,5.1
MT3445940000000,34,45940,"Trenton-Princeton, NJ MSA",2022,7,195166,189011,6155,3.2
MT3447220000000,34,47220,"Vineland, NJ MSA",2022,7,65109,61827,3282,5
MT3510740000000,35,10740,"Albuquerque, NM MSA",2022,7,447023,432036,14987,3.4
MT3522140000000,35,22140,"Farmington, NM MSA",2022,7,47756,45715,2041,4.3
MT3529740000000,35,29740,"Las Cruces, NM MSA",2022,7,97140,92977,4163,4.3
MT3542140000000,35,42140,"Santa Fe, NM MSA",2022,7,72684,70259,2425,3.3
MT3610580000000,36,10580,"Albany-Schenectady-Troy, NY MSA",2022,7,452820,438840,13980,3.1
MT3613780000000,36,13780,"Binghamton, NY MSA",2022,7,105568,101550,4018,3.8
MT3615380000000,36,15380,"Buffalo-Cheektowaga, NY MSA",2022,7,555047,534940,20107,3.6
MT3621300000000,36,21300,"Elmira, NY MSA",2022,7,35798,34508,1290,3.6
MT3624020000000,36,24020,"Glens Falls, NY MSA",2022,7,59403,57318,2085,3.5
MT3627060000000,36,27060,"Ithaca, NY MSA",2022,7,47834,46444,1390,2.9
MT3628740000000,36,28740,"Kingston, NY MSA",2022,7,85768,82963,2805,3.3
MT3628880000000,36,28880,"Kiryas Joel-Poughkeepsie-Newburgh, NY MSA",2022,7,333419,322655,10764,3.2
MT3635620000000,36,35620,"New York-Newark-Jersey City, NY-NJ MSA",2022,7,9897701,9505247,392454,4
MT3640380000000,36,40380,"Rochester, NY MSA",2022,7,509742,492143,17599,3.5
MT3645060000000,36,45060,"Syracuse, NY MSA",2022,7,310113,299136,10977,3.5
MT3646540000000,36,46540,"Utica-Rome, NY MSA",2022,7,127735,122990,4745,3.7
MT3648060000000,36,48060,"Watertown-Fort Drum, NY MSA",2022,7,44838,42910,1928,4.3
MT3711700000000,37,11700,"Asheville, NC MSA",2022,7,207887,201282,6605,3.2
MT3715500000000,37,15500,"Burlington, NC MSA",2022,7,83464,80258,3206,3.8
MT3716740000000,37,16740,"Charlotte-Concord-Gastonia, NC-SC MSA",2022,7,1441190,1390215,50975,3.5
MT3720500000000,37,20500,"Durham-Chapel Hill, NC MSA",2022,7,316110,305694,10416,3.3
MT3722180000000,37,22180,"Fayetteville, NC MSA",2022,7,153161,145700,7461,4.9
MT3724140000000,37,24140,"Goldsboro, NC MSA",2022,7,49672,47677,1995,4
MT3724660000000,37,24660,"Greensboro-High Point, NC MSA",2022,7,372894,357784,15110,4.1
MT3724780000000,37,24780,"Greenville, NC MSA",2022,7,82224,78803,3421,4.2
MT3725860000000,37,25860,"Hickory-Lenoir-Morganton, NC MSA",2022,7,172766,166522,6244,3.6
MT3727340000000,37,27340,"Jacksonville, NC MSA",2022,7,72609,69678,2931,4
MT3738240000000,37,38240,"Pinehurst-Southern Pines, NC MSA",2022,7,43360,41762,1598,3.7
MT3739580000000,37,39580,"Raleigh-Cary, NC MSA",2022,7,811744,786521,25223,3.1
MT3740580000000,37,40580,"Rocky Mount, NC MSA",2022,7,63772,60325,3447,5.4
MT3748900000000,37,48900,"Wilmington, NC MSA",2022,7,215431,207204,8227,3.8
MT3749180000000,37,49180,"Winston-Salem, NC MSA",2022,7,325478,313147,12331,3.8
MT3813900000000,38,13900,"Bismarck, ND MSA",2022,7,72548,71036,1512,2.1
MT3822020000000,38,22020,"Fargo, ND-MN MSA",2022,7,149788,147085,2703,1.8
MT3824220000000,38,24220,"Grand Forks, ND-MN MSA",2022,7,54528,53409,1119,2.1
MT3833500000000,38,33500,"Minot, ND MSA",2022,7,39563,38708,855,2.2
MT3910420000000,39,10420,"Akron, OH MSA",2022,7,353964,339600,14364,4.1
MT3915940000000,39,15940,"Canton-Massillon, OH MSA",2022,7,189147,181006,8141,4.3
MT3917140000000,39,17140,"Cincinnati, OH-KY-IN MSA",2022,7,1147003,1106077,40926,3.6
MT3917410000000,39,17410,"Cleveland, OH MSA",2022,7,1076464,1027560,48904,4.5
MT3918140000000,39,18140,"Columbus, OH MSA",2022,7,1116419,1077195,39224,3.5
MT3919430000000,39,19430,"Dayton-Kettering-Beavercreek, OH MSA",2022,7,382778,367470,15308,4
MT3930620000000,39,30620,"Lima, OH MSA",2022,7,46997,45073,1924,4.1
MT3931900000000,39,31900,"Mansfield, OH MSA",2022,7,52120,49709,2411,4.6
MT3941780000000,39,41780,"Sandusky, OH MSA",2022,7,56784,53744,3040,5.4
MT3944220000000,39,44220,"Springfield, OH MSA",2022,7,61186,58545,2641,4.3
MT3945780000000,39,45780,"Toledo, OH MSA",2022,7,289643,277151,12492,4.3
MT3948260000000,39,48260,"Weirton-Steubenville, WV-OH MSA",2022,7,52689,50162,2527,4.8
MT3949660000000,39,49660,"Youngstown-Warren, OH MSA",2022,7,188572,179639,8933,4.7
MT4021420000000,40,21420,"Enid, OK MSA",2022,7,28498,27704,794,2.8
MT4030020000000,40,30020,"Lawton, OK MSA",2022,7,50975,49100,1875,3.7
MT4036420000000,40,36420,"Oklahoma City, OK MSA",2022,7,730474,709838,20636,2.8
MT4046140000000,40,46140,"Tulsa, OK MSA",2022,7,497965,481971,15994,3.2
MT4110540000000,41,10540,"Albany, OR MSA",2022,7,61329,58653,2676,4.4
MT4113460000000,41,13460,"Bend, OR MSA",2022,7,126385,121104,5281,4.2
MT4118700000000,41,18700,"Corvallis, OR MSA",2022,7,48665,46964,1701,3.5
MT4121660000000,41,21660,"Eugene-Springfield, OR MSA",2022,7,186102,178242,7860,4.2
MT4124420000000,41,24420,"Grants Pass, OR MSA",2022,7,35130,33211,1919,5.5
MT4132780000000,41,32780,"Medford, OR MSA",2022,7,104972,100288,4684,4.5
MT4138900000000,41,38900,"Portland-Vancouver-Hillsboro, OR-WA MSA",2022,7,1371382,1322679,48703,3.6
MT4141420000000,41,41420,"Salem, OR MSA",2022,7,214276,205704,8572,4
MT4210900000000,42,10900,"Allentown-Bethlehem-Easton, PA-NJ MSA",2022,7,444784,426510,18274,4.1
MT4211020000000,42,11020,"Altoona, PA MSA",2022,7,56997,54456,2541,4.5
MT4216540000000,42,16540,"Chambersburg, PA MSA",2022,7,76767,74023,2744,3.6
MT4221500000000,42,21500,"Erie, PA MSA",2022,7,125709,119812,5897,4.7
MT4223900000000,42,23900,"Gettysburg, PA MSA",2022,7,51867,50044,1823,3.5
MT4225420000000,42,25420,"Harrisburg-Carlisle, PA MSA",2022,7,306141,295199,10942,3.6
MT4227780000000,42,27780,"Johnstown, PA MSA",2022,7,56873,53945,2928,5.1
MT4229540000000,42,29540,"Lancaster, PA MSA",2022,7,288837,279072,9765,3.4
MT4230140000000,42,30140,"Lebanon, PA MSA",2022,7,70957,68335,2622,3.7
MT4237980000000,42,37980,"Philadelphia-Camden-Wilmington, PA-NJ-DE-MD MSA",2022,7,3229865,3105378,124487,3.9
MT4238300000000,42,38300,"Pittsburgh, PA MSA",2022,7,1220421,1167511,52910,4.3
MT4239740000000,42,39740,"Reading, PA MSA",2022,7,215455,206675,8780,4.1
MT4242540000000,42,42540,"Scranton--Wilkes-Barre, PA MSA",2022,7,276624,263415,13209,4.8
MT4244300000000,42,44300,"State College, PA MSA",2022,7,75587,73001,2586,3.4
MT4248700000000,42,48700,"Williamsport, PA MSA",2022,7,52123,49582,2541,4.9
MT4249620000000,42,49620,"York-Hanover, PA MSA",2022,7,236361,227676,8685,3.7
MT4439300000000,44,39300,"Providence-Warwick, RI-MA MSA",2022,7,873541,841162,32379,3.7
MT4516700000000,45,16700,"Charleston-North Charleston, SC MSA",2022,7,410539,399308,11231,2.7
MT4517900000000,45,17900,"Columbia, SC MSA",2022,7,398496,386607,11889,3
MT4522500000000,45,22500,"Florence, SC MSA",2022,7,89627,86569,3058,3.4
MT4524860000000,45,24860,"Greenville-Anderson-Greer, SC MSA",2022,7,454990,442189,12801,2.8
MT4525940000000,45,25940,"Hilton Head Island-Bluffton-Port Royal, SC MSA",2022,7,92812,90091,2721,2.9
MT4534820000000,45,34820,"Myrtle Beach-Conway-North Myrtle Beach, SC MSA",2022,7,160222,154158,6064,3.8
MT4543900000000,45,43900,"Spartanburg, SC MSA",2022,7,167181,161757,5424,3.2
MT4544940000000,45,44940,"Sumter, SC MSA",2022,7,41598,40094,1504,3.6
MT4639660000000,46,39660,"Rapid City, SD MSA",2022,7,77934,76419,1515,1.9
MT4643620000000,46,43620,"Sioux Falls, SD-MN MSA",2022,7,167963,165112,2851,1.7
MT4716860000000,47,16860,"Chattanooga, TN-GA MSA",2022,7,276155,267323,8832,3.2
MT4717300000000,47,17300,"Clarksville, TN-KY MSA",2022,7,134159,128971,5188,3.9
MT4717420000000,47,17420,"Cleveland, TN MSA",2022,7,56941,54920,2021,3.5
MT4727180000000,47,27180,"Jackson, TN MSA",2022,7,78085,75186,2899,3.7
MT4727740000000,47,27740,"Johnson City, TN MSA",2022,7,96189,92889,3300,3.4
MT4728700000000,47,28700,"Kingsport-Bristol, TN-VA MSA",2022,7,130790,126113,4677,3.6
MT4728940000000,47,28940,"Knoxville, TN MSA",2022,7,441171,427122,14049,3.2
MT4732820000000,47,32820,"Memphis, TN-MS-AR MSA",2022,7,635618,610182,25436,4
MT4734100000000,47,34100,"Morristown, TN MSA",2022,7,53113,51150,1963,3.7
MT4734980000000,47,34980,"Nashville-Davidson--Murfreesboro--Franklin, TN MSA",2022,7,1128963,1097958,31005,2.7
MT4810180000000,48,10180,"Abilene, TX MSA",2022,7,82220,79474,2746,3.3
MT4811100000000,48,11100,"Amarillo, TX MSA",2022,7,132077,128080,3997,3
MT4812420000000,48,12420,"Austin-Round Rock-San Marcos, TX MSA",2022,7,1396807,1355873,40934,2.9
MT4813140000000,48,13140,"Beaumont-Port Arthur, TX MSA",2022,7,169859,160758,9101,5.4
MT4815180000000,48,15180,"Brownsville-Harlingen, TX MSA",2022,7,181006,171197,9809,5.4
MT4817780000000,48,17780,"College Station-Bryan, TX MSA",2022,7,140933,136313,4620,3.3
MT4818580000000,48,18580,"Corpus Christi, TX MSA",2022,7,200464,191030,9434,4.7
MT4819100000000,48,19100,"Dallas-Fort Worth-Arlington, TX MSA",2022,7,4238206,4090292,147914,3.5
MT4820580000000,48,20580,"Eagle Pass, TX MSA",2022,7,23162,21391,1771,7.6
MT4821340000000,48,21340,"El Paso, TX MSA",2022,7,388550,372943,15607,4
MT4826420000000,48,26420,"Houston-Pasadena-The Woodlands, TX MSA",2022,7,3597549,3451994,145555,4
MT4828660000000,48,28660,"Killeen-Temple, TX MSA",2022,7,193827,185705,8122,4.2
MT4829700000000,48,29700,"Laredo, TX MSA",2022,7,112074,107648,4426,3.9
MT4830980000000,48,30980,"Longview, TX MSA",2022,7,125766,120538,5228,4.2
MT4831180000000,48,31180,"Lubbock, TX MSA",2022,7,176005,169957,6048,3.4
MT4832580000000,48,32580,"McAllen-Edinburg-Mission, TX MSA",2022,7,378083,354233,23850,6.3
MT4833260000000,48,33260,"Midland, TX MSA",2022,7,93756,90801,2955,3.2
MT4836220000000,48,36220,"Odessa, TX MSA",2022,7,79949,77012,2937,3.7
MT4841660000000,48,41660,"San Angelo, TX MSA",2022,7,59053,57246,1807,3.1
MT4841700000000,48,41700,"San Antonio-New Braunfels, TX MSA",2022,7,1259237,1213738,45499,3.6
MT4843300000000,48,43300,"Sherman-Denison, TX MSA",2022,7,66968,64559,2409,3.6
MT4845500000000,48,45500,"Texarkana, TX-AR MSA",2022,7,60290,57654,2636,4.4
MT4846340000000,48,46340,"Tyler, TX MSA",2022,7,112187,108047,4140,3.7
MT4847020000000,48,47020,"Victoria, TX MSA",2022,7,44198,42451,1747,4
MT4847380000000,48,47380,"Waco, TX MSA",2022,7,139212,134194,5018,3.6
MT4848660000000,48,48660,"Wichita Falls, TX MSA",2022,7,65522,63119,2403,3.7
MT4930860000000,49,30860,"Logan, UT-ID MSA",2022,7,78698,77042,1656,2.1
MT4936260000000,49,36260,"Ogden, UT MSA",2022,7,334002,326471,7531,2.3
MT4939340000000,49,39340,"Provo-Orem-Lehi, UT MSA",2022,7,354099,346177,7922,2.2
MT4941100000000,49,41100,"St. George, UT MSA",2022,7,86295,84007,2288,2.7
MT4941620000000,49,41620,"Salt Lake City-Murray, UT MSA",2022,7,707409,690638,16771,2.4
MT5015540000000,50,15540,"Burlington-South Burlington, VT MSA",2022,7,126399,123914,2485,2
MT5113980000000,51,13980,"Blacksburg-Christiansburg-Radford, VA MSA",2022,7,90899,88352,2547,2.8
MT5116820000000,51,16820,"Charlottesville, VA MSA",2022,7,115043,112148,2895,2.5
MT5125500000000,51,25500,"Harrisonburg, VA MSA",2022,7,70880,69000,1880,2.7
MT5131340000000,51,31340,"Lynchburg, VA MSA",2022,7,126382,122586,3796,3
MT5140060000000,51,40060,"Richmond, VA MSA",2022,7,701964,681940,20024,2.9
MT5140220000000,51,40220,"Roanoke, VA MSA",2022,7,154204,149867,4337,2.8
MT5144420000000,51,44420,"Staunton-Stuarts Draft, VA MSA",2022,7,63906,62259,1647,2.6
MT5147260000000,51,47260,"Virginia Beach-Chesapeake-Norfolk, VA-NC MSA",2022,7,856807,830235,26572,3.1
MT5149020000000,51,49020,"Winchester, VA-WV MSA",2022,7,74482,72548,1934,2.6
MT5313380000000,53,13380,"Bellingham, WA MSA",2022,7,114244,109565,4679,4.1
MT5314740000000,53,14740,"Bremerton-Silverdale-Port Orchard, WA MSA",2022,7,121538,116641,4897,4
MT5328420000000,53,28420,"Kennewick-Richland, WA MSA",2022,7,145284,138384,6900,4.7
MT5331020000000,53,31020,"Longview-Kelso, WA MSA",2022,7,47639,45321,2318,4.9
MT5334580000000,53,34580,"Mount Vernon-Anacortes, WA MSA",2022,7,57972,55227,2745,4.7
MT5336500000000,53,36500,"Olympia-Lacey-Tumwater, WA MSA",2022,7,139766,133984,5782,4.1
MT5342660000000,53,42660,"Seattle-Tacoma-Bellevue, WA MSA",2022,7,2249376,2165643,83733,3.7
MT5344060000000,53,44060,"Spokane-Spokane Valley, WA MSA",2022,7,280973,269053,11920,4.2
MT5347460000000,53,47460,"Walla Walla, WA MSA",2022,7,29602,28412,1190,4
MT5348300000000,53,48300,"Wenatchee-East Wenatchee, WA MSA",2022,7,62369,59578,2791,4.5
MT5349420000000,53,49420,"Yakima, WA MSA",2022,7,127728,120600,7128,5.6
MT5413220000000,54,13220,"Beckley, WV MSA",2022,7,45395,43509,1886,4.2
MT5416620000000,54,16620,"Charleston, WV MSA",2022,7,89527,86023,3504,3.9
MT5426580000000,54,26580,"Huntington-Ashland, WV-KY-OH MSA",2022,7,154475,147727,6748,4.4
MT5434060000000,54,34060,"Morgantown, WV MSA",2022,7,70710,68090,2620,3.7
MT5437620000000,54,37620,"Parkersburg-Vienna, WV MSA",2022,7,39127,37525,1602,4.1
MT5448540000000,54,48540,"Wheeling, WV-OH MSA",2022,7,59007,56104,2903,4.9
MT5511540000000,55,11540,"Appleton, WI MSA",2022,7,134921,131654,3267,2.4
MT5520740000000,55,20740,"Eau Claire, WI MSA",2022,7,93529,90986,2543,2.7
MT5522540000000,55,22540,"Fond du Lac, WI MSA",2022,7,55994,54595,1399,2.5
MT5524580000000,55,24580,"Green Bay, WI MSA",2022,7,174933,170399,4534,2.6
MT5527500000000,55,27500,"Janesville-Beloit, WI MSA",2022,7,83917,81005,2912,3.5
MT5528450000000,55,28450,"Kenosha, WI MSA",2022,7,92501,89711,2790,3
MT5529100000000,55,29100,"La Crosse-Onalaska, WI-MN MSA",2022,7,88004,85770,2234,2.5
MT5531540000000,55,31540,"Madison, WI MSA",2022,7,394939,386179,8760,2.2
MT5533340000000,55,33340,"Milwaukee-Waukesha, WI MSA",2022,7,807607,783688,23919,3
MT5536780000000,55,36780,"Oshkosh-Neenah, WI MSA",2022,7,91719,89456,2263,2.5
MT5539540000000,55,39540,"Racine-Mount Pleasant, WI MSA",2022,7,99806,96444,3362,3.4
MT5543100000000,55,43100,"Sheboygan, WI MSA",2022,7,61741,60272,1469,2.4
MT5548140000000,55,48140,"Wausau, WI MSA",2022,7,74368,72555,1813,2.4
MT5616220000000,56,16220,"Casper, WY MSA",2022,7,41317,39822,1495,3.6
MT5616940000000,56,16940,"Cheyenne, WY MSA",2022,7,48267,46582,1685,3.5
MT7210380000000,72,10380,"Aguadilla, PR MSA",2022,7,85428,79281,6147,7.2
MT7211640000000,72,11640,"Arecibo, PR MSA",2022,7,64405,59747,4658,7.2
MT7225020000000,72,25020,"Guayama, PR MSA",2022,7,18241,16652,1589,8.7
MT7232420000000,72,32420,"Mayaguez, PR MSA",2022,7,64232,59575,4657,7.3
MT7238660000000,72,38660,"Ponce, PR MSA",2022,7,85652,78450,7202,8.4
MT7241980000000,72,41980,"San Juan-Bayamon-Caguas, PR MSA",2022,7,784197,744265,39932,5.1
MT0111500000000,1,11500,"Anniston-Oxford, AL MSA",2022,8,49104,47765,1339,2.7
MT0112220000000,1,12220,"Auburn-Opelika, AL MSA",2022,8,92011,89867,2144,2.3
MT0113820000000,1,13820,"Birmingham, AL MSA",2022,8,557147,544340,12807,2.3
MT0119300000000,1,19300,"Daphne-Fairhope-Foley, AL MSA",2022,8,110406,107915,2491,2.3
MT0119460000000,1,19460,"Decatur, AL MSA",2022,8,72649,71017,1632,2.2
MT0120020000000,1,20020,"Dothan, AL MSA",2022,8,66228,64580,1648,2.5
MT0122520000000,1,22520,"Florence-Muscle Shoals, AL MSA",2022,8,67010,65162,1848,2.8
MT0123460000000,1,23460,"Gadsden, AL MSA",2022,8,40788,39651,1137,2.8
MT0126620000000,1,26620,"Huntsville, AL MSA",2022,8,258967,253618,5349,2.1
MT0133660000000,1,33660,"Mobile, AL MSA",2022,8,182330,176435,5895,3.2
MT0133860000000,1,33860,"Montgomery, AL MSA",2022,8,171534,166812,4722,2.8
MT0146220000000,1,46220,"Tuscaloosa, AL MSA",2022,8,121632,118278,3354,2.8
MT0211260000000,2,11260,"Anchorage, AK MSA",2022,8,197402,190308,7094,3.6
MT0221820000000,2,21820,"Fairbanks-College, AK MSA",2022,8,44562,42983,1579,3.5
MT0422380000000,4,22380,"Flagstaff, AZ MSA",2022,8,72103,68897,3206,4.4
MT0429420000000,4,29420,"Lake Havasu City-Kingman, AZ MSA",2022,8,85940,81742,4198,4.9
MT0438060000000,4,38060,"Phoenix-Mesa-Chandler, AZ MSA",2022,8,2600191,2511526,88665,3.4
MT0439150000000,4,39150,"Prescott Valley-Prescott, AZ MSA",2022,8,103968,100039,3929,3.8
MT0443420000000,4,43420,"Sierra Vista-Douglas, AZ MSA",2022,8,47284,45139,2145,4.5
MT0446060000000,4,46060,"Tucson, AZ MSA",2022,8,489088,470185,18903,3.9
MT0449740000000,4,49740,"Yuma, AZ MSA",2022,8,97203,85686,11517,11.8
MT0522220000000,5,22220,"Fayetteville-Springdale-Rogers, AR MSA",2022,8,290758,283879,6879,2.4
MT0522900000000,5,22900,"Fort Smith, AR-OK MSA",2022,8,99980,96901,3079,3.1
MT0526300000000,5,26300,"Hot Springs, AR MSA",2022,8,43668,42100,1568,3.6
MT0527860000000,5,27860,"Jonesboro, AR MSA",2022,8,64721,62852,1869,2.9
MT0530780000000,5,30780,"Little Rock-North Little Rock-Conway, AR MSA",2022,8,363344,352202,11142,3.1
MT0612540000000,6,12540,"Bakersfield-Delano, CA MSA",2022,8,392275,365119,27156,6.9
MT0617020000000,6,17020,"Chico, CA MSA",2022,8,89705,85705,4000,4.5
MT0620940000000,6,20940,"El Centro, CA MSA",2022,8,68390,58056,10334,15.1
MT0623420000000,6,23420,"Fresno, CA MSA",2022,8,511695,478684,33011,6.5
MT0625260000000,6,25260,"Hanford-Corcoran, CA MSA",2022,8,54801,50790,4011,7.3
MT0631080000000,6,31080,"Los Angeles-Long Beach-Anaheim, CA MSA",2022,8,6595029,6324269,270760,4.1
MT0632900000000,6,32900,"Merced, CA MSA",2022,8,115724,106691,9033,7.8
MT0633700000000,6,33700,"Modesto, CA MSA",2022,8,245122,232250,12872,5.3
MT0634900000000,6,34900,"Napa, CA MSA",2022,8,71148,68985,2163,3
MT0637100000000,6,37100,"Oxnard-Thousand Oaks-Ventura, CA MSA",2022,8,412533,398196,14337,3.5
MT0639820000000,6,39820,"Redding, CA MSA",2022,8,76092,72730,3362,4.4
MT0640140000000,6,40140,"Riverside-San Bernardino-Ontario, CA MSA",2022,8,2137575,2054300,83275,3.9
MT0640900000000,6,40900,"Sacramento-Roseville-Folsom, CA MSA",2022,8,1139606,1099044,40562,3.6
MT0641500000000,6,41500,"Salinas, CA MSA",2022,8,216402,203133,13269,6.1
MT0641740000000,6,41740,"San Diego-Chula Vista-Carlsbad, CA MSA",2022,8,1609949,1559527,50422,3.1
MT0641860000000,6,41860,"San Francisco-Oakland-Fremont, CA MSA",2022,8,2499233,2430738,68495,2.7
MT0641940000000,6,41940,"San Jose-Sunnyvale-Santa Clara, CA MSA",2022,8,1045217,1017854,27363,2.6
MT0642020000000,6,42020,"San Luis Obispo-Paso Robles, CA MSA",2022,8,131009,127053,3956,3
MT0642100000000,6,42100,"Santa Cruz-Watsonville, CA MSA",2022,8,133927,127693,6234,4.7
MT0642200000000,6,42200,"Santa Maria-Santa Barbara, CA MSA",2022,8,217961,210360,7601,3.5
MT0642220000000,6,42220,"Santa Rosa-Petaluma, CA MSA",2022,8,244406,237078,7328,3
MT0644700000000,6,44700,"Stockton-Lodi, CA MSA",2022,8,356960,339179,17781,5
MT0646700000000,6,46700,"Vallejo, CA MSA",2022,8,209534,201514,8020,3.8
MT0647300000000,6,47300,"Visalia, CA MSA",2022,8,210547,193168,17379,8.3
MT0649700000000,6,49700,"Yuba City, CA MSA",2022,8,78090,73204,4886,6.3
MT0814500000000,8,14500,"Boulder, CO MSA",2022,8,191867,187055,4812,2.5
MT0817820000000,8,17820,"Colorado Springs, CO MSA",2022,8,380862,369395,11467,3
MT0819740000000,8,19740,"Denver-Aurora-Centennial, CO MSA",2022,8,1736099,1688017,48082,2.8
MT0822660000000,8,22660,"Fort Collins-Loveland, CO MSA",2022,8,201958,196472,5486,2.7
MT0824300000000,8,24300,"Grand Junction, CO MSA",2022,8,77915,75379,2536,3.3
MT0824540000000,8,24540,"Greeley, CO MSA",2022,8,169938,164690,5248,3.1
MT0839380000000,8,39380,"Pueblo, CO MSA",2022,8,73869,70757,3112,4.2
MT0914860000000,9,14860,"Bridgeport-Stamford-Danbury, CT MSA",2022,8,506729,488513,18216,3.6
MT0925540000000,9,25540,"Hartford-West Hartford-East Hartford, CT MSA",2022,8,605734,582336,23398,3.9
MT0935300000000,9,35300,"New Haven, CT MSA",2022,8,310644,298812,11832,3.8
MT0935980000000,9,35980,"Norwich-New London-Willimantic, CT MSA",2022,8,139656,134018,5638,4
MT0947930000000,9,47930,"Waterbury-Shelton, CT MSA",2022,8,238778,228511,10267,4.3
MT1020100000000,10,20100,"Dover, DE MSA",2022,8,84530,80679,3851,4.6
MT1147900000000,11,47900,"Washington-Arlington-Alexandria, DC-VA-MD-WV MSA",2022,8,3453240,3358539,94701,2.7
MT1215980000000,12,15980,"Cape Coral-Fort Myers, FL MSA",2022,8,364629,354199,10430,2.9
MT1218880000000,12,18880,"Crestview-Fort Walton Beach-Destin, FL MSA",2022,8,139086,135646,3440,2.5
MT1219660000000,12,19660,"Deltona-Daytona Beach-Ormond Beach, FL MSA",2022,8,309619,299587,10032,3.2
MT1223540000000,12,23540,"Gainesville, FL MSA",2022,8,165460,160522,4938,3
MT1226140000000,12,26140,"Homosassa Springs, FL MSA",2022,8,52475,50394,2081,4
MT1227260000000,12,27260,"Jacksonville, FL MSA",2022,8,828548,804866,23682,2.9
MT1229460000000,12,29460,"Lakeland-Winter Haven, FL MSA",2022,8,346229,334637,11592,3.3
MT1233100000000,12,33100,"Miami-Fort Lauderdale-West Palm Beach, FL MSA",2022,8,3187294,3102144,85150,2.7
MT1234940000000,12,34940,"Naples-Marco Island, FL MSA",2022,8,177095,172280,4815,2.7
MT1235840000000,12,35840,"North Port-Bradenton-Sarasota, FL MSA",2022,8,376083,365268,10815,2.9
MT1236100000000,12,36100,"Ocala, FL MSA",2022,8,151717,146494,5223,3.4
MT1236740000000,12,36740,"Orlando-Kissimmee-Sanford, FL MSA",2022,8,1462643,1422065,40578,2.8
MT1237340000000,12,37340,"Palm Bay-Melbourne-Titusville, FL MSA",2022,8,293491,285092,8399,2.9
MT1237460000000,12,37460,"Panama City-Panama City Beach, FL MSA",2022,8,97757,95021,2736,2.8
MT1237860000000,12,37860,"Pensacola-Ferry Pass-Brent, FL MSA",2022,8,234976,228285,6691,2.8
MT1238940000000,12,38940,"Port St. Lucie, FL MSA",2022,8,230726,223472,7254,3.1
MT1239460000000,12,39460,"Punta Gorda, FL MSA",2022,8,72741,70320,2421,3.3
MT1242680000000,12,42680,"Sebastian-Vero Beach-West Vero Corridor, FL MSA",2022,8,65954,63740,2214,3.4
MT1242700000000,12,42700,"Sebring, FL MSA",2022,8,35499,34070,1429,4
MT1245220000000,12,45220,"Tallahassee, FL MSA",2022,8,201241,195341,5900,2.9
MT1245300000000,12,45300,"Tampa-St. Petersburg-Clearwater, FL MSA",2022,8,1645631,1600420,45211,2.7
MT1248680000000,12,48680,"Wildwood-The Villages, FL MSA",2022,8,32106,30555,1551,4.8
MT1310500000000,13,10500,"Albany, GA MSA",2022,8,63083,60565,2518,4
MT1312020000000,13,12020,"Athens-Clarke County, GA MSA",2022,8,102680,99578,3102,3
MT1312060000000,13,12060,"Atlanta-Sandy Springs-Roswell, GA MSA",2022,8,3192815,3096996,95819,3
MT1312260000000,13,12260,"Augusta-Richmond County, GA-SC MSA",2022,8,263647,254109,9538,3.6
MT1315260000000,13,15260,"Brunswick-St. Simons, GA MSA",2022,8,52638,51050,1588,3
MT1317980000000,13,17980,"Columbus, GA-AL MSA",2022,8,128808,124057,4751,3.7
MT1319140000000,13,19140,"Dalton, GA MSA",2022,8,66472,64025,2447,3.7
MT1323580000000,13,23580,"Gainesville, GA MSA",2022,8,103730,101003,2727,2.6
MT1325980000000,13,25980,"Hinesville, GA MSA",2022,8,30841,29645,1196,3.9
MT1331420000000,13,31420,"Macon-Bibb County, GA MSA",2022,8,96997,93363,3634,3.7
MT1340660000000,13,40660,"Rome, GA MSA",2022,8,45168,43728,1440,3.2
MT1342340000000,13,42340,"Savannah, GA MSA",2022,8,202958,196903,6055,3
MT1346660000000,13,46660,"Valdosta, GA MSA",2022,8,61036,58917,2119,3.5
MT1347580000000,13,47580,"Warner Robins, GA MSA",2022,8,87839,84944,2895,3.3
MT1527980000000,15,27980,"Kahului-Wailuku, HI MSA",2022,8,83437,80683,2754,3.3
MT1546520000000,15,46520,"Urban Honolulu, HI MSA",2022,8,467972,452494,15478,3.3
MT1614260000000,16,14260,"Boise City, ID MSA",2022,8,425859,414357,11502,2.7
MT1617660000000,16,17660,"Coeur d'Alene, ID MSA",2022,8,86305,83253,3052,3.5
MT1626820000000,16,26820,"Idaho Falls, ID MSA",2022,8,80176,78125,2051,2.6
MT1630300000000,16,30300,"Lewiston, ID-WA MSA",2022,8,30455,29493,962,3.2
MT1638540000000,16,38540,"Pocatello, ID MSA",2022,8,39477,38142,1335,3.4
MT1646300000000,16,46300,"Twin Falls, ID MSA",2022,8,58378,56722,1656,2.8
MT1714010000000,17,14010,"Bloomington, IL MSA",2022,8,91488,88341,3147,3.4
MT1716580000000,17,16580,"Champaign-Urbana, IL MSA",2022,8,122538,117898,4640,3.8
MT1716980000000,17,16980,"Chicago-Naperville-Elgin, IL-IN MSA",2022,8,4868133,4640760,227373,4.7
MT1719340000000,17,19340,"Davenport-Moline-Rock Island, IA-IL MSA",2022,8,189136,181806,7330,3.9
MT1719500000000,17,19500,"Decatur, IL MSA",2022,8,45031,42562,2469,5.5
MT1728100000000,17,28100,"Kankakee, IL MSA",2022,8,50289,47516,2773,5.5
MT1737900000000,17,37900,"Peoria, IL MSA",2022,8,172486,164871,7615,4.4
MT1740420000000,17,40420,"Rockford, IL MSA",2022,8,158804,149927,8877,5.6
MT1744100000000,17,44100,"Springfield, IL MSA",2022,8,102079,97880,4199,4.1
MT1814020000000,18,14020,"Bloomington, IN MSA",2022,8,82795,80520,2275,2.7
MT1818020000000,18,18020,"Columbus, IN MSA",2022,8,39320,38207,1113,2.8
MT1821140000000,18,21140,"Elkhart-Goshen, IN MSA",2022,8,107013,103828,3185,3
MT1821780000000,18,21780,"Evansville, IN MSA",2022,8,134627,130624,4003,3
MT1823060000000,18,23060,"Fort Wayne, IN MSA",2022,8,227992,221605,6387,2.8
MT1826900000000,18,26900,"Indianapolis-Carmel-Greenwood, IN MSA",2022,8,1100795,1069049,31746,2.9
MT1829020000000,18,29020,"Kokomo, IN MSA",2022,8,35496,33864,1632,4.6
MT1829200000000,18,29200,"Lafayette-West Lafayette, IN MSA",2022,8,116882,113612,3270,2.8
MT1833140000000,18,33140,"Michigan City-La Porte, IN MSA",2022,8,50597,48765,1832,3.6
MT1834620000000,18,34620,"Muncie, IN MSA",2022,8,51522,49665,1857,3.6
MT1843780000000,18,43780,"South Bend-Mishawaka, IN-MI MSA",2022,8,154705,148922,5783,3.7
MT1845460000000,18,45460,"Terre Haute, IN MSA",2022,8,76672,73989,2683,3.5
MT1911180000000,19,11180,"Ames, IA MSA",2022,8,69267,67645,1622,2.3
MT1916300000000,19,16300,"Cedar Rapids, IA MSA",2022,8,149894,145273,4621,3.1
MT1919780000000,19,19780,"Des Moines-West Des Moines, IA MSA",2022,8,400026,389281,10745,2.7
MT1920220000000,19,20220,"Dubuque, IA MSA",2022,8,54080,52350,1730,3.2
MT1926980000000,19,26980,"Iowa City, IA MSA",2022,8,99014,96626,2388,2.4
MT1943580000000,19,43580,"Sioux City, IA-NE-SD MSA",2022,8,76489,74254,2235,2.9
MT1947940000000,19,47940,"Waterloo-Cedar Falls, IA MSA",2022,8,89508,86987,2521,2.8
MT2029940000000,20,29940,"Lawrence, KS MSA",2022,8,68797,67031,1766,2.6
MT2031740000000,20,31740,"Manhattan, KS MSA",2022,8,62916,61163,1753,2.8
MT2045820000000,20,45820,"Topeka, KS MSA",2022,8,116729,113258,3471,3
MT2048620000000,20,48620,"Wichita, KS MSA",2022,8,325823,315790,10033,3.1
MT2114540000000,21,14540,"Bowling Green, KY MSA",2022,8,88904,85594,3310,3.7
MT2121060000000,21,21060,"Elizabethtown, KY MSA",2022,8,53405,51040,2365,4.4
MT2130460000000,21,30460,"Lexington-Fayette, KY MSA",2022,8,268545,259560,8985,3.3
MT2131140000000,21,31140,"Louisville/Jefferson County, KY-IN MSA",2022,8,684749,660785,23964,3.5
MT2136980000000,21,36980,"Owensboro, KY MSA",2022,8,51071,48901,2170,4.2
MT2137140000000,21,37140,"Paducah, KY-IL MSA",2022,8,45252,43217,2035,4.5
MT2210780000000,22,10780,"Alexandria, LA MSA",2022,8,65149,63127,2022,3.1
MT2212940000000,22,12940,"Baton Rouge, LA MSA",2022,8,418665,404377,14288,3.4
MT2225220000000,22,25220,"Hammond, LA MSA",2022,8,59080,56733,2347,4
MT2226380000000,22,26380,"Houma-Bayou Cane-Thibodaux, LA MSA",2022,8,86789,83888,2901,3.3
MT2229180000000,22,29180,"Lafayette, LA MSA",2022,8,195632,189628,6004,3.1
MT2229340000000,22,29340,"Lake Charles, LA MSA",2022,8,98799,95180,3619,3.7
MT2233740000000,22,33740,"Monroe, LA MSA",2022,8,96293,92522,3771,3.9
MT2235380000000,22,35380,"New Orleans-Metairie, LA MSA",2022,8,468122,451083,17039,3.6
MT2243340000000,22,43340,"Shreveport-Bossier City, LA MSA",2022,8,168266,162205,6061,3.6
MT2243640000000,22,43640,"Slidell-Mandeville-Covington, LA MSA",2022,8,126925,123380,3545,2.8
MT2312620000000,23,12620,"Bangor, ME MSA",2022,8,72906,70795,2111,2.9
MT2330340000000,23,30340,"Lewiston-Auburn, ME MSA",2022,8,53582,52155,1427,2.7
MT2338860000000,23,38860,"Portland-South Portland, ME MSA",2022,8,300835,294161,6674,2.2
MT2412580000000,24,12580,"Baltimore-Columbia-Towson, MD MSA",2022,8,1458359,1415500,42859,2.9
MT2425180000000,24,25180,"Hagerstown-Martinsburg, MD-WV MSA",2022,8,141655,137290,4365,3.1
MT2430500000000,24,30500,"Lexington Park, MD MSA",2022,8,104543,101619,2924,2.8
MT2441540000000,24,41540,"Salisbury, MD MSA",2022,8,61781,59617,2164,3.5
MT2511200000000,25,11200,"Amherst Town-Northampton, MA MSA",2022,8,84799,81866,2933,3.5
MT2512700000000,25,12700,"Barnstable Town, MA MSA",2022,8,113348,108084,5264,4.6
MT2514460000000,25,14460,"Boston-Cambridge-Newton, MA-NH MSA",2022,8,2731792,2643328,88464,3.2
MT2538340000000,25,38340,"Pittsfield, MA MSA",2022,8,63416,60788,2628,4.1
MT2544140000000,25,44140,"Springfield, MA MSA",2022,8,222355,211799,10556,4.7
MT2549340000000,25,49340,"Worcester, MA MSA",2022,8,451817,434805,17012,3.8
MT2611460000000,26,11460,"Ann Arbor, MI MSA",2022,8,199580,192958,6622,3.3
MT2612980000000,26,12980,"Battle Creek, MI MSA",2022,8,59829,57049,2780,4.6
MT2613020000000,26,13020,"Bay City, MI MSA",2022,8,48489,45975,2514,5.2
MT2619820000000,26,19820,"Detroit-Warren-Dearborn, MI MSA",2022,8,2107258,2034039,73219,3.5
MT2622420000000,26,22420,"Flint, MI MSA",2022,8,181729,172232,9497,5.2
MT2624340000000,26,24340,"Grand Rapids-Wyoming-Kentwood, MI MSA",2022,8,603310,582073,21237,3.5
MT2627100000000,26,27100,"Jackson, MI MSA",2022,8,73123,69919,3204,4.4
MT2628020000000,26,28020,"Kalamazoo-Portage, MI MSA",2022,8,134463,129507,4956,3.7
MT2629620000000,26,29620,"Lansing-East Lansing, MI MSA",2022,8,241539,231294,10245,4.2
MT2633220000000,26,33220,"Midland, MI MSA",2022,8,40282,38568,1714,4.3
MT2633780000000,26,33780,"Monroe, MI MSA",2022,8,74495,71053,3442,4.6
MT2634740000000,26,34740,"Muskegon-Norton Shores, MI MSA",2022,8,81447,77650,3797,4.7
MT2635660000000,26,35660,"Niles, MI MSA",2022,8,73441,70280,3161,4.3
MT2640980000000,26,40980,"Saginaw, MI MSA",2022,8,82903,78453,4450,5.4
MT2645900000000,26,45900,"Traverse City, MI MSA",2022,8,78532,75225,3307,4.2
MT2720260000000,27,20260,"Duluth, MN-WI MSA",2022,8,138494,133914,4580,3.3
MT2731860000000,27,31860,"Mankato, MN MSA",2022,8,58748,57602,1146,2
MT2733460000000,27,33460,"Minneapolis-St. Paul-Bloomington, MN-WI MSA",2022,8,2037831,1992204,45627,2.2
MT2740340000000,27,40340,"Rochester, MN MSA",2022,8,123910,121260,2650,2.1
MT2741060000000,27,41060,"St. Cloud, MN MSA",2022,8,108014,105247,2767,2.6
MT2825060000000,28,25060,"Gulfport-Biloxi, MS MSA",2022,8,183015,176380,6635,3.6
MT2825620000000,28,25620,"Hattiesburg, MS MSA",2022,8,70316,67962,2354,3.3
MT2827140000000,28,27140,"Jackson, MS MSA",2022,8,276830,267393,9437,3.4
MT2916020000000,29,16020,"Cape Girardeau, MO-IL MSA",2022,8,47881,46701,1180,2.5
MT2917860000000,29,17860,"Columbia, MO MSA",2022,8,113383,111044,2339,2.1
MT2927620000000,29,27620,"Jefferson City, MO MSA",2022,8,73152,71546,1606,2.2
MT2927900000000,29,27900,"Joplin, MO-KS MSA",2022,8,95287,93008,2279,2.4
MT2928140000000,29,28140,"Kansas City, MO-KS MSA",2022,8,1158857,1128756,30101,2.6
MT2941140000000,29,41140,"St. Joseph, MO-KS MSA",2022,8,53870,52411,1459,2.7
MT2941180000000,29,41180,"St. Louis, MO-IL MSA",2022,8,1445507,1405357,40150,2.8
MT2944180000000,29,44180,"Springfield, MO MSA",2022,8,235083,229753,5330,2.3
MT3013740000000,30,13740,"Billings, MT MSA",2022,8,99220,96809,2411,2.4
MT3014580000000,30,14580,"Bozeman, MT MSA",2022,8,75163,73631,1532,2
MT3024500000000,30,24500,"Great Falls, MT MSA",2022,8,40109,39033,1076,2.7
MT3025740000000,30,25740,"Helena, MT MSA",2022,8,46744,45537,1207,2.6
MT3033540000000,30,33540,"Missoula, MT MSA",2022,8,72497,70642,1855,2.6
MT3124260000000,31,24260,"Grand Island, NE MSA",2022,8,41535,40629,906,2.2
MT3130700000000,31,30700,"Lincoln, NE MSA",2022,8,189668,185650,4018,2.1
MT3136540000000,31,36540,"Omaha, NE-IA MSA",2022,8,516542,503718,12824,2.5
MT3216180000000,32,16180,"Carson City, NV MSA",2022,8,28126,26853,1273,4.5
MT3229820000000,32,29820,"Las Vegas-Henderson-North Las Vegas, NV MSA",2022,8,1158649,1094722,63927,5.5
MT3239900000000,32,39900,"Reno, NV MSA",2022,8,290911,278183,12728,4.4
MT3331700000000,33,31700,"Manchester-Nashua, NH MSA",2022,8,240133,233996,6137,2.6
MT3412100000000,34,12100,"Atlantic City-Hammonton, NJ MSA",2022,8,178341,169426,8915,5
MT3445940000000,34,45940,"Trenton-Princeton, NJ MSA",2022,8,195881,189793,6088,3.1
MT3447220000000,34,47220,"Vineland, NJ MSA",2022,8,65253,61985,3268,5
MT3510740000000,35,10740,"Albuquerque, NM MSA",2022,8,447406,433053,14353,3.2
MT3522140000000,35,22140,"Farmington, NM MSA",2022,8,47839,45866,1973,4.1
MT3529740000000,35,29740,"Las Cruces, NM MSA",2022,8,97195,93127,4068,4.2
MT3542140000000,35,42140,"Santa Fe, NM MSA",2022,8,72521,70190,2331,3.2
MT3610580000000,36,10580,"Albany-Schenectady-Troy, NY MSA",2022,8,452660,438722,13938,3.1
MT3613780000000,36,13780,"Binghamton, NY MSA",2022,8,105577,101587,3990,3.8
MT3615380000000,36,15380,"Buffalo-Cheektowaga, NY MSA",2022,8,554391,534433,19958,3.6
MT3621300000000,36,21300,"Elmira, NY MSA",2022,8,35660,34367,1293,3.6
MT3624020000000,36,24020,"Glens Falls, NY MSA",2022,8,59313,57241,2072,3.5
MT3627060000000,36,27060,"Ithaca, NY MSA",2022,8,47921,46521,1400,2.9
MT3628740000000,36,28740,"Kingston, NY MSA",2022,8,85708,82930,2778,3.2
MT3628880000000,36,28880,"Kiryas Joel-Poughkeepsie-Newburgh, NY MSA",2022,8,333450,322813,10637,3.2
MT3635620000000,36,35620,"New York-Newark-Jersey City, NY-NJ MSA",2022,8,9917045,9532889,384156,3.9
MT3640380000000,36,40380,"Rochester, NY MSA",2022,8,509411,491982,17429,3.4
MT3645060000000,36,45060,"Syracuse, NY MSA",2022,8,310331,299441,10890,3.5
MT3646540000000,36,46540,"Utica-Rome, NY MSA",2022,8,127667,122913,4754,3.7
MT3648060000000,36,48060,"Watertown-Fort Drum, NY MSA",2022,8,44791,42864,1927,4.3
MT3711700000000,37,11700,"Asheville, NC MSA",2022,8,207796,201159,6637,3.2
MT3715500000000,37,15500,"Burlington, NC MSA",2022,8,83455,80209,3246,3.9
MT3716740000000,37,16740,"Charlotte-Concord-Gastonia, NC-SC MSA",2022,8,1441634,1390191,51443,3.6
MT3720500000000,37,20500,"Durham-Chapel Hill, NC MSA",2022,8,316177,305700,10477,3.3
MT3722180000000,37,22180,"Fayetteville, NC MSA",2022,8,153041,145528,7513,4.9
MT3724140000000,37,24140,"Goldsboro, NC MSA",2022,8,49632,47639,1993,4
MT3724660000000,37,24660,"Greensboro-High Point, NC MSA",2022,8,372833,357573,15260,4.1
MT3724780000000,37,24780,"Greenville, NC MSA",2022,8,82308,78851,3457,4.2
MT3725860000000,37,25860,"Hickory-Lenoir-Morganton, NC MSA",2022,8,172770,166496,6274,3.6
MT3727340000000,37,27340,"Jacksonville, NC MSA",2022,8,72722,69783,2939,4
MT3738240000000,37,38240,"Pinehurst-Southern Pines, NC MSA",2022,8,43433,41825,1608,3.7
MT3739580000000,37,39580,"Raleigh-Cary, NC MSA",2022,8,812724,787353,25371,3.1
MT3740580000000,37,40580,"Rocky Mount, NC MSA",2022,8,63719,60241,3478,5.5
MT3748900000000,37,48900,"Wilmington, NC MSA",2022,8,215814,207548,8266,3.8
MT3749180000000,37,49180,"Winston-Salem, NC MSA",2022,8,325489,313073,12416,3.8
MT3813900000000,38,13900,"Bismarck, ND MSA",2022,8,72436,70922,1514,2.1
MT3822020000000,38,22020,"Fargo, ND-MN MSA",2022,8,149872,147148,2724,1.8
MT3824220000000,38,24220,"Grand Forks, ND-MN MSA",2022,8,54576,53429,1147,2.1
MT3833500000000,38,33500,"Minot, ND MSA",2022,8,39492,38632,860,2.2
MT3910420000000,39,10420,"Akron, OH MSA",2022,8,354312,339806,14506,4.1
MT3915940000000,39,15940,"Canton-Massillon, OH MSA",2022,8,189009,180741,8268,4.4
MT3917140000000,39,17140,"Cincinnati, OH-KY-IN MSA",2022,8,1147430,1105987,41443,3.6
MT3917410000000,39,17410,"Cleveland, OH MSA",2022,8,1076176,1027751,48425,4.5
MT3918140000000,39,18140,"Columbus, OH MSA",2022,8,1115394,1075662,39732,3.6
MT3919430000000,39,19430,"Dayton-Kettering-Beavercreek, OH MSA",2022,8,382681,367191,15490,4
MT3930620000000,39,30620,"Lima, OH MSA",2022,8,47007,45038,1969,4.2
MT3931900000000,39,31900,"Mansfield, OH MSA",2022,8,52051,49611,2440,4.7
MT3941780000000,39,41780,"Sandusky, OH MSA",2022,8,56603,53598,3005,5.3
MT3944220000000,39,44220,"Springfield, OH MSA",2022,8,61108,58466,2642,4.3
MT3945780000000,39,45780,"Toledo, OH MSA",2022,8,289681,276938,12743,4.4
MT3948260000000,39,48260,"Weirton-Steubenville, WV-OH MSA",2022,8,52606,50074,2532,4.8
MT3949660000000,39,49660,"Youngstown-Warren, OH MSA",2022,8,188745,179691,9054,4.8
MT4021420000000,40,21420,"Enid, OK MSA",2022,8,28341,27537,804,2.8
MT4030020000000,40,30020,"Lawton, OK MSA",2022,8,51042,49151,1891,3.7
MT4036420000000,40,36420,"Oklahoma City, OK MSA",2022,8,732415,711502,20913,2.9
MT4046140000000,40,46140,"Tulsa, OK MSA",2022,8,499117,482972,16145,3.2
MT4110540000000,41,10540,"Albany, OR MSA",2022,8,61217,58475,2742,4.5
MT4113460000000,41,13460,"Bend, OR MSA",2022,8,126244,120799,5445,4.3
MT4118700000000,41,18700,"Corvallis, OR MSA",2022,8,48664,46922,1742,3.6
MT4121660000000,41,21660,"Eugene-Springfield, OR MSA",2022,8,185867,177760,8107,4.4
MT4124420000000,41,24420,"Grants Pass, OR MSA",2022,8,35060,33082,1978,5.6
MT4132780000000,41,32780,"Medford, OR MSA",2022,8,104820,99934,4886,4.7
MT4138900000000,41,38900,"Portland-Vancouver-Hillsboro, OR-WA MSA",2022,8,1371128,1321334,49794,3.6
MT4141420000000,41,41420,"Salem, OR MSA",2022,8,214360,205555,8805,4.1
MT4210900000000,42,10900,"Allentown-Bethlehem-Easton, PA-NJ MSA",2022,8,444982,426822,18160,4.1
MT4211020000000,42,11020,"Altoona, PA MSA",2022,8,56845,54330,2515,4.4
MT4216540000000,42,16540,"Chambersburg, PA MSA",2022,8,76730,74000,2730,3.6
MT4221500000000,42,21500,"Erie, PA MSA",2022,8,125466,119602,5864,4.7
MT4223900000000,42,23900,"Gettysburg, PA MSA",2022,8,51845,50048,1797,3.5
MT4225420000000,42,25420,"Harrisburg-Carlisle, PA MSA",2022,8,306556,295701,10855,3.5
MT4227780000000,42,27780,"Johnstown, PA MSA",2022,8,56836,53934,2902,5.1
MT4229540000000,42,29540,"Lancaster, PA MSA",2022,8,288743,279149,9594,3.3
MT4230140000000,42,30140,"Lebanon, PA MSA",2022,8,71067,68481,2586,3.6
MT4237980000000,42,37980,"Philadelphia-Camden-Wilmington, PA-NJ-DE-MD MSA",2022,8,3233691,3110299,123392,3.8
MT4238300000000,42,38300,"Pittsburgh, PA MSA",2022,8,1220228,1167731,52497,4.3
MT4239740000000,42,39740,"Reading, PA MSA",2022,8,215531,206887,8644,4
MT4242540000000,42,42540,"Scranton--Wilkes-Barre, PA MSA",2022,8,276486,263360,13126,4.7
MT4244300000000,42,44300,"State College, PA MSA",2022,8,75765,73212,2553,3.4
MT4248700000000,42,48700,"Williamsport, PA MSA",2022,8,52047,49540,2507,4.8
MT4249620000000,42,49620,"York-Hanover, PA MSA",2022,8,236226,227664,8562,3.6
MT4439300000000,44,39300,"Providence-Warwick, RI-MA MSA",2022,8,873344,840793,32551,3.7
MT4516700000000,45,16700,"Charleston-North Charleston, SC MSA",2022,8,412274,401032,11242,2.7
MT4517900000000,45,17900,"Columbia, SC MSA",2022,8,398458,386546,11912,3
MT4522500000000,45,22500,"Florence, SC MSA",2022,8,89681,86620,3061,3.4
MT4524860000000,45,24860,"Greenville-Anderson-Greer, SC MSA",2022,8,455571,442695,12876,2.8
MT4525940000000,45,25940,"Hilton Head Island-Bluffton-Port Royal, SC MSA",2022,8,93076,90341,2735,2.9
MT4534820000000,45,34820,"Myrtle Beach-Conway-North Myrtle Beach, SC MSA",2022,8,160813,154699,6114,3.8
MT4543900000000,45,43900,"Spartanburg, SC MSA",2022,8,167347,161882,5465,3.3
MT4544940000000,45,44940,"Sumter, SC MSA",2022,8,41514,39990,1524,3.7
MT4639660000000,46,39660,"Rapid City, SD MSA",2022,8,77987,76451,1536,2
MT4643620000000,46,43620,"Sioux Falls, SD-MN MSA",2022,8,168332,165440,2892,1.7
MT4716860000000,47,16860,"Chattanooga, TN-GA MSA",2022,8,276871,267979,8892,3.2
MT4717300000000,47,17300,"Clarksville, TN-KY MSA",2022,8,134065,128858,5207,3.9
MT4717420000000,47,17420,"Cleveland, TN MSA",2022,8,56619,54581,2038,3.6
MT4727180000000,47,27180,"Jackson, TN MSA",2022,8,77934,75037,2897,3.7
MT4727740000000,47,27740,"Johnson City, TN MSA",2022,8,95948,92638,3310,3.4
MT4728700000000,47,28700,"Kingsport-Bristol, TN-VA MSA",2022,8,130751,126045,4706,3.6
MT4728940000000,47,28940,"Knoxville, TN MSA",2022,8,440761,426734,14027,3.2
MT4732820000000,47,32820,"Memphis, TN-MS-AR MSA",2022,8,633038,607470,25568,4
MT4734100000000,47,34100,"Morristown, TN MSA",2022,8,53008,51056,1952,3.7
MT4734980000000,47,34980,"Nashville-Davidson--Murfreesboro--Franklin, TN MSA",2022,8,1128280,1097213,31067,2.8
MT4810180000000,48,10180,"Abilene, TX MSA",2022,8,82302,79546,2756,3.3
MT4811100000000,48,11100,"Amarillo, TX MSA",2022,8,131804,127795,4009,3
MT4812420000000,48,12420,"Austin-Round Rock-San Marcos, TX MSA",2022,8,1402098,1360767,41331,2.9
MT4813140000000,48,13140,"Beaumont-Port Arthur, TX MSA",2022,8,170546,161406,9140,5.4
MT4815180000000,48,15180,"Brownsville-Harlingen, TX MSA",2022,8,181213,171372,9841,5.4
MT4817780000000,48,17780,"College Station-Bryan, TX MSA",2022,8,141186,136515,4671,3.3
MT4818580000000,48,18580,"Corpus Christi, TX MSA",2022,8,200371,190972,9399,4.7
MT4819100000000,48,19100,"Dallas-Fort Worth-Arlington, TX MSA",2022,8,4249449,4100035,149414,3.5
MT4820580000000,48,20580,"Eagle Pass, TX MSA",2022,8,23168,21391,1777,7.7
MT4821340000000,48,21340,"El Paso, TX MSA",2022,8,388780,373062,15718,4
MT4826420000000,48,26420,"Houston-Pasadena-The Woodlands, TX MSA",2022,8,3606815,3460635,146180,4.1
MT4828660000000,48,28660,"Killeen-Temple, TX MSA",2022,8,193925,185776,8149,4.2
MT4829700000000,48,29700,"Laredo, TX MSA",2022,8,112034,107628,4406,3.9
MT4830980000000,48,30980,"Longview, TX MSA",2022,8,125928,120671,5257,4.2
MT4831180000000,48,31180,"Lubbock, TX MSA",2022,8,175840,169735,6105,3.5
MT4832580000000,48,32580,"McAllen-Edinburg-Mission, TX MSA",2022,8,378645,354641,24004,6.3
MT4833260000000,48,33260,"Midland, TX MSA",2022,8,94277,91362,2915,3.1
MT4836220000000,48,36220,"Odessa, TX MSA",2022,8,80187,77281,2906,3.6
MT4841660000000,48,41660,"San Angelo, TX MSA",2022,8,59054,57245,1809,3.1
MT4841700000000,48,41700,"San Antonio-New Braunfels, TX MSA",2022,8,1261383,1215699,45684,3.6
MT4843300000000,48,43300,"Sherman-Denison, TX MSA",2022,8,67083,64647,2436,3.6
MT4845500000000,48,45500,"Texarkana, TX-AR MSA",2022,8,60274,57642,2632,4.4
MT4846340000000,48,46340,"Tyler, TX MSA",2022,8,112189,108067,4122,3.7
MT4847020000000,48,47020,"Victoria, TX MSA",2022,8,44181,42427,1754,4
MT4847380000000,48,47380,"Waco, TX MSA",2022,8,139316,134299,5017,3.6
MT4848660000000,48,48660,"Wichita Falls, TX MSA",2022,8,65439,63046,2393,3.7
MT4930860000000,49,30860,"Logan, UT-ID MSA",2022,8,78676,76993,1683,2.1
MT4936260000000,49,36260,"Ogden, UT MSA",2022,8,334723,327109,7614,2.3
MT4939340000000,49,39340,"Provo-Orem-Lehi, UT MSA",2022,8,354941,346864,8077,2.3
MT4941100000000,49,41100,"St. George, UT MSA",2022,8,86494,84175,2319,2.7
MT4941620000000,49,41620,"Salt Lake City-Murray, UT MSA",2022,8,709256,692234,17022,2.4
MT5015540000000,50,15540,"Burlington-South Burlington, VT MSA",2022,8,126494,124030,2464,1.9
MT5113980000000,51,13980,"Blacksburg-Christiansburg-Radford, VA MSA",2022,8,90944,88340,2604,2.9
MT5116820000000,51,16820,"Charlottesville, VA MSA",2022,8,115273,112323,2950,2.6
MT5125500000000,51,25500,"Harrisonburg, VA MSA",2022,8,71015,69085,1930,2.7
MT5131340000000,51,31340,"Lynchburg, VA MSA",2022,8,126475,122600,3875,3.1
MT5140060000000,51,40060,"Richmond, VA MSA",2022,8,703763,683367,20396,2.9
MT5140220000000,51,40220,"Roanoke, VA MSA",2022,8,154613,150219,4394,2.8
MT5144420000000,51,44420,"Staunton-Stuarts Draft, VA MSA",2022,8,64193,62523,1670,2.6
MT5147260000000,51,47260,"Virginia Beach-Chesapeake-Norfolk, VA-NC MSA",2022,8,858345,831466,26879,3.1
MT5149020000000,51,49020,"Winchester, VA-WV MSA",2022,8,74799,72814,1985,2.7
MT5313380000000,53,13380,"Bellingham, WA MSA",2022,8,114316,109610,4706,4.1
MT5314740000000,53,14740,"Bremerton-Silverdale-Port Orchard, WA MSA",2022,8,121505,116582,4923,4.1
MT5328420000000,53,28420,"Kennewick-Richland, WA MSA",2022,8,145341,138417,6924,4.8
MT5331020000000,53,31020,"Longview-Kelso, WA MSA",2022,8,47637,45299,2338,4.9
MT5334580000000,53,34580,"Mount Vernon-Anacortes, WA MSA",2022,8,57838,55101,2737,4.7
MT5336500000000,53,36500,"Olympia-Lacey-Tumwater, WA MSA",2022,8,139877,134064,5813,4.2
MT5342660000000,53,42660,"Seattle-Tacoma-Bellevue, WA MSA",2022,8,2252485,2166100,86385,3.8
MT5344060000000,53,44060,"Spokane-Spokane Valley, WA MSA",2022,8,281016,268919,12097,4.3
MT5347460000000,53,47460,"Walla Walla, WA MSA",2022,8,29612,28432,1180,4
MT5348300000000,53,48300,"Wenatchee-East Wenatchee, WA MSA",2022,8,62467,59662,2805,4.5
MT5349420000000,53,49420,"Yakima, WA MSA",2022,8,127959,120663,7296,5.7
MT5413220000000,54,13220,"Beckley, WV MSA",2022,8,45423,43537,1886,4.2
MT5416620000000,54,16620,"Charleston, WV MSA",2022,8,89439,85938,3501,3.9
MT5426580000000,54,26580,"Huntington-Ashland, WV-KY-OH MSA",2022,8,154394,147586,6808,4.4
MT5434060000000,54,34060,"Morgantown, WV MSA",2022,8,70649,68064,2585,3.7
MT5437620000000,54,37620,"Parkersburg-Vienna, WV MSA",2022,8,39098,37485,1613,4.1
MT5448540000000,54,48540,"Wheeling, WV-OH MSA",2022,8,58865,55934,2931,5
MT5511540000000,55,11540,"Appleton, WI MSA",2022,8,135181,131906,3275,2.4
MT5520740000000,55,20740,"Eau Claire, WI MSA",2022,8,93653,91086,2567,2.7
MT5522540000000,55,22540,"Fond du Lac, WI MSA",2022,8,55905,54499,1406,2.5
MT5524580000000,55,24580,"Green Bay, WI MSA",2022,8,175278,170704,4574,2.6
MT5527500000000,55,27500,"Janesville-Beloit, WI MSA",2022,8,84055,81167,2888,3.4
MT5528450000000,55,28450,"Kenosha, WI MSA",2022,8,92517,89739,2778,3
MT5529100000000,55,29100,"La Crosse-Onalaska, WI-MN MSA",2022,8,88271,86010,2261,2.6
MT5531540000000,55,31540,"Madison, WI MSA",2022,8,395581,386758,8823,2.2
MT5533340000000,55,33340,"Milwaukee-Waukesha, WI MSA",2022,8,808381,784494,23887,3
MT5536780000000,55,36780,"Oshkosh-Neenah, WI MSA",2022,8,91903,89626,2277,2.5
MT5539540000000,55,39540,"Racine-Mount Pleasant, WI MSA",2022,8,99912,96577,3335,3.3
MT5543100000000,55,43100,"Sheboygan, WI MSA",2022,8,61742,60253,1489,2.4
MT5548140000000,55,48140,"Wausau, WI MSA",2022,8,74238,72418,1820,2.5
MT5616220000000,56,16220,"Casper, WY MSA",2022,8,41473,39978,1495,3.6
MT5616940000000,56,16940,"Cheyenne, WY MSA",2022,8,48350,46653,1697,3.5
MT7210380000000,72,10380,"Aguadilla, PR MSA",2022,8,85509,79245,6264,7.3
MT7211640000000,72,11640,"Arecibo, PR MSA",2022,8,64387,59761,4626,7.2
MT7225020000000,72,25020,"Guayama, PR MSA",2022,8,18207,16611,1596,8.8
MT7232420000000,72,32420,"Mayaguez, PR MSA",2022,8,64220,59521,4699,7.3
MT7238660000000,72,38660,"Ponce, PR MSA",2022,8,85638,78291,7347,8.6
MT7241980000000,72,41980,"San Juan-Bayamon-Caguas, PR MSA",2022,8,783464,743681,39783,5.1
MT0111500000000,1,11500,"Anniston-Oxford, AL MSA",2022,9,49115,47817,1298,2.6
MT0112220000000,1,12220,"Auburn-Opelika, AL MSA",2022,9,91916,89801,2115,2.3
MT0113820000000,1,13820,"Birmingham, AL MSA",2022,9,556443,543860,12583,2.3
MT0119300000000,1,19300,"Daphne-Fairhope-Foley, AL MSA",2022,9,110792,108389,2403,2.2
MT0119460000000,1,19460,"Decatur, AL MSA",2022,9,72764,71178,1586,2.2
MT0120020000000,1,20020,"Dothan, AL MSA",2022,9,66281,64665,1616,2.4
MT0122520000000,1,22520,"Florence-Muscle Shoals, AL MSA",2022,9,66940,65138,1802,2.7
MT0123460000000,1,23460,"Gadsden, AL MSA",2022,9,40698,39587,1111,2.7
MT0126620000000,1,26620,"Huntsville, AL MSA",2022,9,259484,254241,5243,2
MT0133660000000,1,33660,"Mobile, AL MSA",2022,9,182216,176408,5808,3.2
MT0133860000000,1,33860,"Montgomery, AL MSA",2022,9,171634,166983,4651,2.7
MT0146220000000,1,46220,"Tuscaloosa, AL MSA",2022,9,121802,118502,3300,2.7
MT0211260000000,2,11260,"Anchorage, AK MSA",2022,9,197563,190529,7034,3.6
MT0221820000000,2,21820,"Fairbanks-College, AK MSA",2022,9,44593,43023,1570,3.5
MT0422380000000,4,22380,"Flagstaff, AZ MSA",2022,9,72401,69207,3194,4.4
MT0429420000000,4,29420,"Lake Havasu City-Kingman, AZ MSA",2022,9,86008,81849,4159,4.8
MT0438060000000,4,38060,"Phoenix-Mesa-Chandler, AZ MSA",2022,9,2602213,2514589,87624,3.4
MT0439150000000,4,39150,"Prescott Valley-Prescott, AZ MSA",2022,9,104227,100333,3894,3.7
MT0443420000000,4,43420,"Sierra Vista-Douglas, AZ MSA",2022,9,47367,45209,2158,4.6
MT0446060000000,4,46060,"Tucson, AZ MSA",2022,9,488914,470177,18737,3.8
MT0449740000000,4,49740,"Yuma, AZ MSA",2022,9,97696,85975,11721,12
MT0522220000000,5,22220,"Fayetteville-Springdale-Rogers, AR MSA",2022,9,291425,284599,6826,2.3
MT0522900000000,5,22900,"Fort Smith, AR-OK MSA",2022,9,99912,96899,3013,3
MT0526300000000,5,26300,"Hot Springs, AR MSA",2022,9,43677,42130,1547,3.5
MT0527860000000,5,27860,"Jonesboro, AR MSA",2022,9,64651,62804,1847,2.9
MT0530780000000,5,30780,"Little Rock-North Little Rock-Conway, AR MSA",2022,9,363860,352888,10972,3
MT0612540000000,6,12540,"Bakersfield-Delano, CA MSA",2022,9,393707,365863,27844,7.1
MT0617020000000,6,17020,"Chico, CA MSA",2022,9,89878,85772,4106,4.6
MT0620940000000,6,20940,"El Centro, CA MSA",2022,9,68760,58068,10692,15.5
MT0623420000000,6,23420,"Fresno, CA MSA",2022,9,513240,479823,33417,6.5
MT0625260000000,6,25260,"Hanford-Corcoran, CA MSA",2022,9,54989,50893,4096,7.4
MT0631080000000,6,31080,"Los Angeles-Long Beach-Anaheim, CA MSA",2022,9,6600577,6327530,273047,4.1
MT0632900000000,6,32900,"Merced, CA MSA",2022,9,115819,106659,9160,7.9
MT0633700000000,6,33700,"Modesto, CA MSA",2022,9,245269,232079,13190,5.4
MT0634900000000,6,34900,"Napa, CA MSA",2022,9,71303,69121,2182,3.1
MT0637100000000,6,37100,"Oxnard-Thousand Oaks-Ventura, CA MSA",2022,9,412586,398063,14523,3.5
MT0639820000000,6,39820,"Redding, CA MSA",2022,9,76168,72764,3404,4.5
MT0640140000000,6,40140,"Riverside-San Bernardino-Ontario, CA MSA",2022,9,2140086,2055356,84730,4
MT0640900000000,6,40900,"Sacramento-Roseville-Folsom, CA MSA",2022,9,1141737,1100442,41295,3.6
MT0641500000000,6,41500,"Salinas, CA MSA",2022,9,215923,202380,13543,6.3
MT0641740000000,6,41740,"San Diego-Chula Vista-Carlsbad, CA MSA",2022,9,1612569,1561492,51077,3.2
MT0641860000000,6,41860,"San Francisco-Oakland-Fremont, CA MSA",2022,9,2500427,2430645,69782,2.8
MT0641940000000,6,41940,"San Jose-Sunnyvale-Santa Clara, CA MSA",2022,9,1046836,1018990,27846,2.7
MT0642020000000,6,42020,"San Luis Obispo-Paso Robles, CA MSA",2022,9,130917,126921,3996,3.1
MT0642100000000,6,42100,"Santa Cruz-Watsonville, CA MSA",2022,9,134088,127729,6359,4.7
MT0642200000000,6,42200,"Santa Maria-Santa Barbara, CA MSA",2022,9,217870,210192,7678,3.5
MT0642220000000,6,42220,"Santa Rosa-Petaluma, CA MSA",2022,9,244398,236987,7411,3
MT0644700000000,6,44700,"Stockton-Lodi, CA MSA",2022,9,357264,339111,18153,5.1
MT0646700000000,6,46700,"Vallejo, CA MSA",2022,9,209573,201418,8155,3.9
MT0647300000000,6,47300,"Visalia, CA MSA",2022,9,211248,193370,17878,8.5
MT0649700000000,6,49700,"Yuba City, CA MSA",2022,9,78151,73125,5026,6.4
MT0814500000000,8,14500,"Boulder, CO MSA",2022,9,191927,187104,4823,2.5
MT0817820000000,8,17820,"Colorado Springs, CO MSA",2022,9,381473,369862,11611,3
MT0819740000000,8,19740,"Denver-Aurora-Centennial, CO MSA",2022,9,1739010,1690488,48522,2.8
MT0822660000000,8,22660,"Fort Collins-Loveland, CO MSA",2022,9,202001,196492,5509,2.7
MT0824300000000,8,24300,"Grand Junction, CO MSA",2022,9,77937,75366,2571,3.3
MT0824540000000,8,24540,"Greeley, CO MSA",2022,9,170107,164828,5279,3.1
MT0839380000000,8,39380,"Pueblo, CO MSA",2022,9,73845,70692,3153,4.3
MT0914860000000,9,14860,"Bridgeport-Stamford-Danbury, CT MSA",2022,9,505879,488137,17742,3.5
MT0925540000000,9,25540,"Hartford-West Hartford-East Hartford, CT MSA",2022,9,604201,581469,22732,3.8
MT0935300000000,9,35300,"New Haven, CT MSA",2022,9,309776,298268,11508,3.7
MT0935980000000,9,35980,"Norwich-New London-Willimantic, CT MSA",2022,9,139540,134079,5461,3.9
MT0947930000000,9,47930,"Waterbury-Shelton, CT MSA",2022,9,238371,228348,10023,4.2
MT1020100000000,10,20100,"Dover, DE MSA",2022,9,84374,80547,3827,4.5
MT1147900000000,11,47900,"Washington-Arlington-Alexandria, DC-VA-MD-WV MSA",2022,9,3458423,3364159,94264,2.7
MT1215980000000,12,15980,"Cape Coral-Fort Myers, FL MSA",2022,9,365613,355267,10346,2.8
MT1218880000000,12,18880,"Crestview-Fort Walton Beach-Destin, FL MSA",2022,9,139440,136031,3409,2.4
MT1219660000000,12,19660,"Deltona-Daytona Beach-Ormond Beach, FL MSA",2022,9,310499,300447,10052,3.2
MT1223540000000,12,23540,"Gainesville, FL MSA",2022,9,165880,160975,4905,3
MT1226140000000,12,26140,"Homosassa Springs, FL MSA",2022,9,52603,50517,2086,4
MT1227260000000,12,27260,"Jacksonville, FL MSA",2022,9,830674,807094,23580,2.8
MT1229460000000,12,29460,"Lakeland-Winter Haven, FL MSA",2022,9,347028,335474,11554,3.3
MT1233100000000,12,33100,"Miami-Fort Lauderdale-West Palm Beach, FL MSA",2022,9,3194631,3110655,83976,2.6
MT1234940000000,12,34940,"Naples-Marco Island, FL MSA",2022,9,177643,172986,4657,2.6
MT1235840000000,12,35840,"North Port-Bradenton-Sarasota, FL MSA",2022,9,377004,366167,10837,2.9
MT1236100000000,12,36100,"Ocala, FL MSA",2022,9,152275,147087,5188,3.4
MT1236740000000,12,36740,"Orlando-Kissimmee-Sanford, FL MSA",2022,9,1468299,1427830,40469,2.8
MT1237340000000,12,37340,"Palm Bay-Melbourne-Titusville, FL MSA",2022,9,294540,286172,8368,2.8
MT1237460000000,12,37460,"Panama City-Panama City Beach, FL MSA",2022,9,98082,95379,2703,2.8
MT1237860000000,12,37860,"Pensacola-Ferry Pass-Brent, FL MSA",2022,9,235362,228679,6683,2.8
MT1238940000000,12,38940,"Port St. Lucie, FL MSA",2022,9,231344,224131,7213,3.1
MT1239460000000,12,39460,"Punta Gorda, FL MSA",2022,9,73075,70681,2394,3.3
MT1242680000000,12,42680,"Sebastian-Vero Beach-West Vero Corridor, FL MSA",2022,9,66135,63937,2198,3.3
MT1242700000000,12,42700,"Sebring, FL MSA",2022,9,35630,34190,1440,4
MT1245220000000,12,45220,"Tallahassee, FL MSA",2022,9,201394,195517,5877,2.9
MT1245300000000,12,45300,"Tampa-St. Petersburg-Clearwater, FL MSA",2022,9,1650160,1604964,45196,2.7
MT1248680000000,12,48680,"Wildwood-The Villages, FL MSA",2022,9,32188,30631,1557,4.8
MT1310500000000,13,10500,"Albany, GA MSA",2022,9,63204,60659,2545,4
MT1312020000000,13,12020,"Athens-Clarke County, GA MSA",2022,9,102768,99616,3152,3.1
MT1312060000000,13,12060,"Atlanta-Sandy Springs-Roswell, GA MSA",2022,9,3198962,3101648,97314,3
MT1312260000000,13,12260,"Augusta-Richmond County, GA-SC MSA",2022,9,263587,253931,9656,3.7
MT1315260000000,13,15260,"Brunswick-St. Simons, GA MSA",2022,9,52889,51280,1609,3
MT1317980000000,13,17980,"Columbus, GA-AL MSA",2022,9,128640,123822,4818,3.7
MT1319140000000,13,19140,"Dalton, GA MSA",2022,9,66462,63972,2490,3.7
MT1323580000000,13,23580,"Gainesville, GA MSA",2022,9,104104,101316,2788,2.7
MT1325980000000,13,25980,"Hinesville, GA MSA",2022,9,30901,29698,1203,3.9
MT1331420000000,13,31420,"Macon-Bibb County, GA MSA",2022,9,96844,93170,3674,3.8
MT1340660000000,13,40660,"Rome, GA MSA",2022,9,45269,43808,1461,3.2
MT1342340000000,13,42340,"Savannah, GA MSA",2022,9,203065,196940,6125,3
MT1346660000000,13,46660,"Valdosta, GA MSA",2022,9,60848,58693,2155,3.5
MT1347580000000,13,47580,"Warner Robins, GA MSA",2022,9,87734,84811,2923,3.3
MT1527980000000,15,27980,"Kahului-Wailuku, HI MSA",2022,9,83580,80842,2738,3.3
MT1546520000000,15,46520,"Urban Honolulu, HI MSA",2022,9,468236,452748,15488,3.3
MT1614260000000,16,14260,"Boise City, ID MSA",2022,9,426648,415165,11483,2.7
MT1617660000000,16,17660,"Coeur d'Alene, ID MSA",2022,9,86525,83432,3093,3.6
MT1626820000000,16,26820,"Idaho Falls, ID MSA",2022,9,80267,78218,2049,2.6
MT1630300000000,16,30300,"Lewiston, ID-WA MSA",2022,9,30450,29485,965,3.2
MT1638540000000,16,38540,"Pocatello, ID MSA",2022,9,39513,38187,1326,3.4
MT1646300000000,16,46300,"Twin Falls, ID MSA",2022,9,58179,56518,1661,2.9
MT1714010000000,17,14010,"Bloomington, IL MSA",2022,9,91591,88469,3122,3.4
MT1716580000000,17,16580,"Champaign-Urbana, IL MSA",2022,9,122157,117536,4621,3.8
MT1716980000000,17,16980,"Chicago-Naperville-Elgin, IL-IN MSA",2022,9,4867493,4641053,226440,4.7
MT1719340000000,17,19340,"Davenport-Moline-Rock Island, IA-IL MSA",2022,9,189055,181750,7305,3.9
MT1719500000000,17,19500,"Decatur, IL MSA",2022,9,44978,42544,2434,5.4
MT1728100000000,17,28100,"Kankakee, IL MSA",2022,9,50148,47367,2781,5.5
MT1737900000000,17,37900,"Peoria, IL MSA",2022,9,172190,164636,7554,4.4
MT1740420000000,17,40420,"Rockford, IL MSA",2022,9,158593,149871,8722,5.5
MT1744100000000,17,44100,"Springfield, IL MSA",2022,9,101838,97678,4160,4.1
MT1814020000000,18,14020,"Bloomington, IN MSA",2022,9,82836,80521,2315,2.8
MT1818020000000,18,18020,"Columbus, IN MSA",2022,9,39348,38226,1122,2.9
MT1821140000000,18,21140,"Elkhart-Goshen, IN MSA",2022,9,106420,103076,3344,3.1
MT1821780000000,18,21780,"Evansville, IN MSA",2022,9,134428,130397,4031,3
MT1823060000000,18,23060,"Fort Wayne, IN MSA",2022,9,228204,221795,6409,2.8
MT1826900000000,18,26900,"Indianapolis-Carmel-Greenwood, IN MSA",2022,9,1102048,1070191,31857,2.9
MT1829020000000,18,29020,"Kokomo, IN MSA",2022,9,35508,33853,1655,4.7
MT1829200000000,18,29200,"Lafayette-West Lafayette, IN MSA",2022,9,117333,114045,3288,2.8
MT1833140000000,18,33140,"Michigan City-La Porte, IN MSA",2022,9,50640,48785,1855,3.7
MT1834620000000,18,34620,"Muncie, IN MSA",2022,9,51499,49640,1859,3.6
MT1843780000000,18,43780,"South Bend-Mishawaka, IN-MI MSA",2022,9,154556,148718,5838,3.8
MT1845460000000,18,45460,"Terre Haute, IN MSA",2022,9,76501,73786,2715,3.5
MT1911180000000,19,11180,"Ames, IA MSA",2022,9,69381,67718,1663,2.4
MT1916300000000,19,16300,"Cedar Rapids, IA MSA",2022,9,149887,145164,4723,3.2
MT1919780000000,19,19780,"Des Moines-West Des Moines, IA MSA",2022,9,401023,390062,10961,2.7
MT1920220000000,19,20220,"Dubuque, IA MSA",2022,9,54086,52302,1784,3.3
MT1926980000000,19,26980,"Iowa City, IA MSA",2022,9,99076,96640,2436,2.5
MT1943580000000,19,43580,"Sioux City, IA-NE-SD MSA",2022,9,76693,74428,2265,3
MT1947940000000,19,47940,"Waterloo-Cedar Falls, IA MSA",2022,9,89364,86767,2597,2.9
MT2029940000000,20,29940,"Lawrence, KS MSA",2022,9,68948,67137,1811,2.6
MT2031740000000,20,31740,"Manhattan, KS MSA",2022,9,62949,61153,1796,2.9
MT2045820000000,20,45820,"Topeka, KS MSA",2022,9,116882,113362,3520,3
MT2048620000000,20,48620,"Wichita, KS MSA",2022,9,326269,316128,10141,3.1
MT2114540000000,21,14540,"Bowling Green, KY MSA",2022,9,89080,85734,3346,3.8
MT2121060000000,21,21060,"Elizabethtown, KY MSA",2022,9,53312,50953,2359,4.4
MT2130460000000,21,30460,"Lexington-Fayette, KY MSA",2022,9,268681,259611,9070,3.4
MT2131140000000,21,31140,"Louisville/Jefferson County, KY-IN MSA",2022,9,684646,660575,24071,3.5
MT2136980000000,21,36980,"Owensboro, KY MSA",2022,9,51023,48811,2212,4.3
MT2137140000000,21,37140,"Paducah, KY-IL MSA",2022,9,45203,43172,2031,4.5
MT2210780000000,22,10780,"Alexandria, LA MSA",2022,9,65061,63021,2040,3.1
MT2212940000000,22,12940,"Baton Rouge, LA MSA",2022,9,418351,404132,14219,3.4
MT2225220000000,22,25220,"Hammond, LA MSA",2022,9,59114,56771,2343,4
MT2226380000000,22,26380,"Houma-Bayou Cane-Thibodaux, LA MSA",2022,9,86870,84001,2869,3.3
MT2229180000000,22,29180,"Lafayette, LA MSA",2022,9,195848,189872,5976,3.1
MT2229340000000,22,29340,"Lake Charles, LA MSA",2022,9,98659,95055,3604,3.7
MT2233740000000,22,33740,"Monroe, LA MSA",2022,9,96189,92430,3759,3.9
MT2235380000000,22,35380,"New Orleans-Metairie, LA MSA",2022,9,467857,451091,16766,3.6
MT2243340000000,22,43340,"Shreveport-Bossier City, LA MSA",2022,9,168179,162169,6010,3.6
MT2243640000000,22,43640,"Slidell-Mandeville-Covington, LA MSA",2022,9,127042,123491,3551,2.8
MT2312620000000,23,12620,"Bangor, ME MSA",2022,9,72994,70868,2126,2.9
MT2330340000000,23,30340,"Lewiston-Auburn, ME MSA",2022,9,53585,52145,1440,2.7
MT2338860000000,23,38860,"Portland-South Portland, ME MSA",2022,9,301237,294596,6641,2.2
MT2412580000000,24,12580,"Baltimore-Columbia-Towson, MD MSA",2022,9,1459155,1417193,41962,2.9
MT2425180000000,24,25180,"Hagerstown-Martinsburg, MD-WV MSA",2022,9,141689,137388,4301,3
MT2430500000000,24,30500,"Lexington Park, MD MSA",2022,9,104571,101708,2863,2.7
MT2441540000000,24,41540,"Salisbury, MD MSA",2022,9,61802,59700,2102,3.4
MT2511200000000,25,11200,"Amherst Town-Northampton, MA MSA",2022,9,85007,82088,2919,3.4
MT2512700000000,25,12700,"Barnstable Town, MA MSA",2022,9,113432,108133,5299,4.7
MT2514460000000,25,14460,"Boston-Cambridge-Newton, MA-NH MSA",2022,9,2733040,2644757,88283,3.2
MT2538340000000,25,38340,"Pittsfield, MA MSA",2022,9,63325,60680,2645,4.2
MT2544140000000,25,44140,"Springfield, MA MSA",2022,9,221979,211438,10541,4.7
MT2549340000000,25,49340,"Worcester, MA MSA",2022,9,451764,434766,16998,3.8
MT2611460000000,26,11460,"Ann Arbor, MI MSA",2022,9,199884,193188,6696,3.3
MT2612980000000,26,12980,"Battle Creek, MI MSA",2022,9,60048,57241,2807,4.7
MT2613020000000,26,13020,"Bay City, MI MSA",2022,9,48570,46035,2535,5.2
MT2619820000000,26,19820,"Detroit-Warren-Dearborn, MI MSA",2022,9,2108949,2034968,73981,3.5
MT2622420000000,26,22420,"Flint, MI MSA",2022,9,182302,172728,9574,5.3
MT2624340000000,26,24340,"Grand Rapids-Wyoming-Kentwood, MI MSA",2022,9,604883,583500,21383,3.5
MT2627100000000,26,27100,"Jackson, MI MSA",2022,9,73213,69988,3225,4.4
MT2628020000000,26,28020,"Kalamazoo-Portage, MI MSA",2022,9,134592,129576,5016,3.7
MT2629620000000,26,29620,"Lansing-East Lansing, MI MSA",2022,9,241975,231884,10091,4.2
MT2633220000000,26,33220,"Midland, MI MSA",2022,9,40319,38589,1730,4.3
MT2633780000000,26,33780,"Monroe, MI MSA",2022,9,74491,71046,3445,4.6
MT2634740000000,26,34740,"Muskegon-Norton Shores, MI MSA",2022,9,81588,77733,3855,4.7
MT2635660000000,26,35660,"Niles, MI MSA",2022,9,73625,70405,3220,4.4
MT2640980000000,26,40980,"Saginaw, MI MSA",2022,9,82955,78481,4474,5.4
MT2645900000000,26,45900,"Traverse City, MI MSA",2022,9,78662,75331,3331,4.2
MT2720260000000,27,20260,"Duluth, MN-WI MSA",2022,9,138630,133968,4662,3.4
MT2731860000000,27,31860,"Mankato, MN MSA",2022,9,58975,57765,1210,2.1
MT2733460000000,27,33460,"Minneapolis-St. Paul-Bloomington, MN-WI MSA",2022,9,2037612,1990153,47459,2.3
MT2740340000000,27,40340,"Rochester, MN MSA",2022,9,123994,121265,2729,2.2
MT2741060000000,27,41060,"St. Cloud, MN MSA",2022,9,108257,105357,2900,2.7
MT2825060000000,28,25060,"Gulfport-Biloxi, MS MSA",2022,9,182833,176273,6560,3.6
MT2825620000000,28,25620,"Hattiesburg, MS MSA",2022,9,70252,67916,2336,3.3
MT2827140000000,28,27140,"Jackson, MS MSA",2022,9,276866,267522,9344,3.4
MT2916020000000,29,16020,"Cape Girardeau, MO-IL MSA",2022,9,47944,46719,1225,2.6
MT2917860000000,29,17860,"Columbia, MO MSA",2022,9,113375,110935,2440,2.2
MT2927620000000,29,27620,"Jefferson City, MO MSA",2022,9,73240,71562,1678,2.3
MT2927900000000,29,27900,"Joplin, MO-KS MSA",2022,9,95361,92973,2388,2.5
MT2928140000000,29,28140,"Kansas City, MO-KS MSA",2022,9,1162175,1130876,31299,2.7
MT2941140000000,29,41140,"St. Joseph, MO-KS MSA",2022,9,53767,52256,1511,2.8
MT2941180000000,29,41180,"St. Louis, MO-IL MSA",2022,9,1447337,1406042,41295,2.9
MT2944180000000,29,44180,"Springfield, MO MSA",2022,9,235537,229996,5541,2.4
MT3013740000000,30,13740,"Billings, MT MSA",2022,9,99057,96709,2348,2.4
MT3014580000000,30,14580,"Bozeman, MT MSA",2022,9,75269,73778,1491,2
MT3024500000000,30,24500,"Great Falls, MT MSA",2022,9,40070,39018,1052,2.6
MT3025740000000,30,25740,"Helena, MT MSA",2022,9,46815,45637,1178,2.5
MT3033540000000,30,33540,"Missoula, MT MSA",2022,9,72522,70722,1800,2.5
MT3124260000000,31,24260,"Grand Island, NE MSA",2022,9,41569,40660,909,2.2
MT3130700000000,31,30700,"Lincoln, NE MSA",2022,9,189699,185655,4044,2.1
MT3136540000000,31,36540,"Omaha, NE-IA MSA",2022,9,516504,503545,12959,2.5
MT3216180000000,32,16180,"Carson City, NV MSA",2022,9,28188,26919,1269,4.5
MT3229820000000,32,29820,"Las Vegas-Henderson-North Las Vegas, NV MSA",2022,9,1163184,1099187,63997,5.5
MT3239900000000,32,39900,"Reno, NV MSA",2022,9,291258,278468,12790,4.4
MT3331700000000,33,31700,"Manchester-Nashua, NH MSA",2022,9,240197,233907,6290,2.6
MT3412100000000,34,12100,"Atlantic City-Hammonton, NJ MSA",2022,9,178816,169895,8921,5
MT3445940000000,34,45940,"Trenton-Princeton, NJ MSA",2022,9,196661,190444,6217,3.2
MT3447220000000,34,47220,"Vineland, NJ MSA",2022,9,65346,62024,3322,5.1
MT3510740000000,35,10740,"Albuquerque, NM MSA",2022,9,448071,434064,14007,3.1
MT3522140000000,35,22140,"Farmington, NM MSA",2022,9,48009,46061,1948,4.1
MT3529740000000,35,29740,"Las Cruces, NM MSA",2022,9,97302,93281,4021,4.1
MT3542140000000,35,42140,"Santa Fe, NM MSA",2022,9,72403,70128,2275,3.1
MT3610580000000,36,10580,"Albany-Schenectady-Troy, NY MSA",2022,9,452337,438480,13857,3.1
MT3613780000000,36,13780,"Binghamton, NY MSA",2022,9,105622,101692,3930,3.7
MT3615380000000,36,15380,"Buffalo-Cheektowaga, NY MSA",2022,9,554015,534278,19737,3.6
MT3621300000000,36,21300,"Elmira, NY MSA",2022,9,35500,34209,1291,3.6
MT3624020000000,36,24020,"Glens Falls, NY MSA",2022,9,59240,57210,2030,3.4
MT3627060000000,36,27060,"Ithaca, NY MSA",2022,9,48051,46629,1422,3
MT3628740000000,36,28740,"Kingston, NY MSA",2022,9,85688,82938,2750,3.2
MT3628880000000,36,28880,"Kiryas Joel-Poughkeepsie-Newburgh, NY MSA",2022,9,333388,322871,10517,3.2
MT3635620000000,36,35620,"New York-Newark-Jersey City, NY-NJ MSA",2022,9,9938591,9555149,383442,3.9
MT3640380000000,36,40380,"Rochester, NY MSA",2022,9,509216,492011,17205,3.4
MT3645060000000,36,45060,"Syracuse, NY MSA",2022,9,310335,299593,10742,3.5
MT3646540000000,36,46540,"Utica-Rome, NY MSA",2022,9,127546,122826,4720,3.7
MT3648060000000,36,48060,"Watertown-Fort Drum, NY MSA",2022,9,44751,42849,1902,4.3
MT3711700000000,37,11700,"Asheville, NC MSA",2022,9,207789,201169,6620,3.2
MT3715500000000,37,15500,"Burlington, NC MSA",2022,9,83425,80175,3250,3.9
MT3716740000000,37,16740,"Charlotte-Concord-Gastonia, NC-SC MSA",2022,9,1442174,1390680,51494,3.6
MT3720500000000,37,20500,"Durham-Chapel Hill, NC MSA",2022,9,316088,305619,10469,3.3
MT3722180000000,37,22180,"Fayetteville, NC MSA",2022,9,152999,145486,7513,4.9
MT3724140000000,37,24140,"Goldsboro, NC MSA",2022,9,49638,47659,1979,4
MT3724660000000,37,24660,"Greensboro-High Point, NC MSA",2022,9,372980,357682,15298,4.1
MT3724780000000,37,24780,"Greenville, NC MSA",2022,9,82390,78900,3490,4.2
MT3725860000000,37,25860,"Hickory-Lenoir-Morganton, NC MSA",2022,9,172740,166522,6218,3.6
MT3727340000000,37,27340,"Jacksonville, NC MSA",2022,9,72803,69881,2922,4
MT3738240000000,37,38240,"Pinehurst-Southern Pines, NC MSA",2022,9,43485,41878,1607,3.7
MT3739580000000,37,39580,"Raleigh-Cary, NC MSA",2022,9,813396,788016,25380,3.1
MT3740580000000,37,40580,"Rocky Mount, NC MSA",2022,9,63648,60161,3487,5.5
MT3748900000000,37,48900,"Wilmington, NC MSA",2022,9,216242,207990,8252,3.8
MT3749180000000,37,49180,"Winston-Salem, NC MSA",2022,9,325375,312983,12392,3.8
MT3813900000000,38,13900,"Bismarck, ND MSA",2022,9,72301,70803,1498,2.1
MT3822020000000,38,22020,"Fargo, ND-MN MSA",2022,9,149953,147207,2746,1.8
MT3824220000000,38,24220,"Grand Forks, ND-MN MSA",2022,9,54630,53456,1174,2.1
MT3833500000000,38,33500,"Minot, ND MSA",2022,9,39423,38565,858,2.2
MT3910420000000,39,10420,"Akron, OH MSA",2022,9,354670,340225,14445,4.1
MT3915940000000,39,15940,"Canton-Massillon, OH MSA",2022,9,188920,180670,8250,4.4
MT3917140000000,39,17140,"Cincinnati, OH-KY-IN MSA",2022,9,1147984,1106462,41522,3.6
MT3917410000000,39,17410,"Cleveland, OH MSA",2022,9,1076097,1028386,47711,4.4
MT3918140000000,39,18140,"Columbus, OH MSA",2022,9,1115087,1075293,39794,3.6
MT3919430000000,39,19430,"Dayton-Kettering-Beavercreek, OH MSA",2022,9,382542,367091,15451,4
MT3930620000000,39,30620,"Lima, OH MSA",2022,9,47077,45089,1988,4.2
MT3931900000000,39,31900,"Mansfield, OH MSA",2022,9,52010,49576,2434,4.7
MT3941780000000,39,41780,"Sandusky, OH MSA",2022,9,56411,53482,2929,5.2
MT3944220000000,39,44220,"Springfield, OH MSA",2022,9,61071,58469,2602,4.3
MT3945780000000,39,45780,"Toledo, OH MSA",2022,9,289793,276977,12816,4.4
MT3948260000000,39,48260,"Weirton-Steubenville, WV-OH MSA",2022,9,52491,49962,2529,4.8
MT3949660000000,39,49660,"Youngstown-Warren, OH MSA",2022,9,189014,179942,9072,4.8
MT4021420000000,40,21420,"Enid, OK MSA",2022,9,28214,27404,810,2.9
MT4030020000000,40,30020,"Lawton, OK MSA",2022,9,51072,49190,1882,3.7
MT4036420000000,40,36420,"Oklahoma City, OK MSA",2022,9,734618,713558,21060,2.9
MT4046140000000,40,46140,"Tulsa, OK MSA",2022,9,500248,484155,16093,3.2
MT4110540000000,41,10540,"Albany, OR MSA",2022,9,61079,58289,2790,4.6
MT4113460000000,41,13460,"Bend, OR MSA",2022,9,126294,120735,5559,4.4
MT4118700000000,41,18700,"Corvallis, OR MSA",2022,9,48611,46834,1777,3.7
MT4121660000000,41,21660,"Eugene-Springfield, OR MSA",2022,9,185620,177317,8303,4.5
MT4124420000000,41,24420,"Grants Pass, OR MSA",2022,9,35002,32968,2034,5.8
MT4132780000000,41,32780,"Medford, OR MSA",2022,9,104594,99529,5065,4.8
MT4138900000000,41,38900,"Portland-Vancouver-Hillsboro, OR-WA MSA",2022,9,1370360,1319597,50763,3.7
MT4141420000000,41,41420,"Salem, OR MSA",2022,9,214455,205479,8976,4.2
MT4210900000000,42,10900,"Allentown-Bethlehem-Easton, PA-NJ MSA",2022,9,445065,427026,18039,4.1
MT4211020000000,42,11020,"Altoona, PA MSA",2022,9,56720,54249,2471,4.4
MT4216540000000,42,16540,"Chambersburg, PA MSA",2022,9,76761,74056,2705,3.5
MT4221500000000,42,21500,"Erie, PA MSA",2022,9,125278,119464,5814,4.6
MT4223900000000,42,23900,"Gettysburg, PA MSA",2022,9,51911,50153,1758,3.4
MT4225420000000,42,25420,"Harrisburg-Carlisle, PA MSA",2022,9,307057,296315,10742,3.5
MT4227780000000,42,27780,"Johnstown, PA MSA",2022,9,56818,53967,2851,5
MT4229540000000,42,29540,"Lancaster, PA MSA",2022,9,288794,279391,9403,3.3
MT4230140000000,42,30140,"Lebanon, PA MSA",2022,9,71240,68702,2538,3.6
MT4237980000000,42,37980,"Philadelphia-Camden-Wilmington, PA-NJ-DE-MD MSA",2022,9,3237224,3114537,122687,3.8
MT4238300000000,42,38300,"Pittsburgh, PA MSA",2022,9,1220168,1168338,51830,4.2
MT4239740000000,42,39740,"Reading, PA MSA",2022,9,215746,207249,8497,3.9
MT4242540000000,42,42540,"Scranton--Wilkes-Barre, PA MSA",2022,9,276325,263294,13031,4.7
MT4244300000000,42,44300,"State College, PA MSA",2022,9,75945,73424,2521,3.3
MT4248700000000,42,48700,"Williamsport, PA MSA",2022,9,51989,49540,2449,4.7
MT4249620000000,42,49620,"York-Hanover, PA MSA",2022,9,236166,227746,8420,3.6
MT4439300000000,44,39300,"Providence-Warwick, RI-MA MSA",2022,9,872854,840557,32297,3.7
MT4516700000000,45,16700,"Charleston-North Charleston, SC MSA",2022,9,414097,402822,11275,2.7
MT4517900000000,45,17900,"Columbia, SC MSA",2022,9,398824,386843,11981,3
MT4522500000000,45,22500,"Florence, SC MSA",2022,9,89747,86687,3060,3.4
MT4524860000000,45,24860,"Greenville-Anderson-Greer, SC MSA",2022,9,456569,443650,12919,2.8
MT4525940000000,45,25940,"Hilton Head Island-Bluffton-Port Royal, SC MSA",2022,9,93429,90686,2743,2.9
MT4534820000000,45,34820,"Myrtle Beach-Conway-North Myrtle Beach, SC MSA",2022,9,161471,155330,6141,3.8
MT4543900000000,45,43900,"Spartanburg, SC MSA",2022,9,167655,162165,5490,3.3
MT4544940000000,45,44940,"Sumter, SC MSA",2022,9,41444,39884,1560,3.8
MT4639660000000,46,39660,"Rapid City, SD MSA",2022,9,77984,76445,1539,2
MT4643620000000,46,43620,"Sioux Falls, SD-MN MSA",2022,9,168566,165651,2915,1.7
MT4716860000000,47,16860,"Chattanooga, TN-GA MSA",2022,9,277690,268774,8916,3.2
MT4717300000000,47,17300,"Clarksville, TN-KY MSA",2022,9,134043,128821,5222,3.9
MT4717420000000,47,17420,"Cleveland, TN MSA",2022,9,56291,54244,2047,3.6
MT4727180000000,47,27180,"Jackson, TN MSA",2022,9,77820,74928,2892,3.7
MT4727740000000,47,27740,"Johnson City, TN MSA",2022,9,95728,92424,3304,3.5
MT4728700000000,47,28700,"Kingsport-Bristol, TN-VA MSA",2022,9,130731,126027,4704,3.6
MT4728940000000,47,28940,"Knoxville, TN MSA",2022,9,440468,426492,13976,3.2
MT4732820000000,47,32820,"Memphis, TN-MS-AR MSA",2022,9,630228,604654,25574,4.1
MT4734100000000,47,34100,"Morristown, TN MSA",2022,9,52864,50928,1936,3.7
MT4734980000000,47,34980,"Nashville-Davidson--Murfreesboro--Franklin, TN MSA",2022,9,1127393,1096257,31136,2.8
MT4810180000000,48,10180,"Abilene, TX MSA",2022,9,82483,79680,2803,3.4
MT4811100000000,48,11100,"Amarillo, TX MSA",2022,9,131697,127656,4041,3.1
MT4812420000000,48,12420,"Austin-Round Rock-San Marcos, TX MSA",2022,9,1407215,1365355,41860,3
MT4813140000000,48,13140,"Beaumont-Port Arthur, TX MSA",2022,9,171391,162146,9245,5.4
MT4815180000000,48,15180,"Brownsville-Harlingen, TX MSA",2022,9,181466,171568,9898,5.5
MT4817780000000,48,17780,"College Station-Bryan, TX MSA",2022,9,141551,136787,4764,3.4
MT4818580000000,48,18580,"Corpus Christi, TX MSA",2022,9,200438,191041,9397,4.7
MT4819100000000,48,19100,"Dallas-Fort Worth-Arlington, TX MSA",2022,9,4262040,4110911,151129,3.5
MT4820580000000,48,20580,"Eagle Pass, TX MSA",2022,9,23216,21424,1792,7.7
MT4821340000000,48,21340,"El Paso, TX MSA",2022,9,389241,373354,15887,4.1
MT4826420000000,48,26420,"Houston-Pasadena-The Woodlands, TX MSA",2022,9,3618128,3470794,147334,4.1
MT4828660000000,48,28660,"Killeen-Temple, TX MSA",2022,9,194160,185964,8196,4.2
MT4829700000000,48,29700,"Laredo, TX MSA",2022,9,112067,107625,4442,4
MT4830980000000,48,30980,"Longview, TX MSA",2022,9,126237,120918,5319,4.2
MT4831180000000,48,31180,"Lubbock, TX MSA",2022,9,175862,169709,6153,3.5
MT4832580000000,48,32580,"McAllen-Edinburg-Mission, TX MSA",2022,9,379313,355158,24155,6.4
MT4833260000000,48,33260,"Midland, TX MSA",2022,9,94855,91966,2889,3
MT4836220000000,48,36220,"Odessa, TX MSA",2022,9,80486,77587,2899,3.6
MT4841660000000,48,41660,"San Angelo, TX MSA",2022,9,59138,57313,1825,3.1
MT4841700000000,48,41700,"San Antonio-New Braunfels, TX MSA",2022,9,1264208,1218252,45956,3.6
MT4843300000000,48,43300,"Sherman-Denison, TX MSA",2022,9,67232,64758,2474,3.7
MT4845500000000,48,45500,"Texarkana, TX-AR MSA",2022,9,60276,57660,2616,4.3
MT4846340000000,48,46340,"Tyler, TX MSA",2022,9,112303,108183,4120,3.7
MT4847020000000,48,47020,"Victoria, TX MSA",2022,9,44203,42435,1768,4
MT4847380000000,48,47380,"Waco, TX MSA",2022,9,139573,134501,5072,3.6
MT4848660000000,48,48660,"Wichita Falls, TX MSA",2022,9,65407,63019,2388,3.7
MT4930860000000,49,30860,"Logan, UT-ID MSA",2022,9,78710,76987,1723,2.2
MT4936260000000,49,36260,"Ogden, UT MSA",2022,9,335625,327905,7720,2.3
MT4939340000000,49,39340,"Provo-Orem-Lehi, UT MSA",2022,9,355848,347595,8253,2.3
MT4941100000000,49,41100,"St. George, UT MSA",2022,9,86797,84440,2357,2.7
MT4941620000000,49,41620,"Salt Lake City-Murray, UT MSA",2022,9,710930,693662,17268,2.4
MT5015540000000,50,15540,"Burlington-South Burlington, VT MSA",2022,9,126639,124200,2439,1.9
MT5113980000000,51,13980,"Blacksburg-Christiansburg-Radford, VA MSA",2022,9,91019,88357,2662,2.9
MT5116820000000,51,16820,"Charlottesville, VA MSA",2022,9,115575,112577,2998,2.6
MT5125500000000,51,25500,"Harrisonburg, VA MSA",2022,9,71200,69241,1959,2.8
MT5131340000000,51,31340,"Lynchburg, VA MSA",2022,9,126646,122716,3930,3.1
MT5140060000000,51,40060,"Richmond, VA MSA",2022,9,705530,684938,20592,2.9
MT5140220000000,51,40220,"Roanoke, VA MSA",2022,9,155007,150581,4426,2.9
MT5144420000000,51,44420,"Staunton-Stuarts Draft, VA MSA",2022,9,64474,62804,1670,2.6
MT5147260000000,51,47260,"Virginia Beach-Chesapeake-Norfolk, VA-NC MSA",2022,9,860466,833424,27042,3.1
MT5149020000000,51,49020,"Winchester, VA-WV MSA",2022,9,75111,73091,2020,2.7
MT5313380000000,53,13380,"Bellingham, WA MSA",2022,9,114405,109686,4719,4.1
MT5314740000000,53,14740,"Bremerton-Silverdale-Port Orchard, WA MSA",2022,9,121554,116618,4936,4.1
MT5328420000000,53,28420,"Kennewick-Richland, WA MSA",2022,9,145403,138473,6930,4.8
MT5331020000000,53,31020,"Longview-Kelso, WA MSA",2022,9,47628,45274,2354,4.9
MT5334580000000,53,34580,"Mount Vernon-Anacortes, WA MSA",2022,9,57753,55037,2716,4.7
MT5336500000000,53,36500,"Olympia-Lacey-Tumwater, WA MSA",2022,9,140052,134217,5835,4.2
MT5342660000000,53,42660,"Seattle-Tacoma-Bellevue, WA MSA",2022,9,2255814,2167238,88576,3.9
MT5344060000000,53,44060,"Spokane-Spokane Valley, WA MSA",2022,9,281068,268831,12237,4.4
MT5347460000000,53,47460,"Walla Walla, WA MSA",2022,9,29618,28450,1168,3.9
MT5348300000000,53,48300,"Wenatchee-East Wenatchee, WA MSA",2022,9,62514,59691,2823,4.5
MT5349420000000,53,49420,"Yakima, WA MSA",2022,9,128085,120641,7444,5.8
MT5413220000000,54,13220,"Beckley, WV MSA",2022,9,45398,43553,1845,4.1
MT5416620000000,54,16620,"Charleston, WV MSA",2022,9,89385,85929,3456,3.9
MT5426580000000,54,26580,"Huntington-Ashland, WV-KY-OH MSA",2022,9,154437,147603,6834,4.4
MT5434060000000,54,34060,"Morgantown, WV MSA",2022,9,70619,68092,2527,3.6
MT5437620000000,54,37620,"Parkersburg-Vienna, WV MSA",2022,9,39058,37446,1612,4.1
MT5448540000000,54,48540,"Wheeling, WV-OH MSA",2022,9,58805,55887,2918,5
MT5511540000000,55,11540,"Appleton, WI MSA",2022,9,135399,132162,3237,2.4
MT5520740000000,55,20740,"Eau Claire, WI MSA",2022,9,93728,91152,2576,2.7
MT5522540000000,55,22540,"Fond du Lac, WI MSA",2022,9,55824,54426,1398,2.5
MT5524580000000,55,24580,"Green Bay, WI MSA",2022,9,175710,171149,4561,2.6
MT5527500000000,55,27500,"Janesville-Beloit, WI MSA",2022,9,84220,81386,2834,3.4
MT5528450000000,55,28450,"Kenosha, WI MSA",2022,9,92599,89839,2760,3
MT5529100000000,55,29100,"La Crosse-Onalaska, WI-MN MSA",2022,9,88564,86299,2265,2.6
MT5531540000000,55,31540,"Madison, WI MSA",2022,9,396086,387301,8785,2.2
MT5533340000000,55,33340,"Milwaukee-Waukesha, WI MSA",2022,9,808869,785104,23765,2.9
MT5536780000000,55,36780,"Oshkosh-Neenah, WI MSA",2022,9,92045,89775,2270,2.5
MT5539540000000,55,39540,"Racine-Mount Pleasant, WI MSA",2022,9,99991,96717,3274,3.3
MT5543100000000,55,43100,"Sheboygan, WI MSA",2022,9,61780,60288,1492,2.4
MT5548140000000,55,48140,"Wausau, WI MSA",2022,9,74145,72340,1805,2.4
MT5616220000000,56,16220,"Casper, WY MSA",2022,9,41620,40130,1490,3.6
MT5616940000000,56,16940,"Cheyenne, WY MSA",2022,9,48411,46711,1700,3.5
MT7210380000000,72,10380,"Aguadilla, PR MSA",2022,9,85779,79356,6423,7.5
MT7211640000000,72,11640,"Arecibo, PR MSA",2022,9,64544,59907,4637,7.2
MT7225020000000,72,25020,"Guayama, PR MSA",2022,9,18291,16683,1608,8.8
MT7232420000000,72,32420,"Mayaguez, PR MSA",2022,9,64542,59764,4778,7.4
MT7238660000000,72,38660,"Ponce, PR MSA",2022,9,86129,78569,7560,8.8
MT7241980000000,72,41980,"San Juan-Bayamon-Caguas, PR MSA",2022,9,787097,747307,39790,5.1
MT0111500000000,1,11500,"Anniston-Oxford, AL MSA",2022,10,49124,47876,1248,2.5
MT0112220000000,1,12220,"Auburn-Opelika, AL MSA",2022,10,91889,89810,2079,2.3
MT0113820000000,1,13820,"Birmingham, AL MSA",2022,10,556080,543770,12310,2.2
MT0119300000000,1,19300,"Daphne-Fairhope-Foley, AL MSA",2022,10,111180,108878,2302,2.1
MT0119460000000,1,19460,"Decatur, AL MSA",2022,10,72892,71370,1522,2.1
MT0120020000000,1,20020,"Dothan, AL MSA",2022,10,66336,64761,1575,2.4
MT0122520000000,1,22520,"Florence-Muscle Shoals, AL MSA",2022,10,66933,65191,1742,2.6
MT0123460000000,1,23460,"Gadsden, AL MSA",2022,10,40670,39596,1074,2.6
MT0126620000000,1,26620,"Huntsville, AL MSA",2022,10,259939,254840,5099,2
MT0133660000000,1,33660,"Mobile, AL MSA",2022,10,182113,176441,5672,3.1
MT0133860000000,1,33860,"Montgomery, AL MSA",2022,10,171746,167186,4560,2.7
MT0146220000000,1,46220,"Tuscaloosa, AL MSA",2022,10,121971,118770,3201,2.6
MT0211260000000,2,11260,"Anchorage, AK MSA",2022,10,197804,190781,7023,3.6
MT0221820000000,2,21820,"Fairbanks-College, AK MSA",2022,10,44646,43072,1574,3.5
MT0422380000000,4,22380,"Flagstaff, AZ MSA",2022,10,72710,69555,3155,4.3
MT0429420000000,4,29420,"Lake Havasu City-Kingman, AZ MSA",2022,10,86017,81938,4079,4.7
MT0438060000000,4,38060,"Phoenix-Mesa-Chandler, AZ MSA",2022,10,2604059,2518182,85877,3.3
MT0439150000000,4,39150,"Prescott Valley-Prescott, AZ MSA",2022,10,104418,100597,3821,3.7
MT0443420000000,4,43420,"Sierra Vista-Douglas, AZ MSA",2022,10,47481,45317,2164,4.6
MT0446060000000,4,46060,"Tucson, AZ MSA",2022,10,488669,470267,18402,3.8
MT0449740000000,4,49740,"Yuma, AZ MSA",2022,10,98172,86190,11982,12.2
MT0522220000000,5,22220,"Fayetteville-Springdale-Rogers, AR MSA",2022,10,292067,285307,6760,2.3
MT0522900000000,5,22900,"Fort Smith, AR-OK MSA",2022,10,99916,96994,2922,2.9
MT0526300000000,5,26300,"Hot Springs, AR MSA",2022,10,43668,42157,1511,3.5
MT0527860000000,5,27860,"Jonesboro, AR MSA",2022,10,64570,62762,1808,2.8
MT0530780000000,5,30780,"Little Rock-North Little Rock-Conway, AR MSA",2022,10,364667,353948,10719,2.9
MT0612540000000,6,12540,"Bakersfield-Delano, CA MSA",2022,10,395049,366479,28570,7.2
MT0617020000000,6,17020,"Chico, CA MSA",2022,10,90102,85887,4215,4.7
MT0620940000000,6,20940,"El Centro, CA MSA",2022,10,69100,58020,11080,16
MT0623420000000,6,23420,"Fresno, CA MSA",2022,10,514818,480910,33908,6.6
MT0625260000000,6,25260,"Hanford-Corcoran, CA MSA",2022,10,55181,51002,4179,7.6
MT0631080000000,6,31080,"Los Angeles-Long Beach-Anaheim, CA MSA",2022,10,6610598,6331537,279061,4.2
MT0632900000000,6,32900,"Merced, CA MSA",2022,10,115915,106606,9309,8
MT0633700000000,6,33700,"Modesto, CA MSA",2022,10,245409,231874,13535,5.5
MT0634900000000,6,34900,"Napa, CA MSA",2022,10,71498,69284,2214,3.1
MT0637100000000,6,37100,"Oxnard-Thousand Oaks-Ventura, CA MSA",2022,10,412564,397751,14813,3.6
MT0639820000000,6,39820,"Redding, CA MSA",2022,10,76290,72846,3444,4.5
MT0640140000000,6,40140,"Riverside-San Bernardino-Ontario, CA MSA",2022,10,2143068,2056223,86845,4.1
MT0640900000000,6,40900,"Sacramento-Roseville-Folsom, CA MSA",2022,10,1144285,1102068,42217,3.7
MT0641500000000,6,41500,"Salinas, CA MSA",2022,10,215281,201524,13757,6.4
MT0641740000000,6,41740,"San Diego-Chula Vista-Carlsbad, CA MSA",2022,10,1616017,1563899,52118,3.2
MT0641860000000,6,41860,"San Francisco-Oakland-Fremont, CA MSA",2022,10,2502438,2430529,71909,2.9
MT0641940000000,6,41940,"San Jose-Sunnyvale-Santa Clara, CA MSA",2022,10,1048783,1020176,28607,2.7
MT0642020000000,6,42020,"San Luis Obispo-Paso Robles, CA MSA",2022,10,130939,126866,4073,3.1
MT0642100000000,6,42100,"Santa Cruz-Watsonville, CA MSA",2022,10,134269,127786,6483,4.8
MT0642200000000,6,42200,"Santa Maria-Santa Barbara, CA MSA",2022,10,217775,209997,7778,3.6
MT0642220000000,6,42220,"Santa Rosa-Petaluma, CA MSA",2022,10,244526,236979,7547,3.1
MT0644700000000,6,44700,"Stockton-Lodi, CA MSA",2022,10,357457,338889,18568,5.2
MT0646700000000,6,46700,"Vallejo, CA MSA",2022,10,209714,201387,8327,4
MT0647300000000,6,47300,"Visalia, CA MSA",2022,10,211921,193575,18346,8.7
MT0649700000000,6,49700,"Yuba City, CA MSA",2022,10,78206,73049,5157,6.6
MT0814500000000,8,14500,"Boulder, CO MSA",2022,10,192021,187159,4862,2.5
MT0817820000000,8,17820,"Colorado Springs, CO MSA",2022,10,382226,370479,11747,3.1
MT0819740000000,8,19740,"Denver-Aurora-Centennial, CO MSA",2022,10,1742653,1693636,49017,2.8
MT0822660000000,8,22660,"Fort Collins-Loveland, CO MSA",2022,10,202101,196559,5542,2.7
MT0824300000000,8,24300,"Grand Junction, CO MSA",2022,10,77987,75392,2595,3.3
MT0824540000000,8,24540,"Greeley, CO MSA",2022,10,170289,164961,5328,3.1
MT0839380000000,8,39380,"Pueblo, CO MSA",2022,10,73843,70649,3194,4.3
MT0914860000000,9,14860,"Bridgeport-Stamford-Danbury, CT MSA",2022,10,505256,487927,17329,3.4
MT0925540000000,9,25540,"Hartford-West Hartford-East Hartford, CT MSA",2022,10,603086,580936,22150,3.7
MT0935300000000,9,35300,"New Haven, CT MSA",2022,10,309139,297921,11218,3.6
MT0935980000000,9,35980,"Norwich-New London-Willimantic, CT MSA",2022,10,139599,134319,5280,3.8
MT0947930000000,9,47930,"Waterbury-Shelton, CT MSA",2022,10,238078,228302,9776,4.1
MT1020100000000,10,20100,"Dover, DE MSA",2022,10,84269,80478,3791,4.5
MT1147900000000,11,47900,"Washington-Arlington-Alexandria, DC-VA-MD-WV MSA",2022,10,3464401,3370728,93673,2.7
MT1215980000000,12,15980,"Cape Coral-Fort Myers, FL MSA",2022,10,357797,341098,16699,4.7
MT1218880000000,12,18880,"Crestview-Fort Walton Beach-Destin, FL MSA",2022,10,139832,136443,3389,2.4
MT1219660000000,12,19660,"Deltona-Daytona Beach-Ormond Beach, FL MSA",2022,10,311315,301225,10090,3.2
MT1223540000000,12,23540,"Gainesville, FL MSA",2022,10,166322,161433,4889,2.9
MT1226140000000,12,26140,"Homosassa Springs, FL MSA",2022,10,52757,50665,2092,4
MT1227260000000,12,27260,"Jacksonville, FL MSA",2022,10,833132,809549,23583,2.8
MT1229460000000,12,29460,"Lakeland-Winter Haven, FL MSA",2022,10,347888,336266,11622,3.3
MT1233100000000,12,33100,"Miami-Fort Lauderdale-West Palm Beach, FL MSA",2022,10,3202135,3119322,82813,2.6
MT1234940000000,12,34940,"Naples-Marco Island, FL MSA",2022,10,176027,170447,5580,3.2
MT1235840000000,12,35840,"North Port-Bradenton-Sarasota, FL MSA",2022,10,378163,367244,10919,2.9
MT1236100000000,12,36100,"Ocala, FL MSA",2022,10,152917,147754,5163,3.4
MT1236740000000,12,36740,"Orlando-Kissimmee-Sanford, FL MSA",2022,10,1474046,1433432,40614,2.8
MT1237340000000,12,37340,"Palm Bay-Melbourne-Titusville, FL MSA",2022,10,295765,287393,8372,2.8
MT1237460000000,12,37460,"Panama City-Panama City Beach, FL MSA",2022,10,98387,95709,2678,2.7
MT1237860000000,12,37860,"Pensacola-Ferry Pass-Brent, FL MSA",2022,10,235832,229126,6706,2.8
MT1238940000000,12,38940,"Port St. Lucie, FL MSA",2022,10,231936,224708,7228,3.1
MT1239460000000,12,39460,"Punta Gorda, FL MSA",2022,10,74474,71017,3457,4.6
MT1242680000000,12,42680,"Sebastian-Vero Beach-West Vero Corridor, FL MSA",2022,10,66319,64108,2211,3.3
MT1242700000000,12,42700,"Sebring, FL MSA",2022,10,35785,34323,1462,4.1
MT1245220000000,12,45220,"Tallahassee, FL MSA",2022,10,201560,195680,5880,2.9
MT1245300000000,12,45300,"Tampa-St. Petersburg-Clearwater, FL MSA",2022,10,1655400,1610034,45366,2.7
MT1248680000000,12,48680,"Wildwood-The Villages, FL MSA",2022,10,32258,30695,1563,4.8
MT1310500000000,13,10500,"Albany, GA MSA",2022,10,63309,60755,2554,4
MT1312020000000,13,12020,"Athens-Clarke County, GA MSA",2022,10,102928,99733,3195,3.1
MT1312060000000,13,12060,"Atlanta-Sandy Springs-Roswell, GA MSA",2022,10,3206636,3107767,98869,3.1
MT1312260000000,13,12260,"Augusta-Richmond County, GA-SC MSA",2022,10,263704,253947,9757,3.7
MT1315260000000,13,15260,"Brunswick-St. Simons, GA MSA",2022,10,53120,51494,1626,3.1
MT1317980000000,13,17980,"Columbus, GA-AL MSA",2022,10,128512,123657,4855,3.8
MT1319140000000,13,19140,"Dalton, GA MSA",2022,10,66492,63981,2511,3.8
MT1323580000000,13,23580,"Gainesville, GA MSA",2022,10,104546,101707,2839,2.7
MT1325980000000,13,25980,"Hinesville, GA MSA",2022,10,30966,29759,1207,3.9
MT1331420000000,13,31420,"Macon-Bibb County, GA MSA",2022,10,96833,93139,3694,3.8
MT1340660000000,13,40660,"Rome, GA MSA",2022,10,45403,43926,1477,3.3
MT1342340000000,13,42340,"Savannah, GA MSA",2022,10,203413,197236,6177,3
MT1346660000000,13,46660,"Valdosta, GA MSA",2022,10,60628,58443,2185,3.6
MT1347580000000,13,47580,"Warner Robins, GA MSA",2022,10,87775,84845,2930,3.3
MT1527980000000,15,27980,"Kahului-Wailuku, HI MSA",2022,10,83704,80998,2706,3.2
MT1546520000000,15,46520,"Urban Honolulu, HI MSA",2022,10,468335,452967,15368,3.3
MT1614260000000,16,14260,"Boise City, ID MSA",2022,10,427459,416064,11395,2.7
MT1617660000000,16,17660,"Coeur d'Alene, ID MSA",2022,10,86766,83641,3125,3.6
MT1626820000000,16,26820,"Idaho Falls, ID MSA",2022,10,80475,78432,2043,2.5
MT1630300000000,16,30300,"Lewiston, ID-WA MSA",2022,10,30434,29475,959,3.2
MT1638540000000,16,38540,"Pocatello, ID MSA",2022,10,39553,38257,1296,3.3
MT1646300000000,16,46300,"Twin Falls, ID MSA",2022,10,58101,56433,1668,2.9
MT1714010000000,17,14010,"Bloomington, IL MSA",2022,10,91661,88535,3126,3.4
MT1716580000000,17,16580,"Champaign-Urbana, IL MSA",2022,10,121838,117200,4638,3.8
MT1716980000000,17,16980,"Chicago-Naperville-Elgin, IL-IN MSA",2022,10,4866243,4642473,223770,4.6
MT1719340000000,17,19340,"Davenport-Moline-Rock Island, IA-IL MSA",2022,10,188988,181684,7304,3.9
MT1719500000000,17,19500,"Decatur, IL MSA",2022,10,44932,42515,2417,5.4
MT1728100000000,17,28100,"Kankakee, IL MSA",2022,10,50030,47237,2793,5.6
MT1737900000000,17,37900,"Peoria, IL MSA",2022,10,171910,164333,7577,4.4
MT1740420000000,17,40420,"Rockford, IL MSA",2022,10,158381,149722,8659,5.5
MT1744100000000,17,44100,"Springfield, IL MSA",2022,10,101627,97469,4158,4.1
MT1814020000000,18,14020,"Bloomington, IN MSA",2022,10,83164,80819,2345,2.8
MT1818020000000,18,18020,"Columbus, IN MSA",2022,10,39384,38261,1123,2.9
MT1821140000000,18,21140,"Elkhart-Goshen, IN MSA",2022,10,105868,102331,3537,3.3
MT1821780000000,18,21780,"Evansville, IN MSA",2022,10,134303,130252,4051,3
MT1823060000000,18,23060,"Fort Wayne, IN MSA",2022,10,228389,221939,6450,2.8
MT1826900000000,18,26900,"Indianapolis-Carmel-Greenwood, IN MSA",2022,10,1103302,1071326,31976,2.9
MT1829020000000,18,29020,"Kokomo, IN MSA",2022,10,35539,33879,1660,4.7
MT1829200000000,18,29200,"Lafayette-West Lafayette, IN MSA",2022,10,117809,114511,3298,2.8
MT1833140000000,18,33140,"Michigan City-La Porte, IN MSA",2022,10,50710,48834,1876,3.7
MT1834620000000,18,34620,"Muncie, IN MSA",2022,10,51481,49625,1856,3.6
MT1843780000000,18,43780,"South Bend-Mishawaka, IN-MI MSA",2022,10,154493,148590,5903,3.8
MT1845460000000,18,45460,"Terre Haute, IN MSA",2022,10,76362,73632,2730,3.6
MT1911180000000,19,11180,"Ames, IA MSA",2022,10,69435,67758,1677,2.4
MT1916300000000,19,16300,"Cedar Rapids, IA MSA",2022,10,149700,144910,4790,3.2
MT1919780000000,19,19780,"Des Moines-West Des Moines, IA MSA",2022,10,401959,390820,11139,2.8
MT1920220000000,19,20220,"Dubuque, IA MSA",2022,10,54058,52258,1800,3.3
MT1926980000000,19,26980,"Iowa City, IA MSA",2022,10,99044,96581,2463,2.5
MT1943580000000,19,43580,"Sioux City, IA-NE-SD MSA",2022,10,76875,74617,2258,2.9
MT1947940000000,19,47940,"Waterloo-Cedar Falls, IA MSA",2022,10,89152,86499,2653,3
MT2029940000000,20,29940,"Lawrence, KS MSA",2022,10,69100,67253,1847,2.7
MT2031740000000,20,31740,"Manhattan, KS MSA",2022,10,63015,61185,1830,2.9
MT2045820000000,20,45820,"Topeka, KS MSA",2022,10,117025,113471,3554,3
MT2048620000000,20,48620,"Wichita, KS MSA",2022,10,326810,316615,10195,3.1
MT2114540000000,21,14540,"Bowling Green, KY MSA",2022,10,89308,85929,3379,3.8
MT2121060000000,21,21060,"Elizabethtown, KY MSA",2022,10,53251,50905,2346,4.4
MT2130460000000,21,30460,"Lexington-Fayette, KY MSA",2022,10,268801,259682,9119,3.4
MT2131140000000,21,31140,"Louisville/Jefferson County, KY-IN MSA",2022,10,684790,660518,24272,3.5
MT2136980000000,21,36980,"Owensboro, KY MSA",2022,10,50989,48761,2228,4.4
MT2137140000000,21,37140,"Paducah, KY-IL MSA",2022,10,45199,43193,2006,4.4
MT2210780000000,22,10780,"Alexandria, LA MSA",2022,10,64958,62887,2071,3.2
MT2212940000000,22,12940,"Baton Rouge, LA MSA",2022,10,418263,404031,14232,3.4
MT2225220000000,22,25220,"Hammond, LA MSA",2022,10,59199,56847,2352,4
MT2226380000000,22,26380,"Houma-Bayou Cane-Thibodaux, LA MSA",2022,10,86929,84085,2844,3.3
MT2229180000000,22,29180,"Lafayette, LA MSA",2022,10,196111,190146,5965,3
MT2229340000000,22,29340,"Lake Charles, LA MSA",2022,10,98602,94995,3607,3.7
MT2233740000000,22,33740,"Monroe, LA MSA",2022,10,96130,92375,3755,3.9
MT2235380000000,22,35380,"New Orleans-Metairie, LA MSA",2022,10,467778,451090,16688,3.6
MT2243340000000,22,43340,"Shreveport-Bossier City, LA MSA",2022,10,168201,162206,5995,3.6
MT2243640000000,22,43640,"Slidell-Mandeville-Covington, LA MSA",2022,10,127216,123634,3582,2.8
MT2312620000000,23,12620,"Bangor, ME MSA",2022,10,73066,70946,2120,2.9
MT2330340000000,23,30340,"Lewiston-Auburn, ME MSA",2022,10,53636,52180,1456,2.7
MT2338860000000,23,38860,"Portland-South Portland, ME MSA",2022,10,301757,295173,6584,2.2
MT2412580000000,24,12580,"Baltimore-Columbia-Towson, MD MSA",2022,10,1459418,1418770,40648,2.8
MT2425180000000,24,25180,"Hagerstown-Martinsburg, MD-WV MSA",2022,10,141632,137438,4194,3
MT2430500000000,24,30500,"Lexington Park, MD MSA",2022,10,104652,101881,2771,2.6
MT2441540000000,24,41540,"Salisbury, MD MSA",2022,10,61844,59828,2016,3.3
MT2511200000000,25,11200,"Amherst Town-Northampton, MA MSA",2022,10,83139,80231,2908,3.5
MT2512700000000,25,12700,"Barnstable Town, MA MSA",2022,10,113484,108159,5325,4.7
MT2514460000000,25,14460,"Boston-Cambridge-Newton, MA-NH MSA",2022,10,2734772,2646700,88072,3.2
MT2538340000000,25,38340,"Pittsfield, MA MSA",2022,10,63270,60617,2653,4.2
MT2544140000000,25,44140,"Springfield, MA MSA",2022,10,221575,211080,10495,4.7
MT2549340000000,25,49340,"Worcester, MA MSA",2022,10,451715,434727,16988,3.8
MT2611460000000,26,11460,"Ann Arbor, MI MSA",2022,10,200345,193523,6822,3.4
MT2612980000000,26,12980,"Battle Creek, MI MSA",2022,10,60311,57478,2833,4.7
MT2613020000000,26,13020,"Bay City, MI MSA",2022,10,48682,46119,2563,5.3
MT2619820000000,26,19820,"Detroit-Warren-Dearborn, MI MSA",2022,10,2113217,2037437,75780,3.6
MT2622420000000,26,22420,"Flint, MI MSA",2022,10,182854,173188,9666,5.3
MT2624340000000,26,24340,"Grand Rapids-Wyoming-Kentwood, MI MSA",2022,10,607042,585472,21570,3.6
MT2627100000000,26,27100,"Jackson, MI MSA",2022,10,73386,70123,3263,4.4
MT2628020000000,26,28020,"Kalamazoo-Portage, MI MSA",2022,10,134899,129800,5099,3.8
MT2629620000000,26,29620,"Lansing-East Lansing, MI MSA",2022,10,242548,232505,10043,4.1
MT2633220000000,26,33220,"Midland, MI MSA",2022,10,40373,38626,1747,4.3
MT2633780000000,26,33780,"Monroe, MI MSA",2022,10,74598,71140,3458,4.6
MT2634740000000,26,34740,"Muskegon-Norton Shores, MI MSA",2022,10,81798,77900,3898,4.8
MT2635660000000,26,35660,"Niles, MI MSA",2022,10,73891,70601,3290,4.5
MT2640980000000,26,40980,"Saginaw, MI MSA",2022,10,83062,78538,4524,5.4
MT2645900000000,26,45900,"Traverse City, MI MSA",2022,10,78825,75477,3348,4.2
MT2720260000000,27,20260,"Duluth, MN-WI MSA",2022,10,138708,133990,4718,3.4
MT2731860000000,27,31860,"Mankato, MN MSA",2022,10,59196,57915,1281,2.2
MT2733460000000,27,33460,"Minneapolis-St. Paul-Bloomington, MN-WI MSA",2022,10,2038258,1988884,49374,2.4
MT2740340000000,27,40340,"Rochester, MN MSA",2022,10,124107,121300,2807,2.3
MT2741060000000,27,41060,"St. Cloud, MN MSA",2022,10,108529,105484,3045,2.8
MT2825060000000,28,25060,"Gulfport-Biloxi, MS MSA",2022,10,182627,176218,6409,3.5
MT2825620000000,28,25620,"Hattiesburg, MS MSA",2022,10,70104,67796,2308,3.3
MT2827140000000,28,27140,"Jackson, MS MSA",2022,10,276588,267434,9154,3.3
MT2916020000000,29,16020,"Cape Girardeau, MO-IL MSA",2022,10,48024,46767,1257,2.6
MT2917860000000,29,17860,"Columbia, MO MSA",2022,10,113294,110767,2527,2.2
MT2927620000000,29,27620,"Jefferson City, MO MSA",2022,10,73400,71668,1732,2.4
MT2927900000000,29,27900,"Joplin, MO-KS MSA",2022,10,95469,92989,2480,2.6
MT2928140000000,29,28140,"Kansas City, MO-KS MSA",2022,10,1165040,1132778,32262,2.8
MT2941140000000,29,41140,"St. Joseph, MO-KS MSA",2022,10,53686,52143,1543,2.9
MT2941180000000,29,41180,"St. Louis, MO-IL MSA",2022,10,1449563,1407240,42323,2.9
MT2944180000000,29,44180,"Springfield, MO MSA",2022,10,235913,230228,5685,2.4
MT3013740000000,30,13740,"Billings, MT MSA",2022,10,98854,96576,2278,2.3
MT3014580000000,30,14580,"Bozeman, MT MSA",2022,10,75382,73940,1442,1.9
MT3024500000000,30,24500,"Great Falls, MT MSA",2022,10,39951,38927,1024,2.6
MT3025740000000,30,25740,"Helena, MT MSA",2022,10,46891,45744,1147,2.4
MT3033540000000,30,33540,"Missoula, MT MSA",2022,10,72559,70819,1740,2.4
MT3124260000000,31,24260,"Grand Island, NE MSA",2022,10,41646,40734,912,2.2
MT3130700000000,31,30700,"Lincoln, NE MSA",2022,10,189700,185681,4019,2.1
MT3136540000000,31,36540,"Omaha, NE-IA MSA",2022,10,516328,503442,12886,2.5
MT3216180000000,32,16180,"Carson City, NV MSA",2022,10,28246,26984,1262,4.5
MT3229820000000,32,29820,"Las Vegas-Henderson-North Las Vegas, NV MSA",2022,10,1166777,1102814,63963,5.5
MT3239900000000,32,39900,"Reno, NV MSA",2022,10,291556,278732,12824,4.4
MT3331700000000,33,31700,"Manchester-Nashua, NH MSA",2022,10,240006,233638,6368,2.7
MT3412100000000,34,12100,"Atlantic City-Hammonton, NJ MSA",2022,10,179183,170159,9024,5
MT3445940000000,34,45940,"Trenton-Princeton, NJ MSA",2022,10,197403,190903,6500,3.3
MT3447220000000,34,47220,"Vineland, NJ MSA",2022,10,65411,61972,3439,5.3
MT3510740000000,35,10740,"Albuquerque, NM MSA",2022,10,448966,435009,13957,3.1
MT3522140000000,35,22140,"Farmington, NM MSA",2022,10,48253,46289,1964,4.1
MT3529740000000,35,29740,"Las Cruces, NM MSA",2022,10,97491,93465,4026,4.1
MT3542140000000,35,42140,"Santa Fe, NM MSA",2022,10,72380,70125,2255,3.1
MT3610580000000,36,10580,"Albany-Schenectady-Troy, NY MSA",2022,10,452006,438269,13737,3
MT3613780000000,36,13780,"Binghamton, NY MSA",2022,10,105659,101812,3847,3.6
MT3615380000000,36,15380,"Buffalo-Cheektowaga, NY MSA",2022,10,553990,534520,19470,3.5
MT3621300000000,36,21300,"Elmira, NY MSA",2022,10,35354,34072,1282,3.6
MT3624020000000,36,24020,"Glens Falls, NY MSA",2022,10,59214,57247,1967,3.3
MT3627060000000,36,27060,"Ithaca, NY MSA",2022,10,48176,46731,1445,3
MT3628740000000,36,28740,"Kingston, NY MSA",2022,10,85722,83003,2719,3.2
MT3628880000000,36,28880,"Kiryas Joel-Poughkeepsie-Newburgh, NY MSA",2022,10,333310,322897,10413,3.1
MT3635620000000,36,35620,"New York-Newark-Jersey City, NY-NJ MSA",2022,10,9962960,9573773,389187,3.9
MT3640380000000,36,40380,"Rochester, NY MSA",2022,10,509122,492168,16954,3.3
MT3645060000000,36,45060,"Syracuse, NY MSA",2022,10,310039,299485,10554,3.4
MT3646540000000,36,46540,"Utica-Rome, NY MSA",2022,10,127407,122764,4643,3.6
MT3648060000000,36,48060,"Watertown-Fort Drum, NY MSA",2022,10,44713,42855,1858,4.2
MT3711700000000,37,11700,"Asheville, NC MSA",2022,10,207955,201398,6557,3.2
MT3715500000000,37,15500,"Burlington, NC MSA",2022,10,83446,80225,3221,3.9
MT3716740000000,37,16740,"Charlotte-Concord-Gastonia, NC-SC MSA",2022,10,1443271,1392071,51200,3.5
MT3720500000000,37,20500,"Durham-Chapel Hill, NC MSA",2022,10,316042,305631,10411,3.3
MT3722180000000,37,22180,"Fayetteville, NC MSA",2022,10,153054,145593,7461,4.9
MT3724140000000,37,24140,"Goldsboro, NC MSA",2022,10,49712,47757,1955,3.9
MT3724660000000,37,24660,"Greensboro-High Point, NC MSA",2022,10,373234,358007,15227,4.1
MT3724780000000,37,24780,"Greenville, NC MSA",2022,10,82476,78965,3511,4.3
MT3725860000000,37,25860,"Hickory-Lenoir-Morganton, NC MSA",2022,10,172737,166642,6095,3.5
MT3727340000000,37,27340,"Jacksonville, NC MSA",2022,10,72870,69981,2889,4
MT3738240000000,37,38240,"Pinehurst-Southern Pines, NC MSA",2022,10,43524,41930,1594,3.7
MT3739580000000,37,39580,"Raleigh-Cary, NC MSA",2022,10,814151,788856,25295,3.1
MT3740580000000,37,40580,"Rocky Mount, NC MSA",2022,10,63554,60089,3465,5.5
MT3748900000000,37,48900,"Wilmington, NC MSA",2022,10,216756,208560,8196,3.8
MT3749180000000,37,49180,"Winston-Salem, NC MSA",2022,10,325172,312899,12273,3.8
MT3813900000000,38,13900,"Bismarck, ND MSA",2022,10,72185,70720,1465,2
MT3822020000000,38,22020,"Fargo, ND-MN MSA",2022,10,150109,147348,2761,1.8
MT3824220000000,38,24220,"Grand Forks, ND-MN MSA",2022,10,54688,53496,1192,2.2
MT3833500000000,38,33500,"Minot, ND MSA",2022,10,39378,38528,850,2.2
MT3910420000000,39,10420,"Akron, OH MSA",2022,10,355245,341029,14216,4
MT3915940000000,39,15940,"Canton-Massillon, OH MSA",2022,10,188953,180856,8097,4.3
MT3917140000000,39,17140,"Cincinnati, OH-KY-IN MSA",2022,10,1148964,1107813,41151,3.6
MT3917410000000,39,17410,"Cleveland, OH MSA",2022,10,1075604,1028871,46733,4.3
MT3918140000000,39,18140,"Columbus, OH MSA",2022,10,1115657,1076210,39447,3.5
MT3919430000000,39,19430,"Dayton-Kettering-Beavercreek, OH MSA",2022,10,382560,367360,15200,4
MT3930620000000,39,30620,"Lima, OH MSA",2022,10,47181,45210,1971,4.2
MT3931900000000,39,31900,"Mansfield, OH MSA",2022,10,51996,49597,2399,4.6
MT3941780000000,39,41780,"Sandusky, OH MSA",2022,10,56228,53418,2810,5
MT3944220000000,39,44220,"Springfield, OH MSA",2022,10,61082,58550,2532,4.1
MT3945780000000,39,45780,"Toledo, OH MSA",2022,10,290018,277327,12691,4.4
MT3948260000000,39,48260,"Weirton-Steubenville, WV-OH MSA",2022,10,52359,49837,2522,4.8
MT3949660000000,39,49660,"Youngstown-Warren, OH MSA",2022,10,189409,180439,8970,4.7
MT4021420000000,40,21420,"Enid, OK MSA",2022,10,28135,27324,811,2.9
MT4030020000000,40,30020,"Lawton, OK MSA",2022,10,51056,49201,1855,3.6
MT4036420000000,40,36420,"Oklahoma City, OK MSA",2022,10,737173,716070,21103,2.9
MT4046140000000,40,46140,"Tulsa, OK MSA",2022,10,501379,485489,15890,3.2
MT4110540000000,41,10540,"Albany, OR MSA",2022,10,60940,58139,2801,4.6
MT4113460000000,41,13460,"Bend, OR MSA",2022,10,126543,120954,5589,4.4
MT4118700000000,41,18700,"Corvallis, OR MSA",2022,10,48541,46750,1791,3.7
MT4121660000000,41,21660,"Eugene-Springfield, OR MSA",2022,10,185455,177057,8398,4.5
MT4124420000000,41,24420,"Grants Pass, OR MSA",2022,10,34958,32883,2075,5.9
MT4132780000000,41,32780,"Medford, OR MSA",2022,10,104314,99129,5185,5
MT4138900000000,41,38900,"Portland-Vancouver-Hillsboro, OR-WA MSA",2022,10,1369578,1318245,51333,3.7
MT4141420000000,41,41420,"Salem, OR MSA",2022,10,214596,205560,9036,4.2
MT4210900000000,42,10900,"Allentown-Bethlehem-Easton, PA-NJ MSA",2022,10,445162,427205,17957,4
MT4211020000000,42,11020,"Altoona, PA MSA",2022,10,56660,54241,2419,4.3
MT4216540000000,42,16540,"Chambersburg, PA MSA",2022,10,76820,74140,2680,3.5
MT4221500000000,42,21500,"Erie, PA MSA",2022,10,125220,119459,5761,4.6
MT4223900000000,42,23900,"Gettysburg, PA MSA",2022,10,52032,50316,1716,3.3
MT4225420000000,42,25420,"Harrisburg-Carlisle, PA MSA",2022,10,307581,296943,10638,3.5
MT4227780000000,42,27780,"Johnstown, PA MSA",2022,10,56841,54046,2795,4.9
MT4229540000000,42,29540,"Lancaster, PA MSA",2022,10,288953,279730,9223,3.2
MT4230140000000,42,30140,"Lebanon, PA MSA",2022,10,71430,68947,2483,3.5
MT4237980000000,42,37980,"Philadelphia-Camden-Wilmington, PA-NJ-DE-MD MSA",2022,10,3241075,3118608,122467,3.8
MT4238300000000,42,38300,"Pittsburgh, PA MSA",2022,10,1220519,1169404,51115,4.2
MT4239740000000,42,39740,"Reading, PA MSA",2022,10,216064,207689,8375,3.9
MT4242540000000,42,42540,"Scranton--Wilkes-Barre, PA MSA",2022,10,276208,263260,12948,4.7
MT4244300000000,42,44300,"State College, PA MSA",2022,10,76143,73645,2498,3.3
MT4248700000000,42,48700,"Williamsport, PA MSA",2022,10,51990,49603,2387,4.6
MT4249620000000,42,49620,"York-Hanover, PA MSA",2022,10,236220,227921,8299,3.5
MT4439300000000,44,39300,"Providence-Warwick, RI-MA MSA",2022,10,872321,840616,31705,3.6
MT4516700000000,45,16700,"Charleston-North Charleston, SC MSA",2022,10,415979,404640,11339,2.7
MT4517900000000,45,17900,"Columbia, SC MSA",2022,10,399564,387470,12094,3
MT4522500000000,45,22500,"Florence, SC MSA",2022,10,89887,86832,3055,3.4
MT4524860000000,45,24860,"Greenville-Anderson-Greer, SC MSA",2022,10,458050,445111,12939,2.8
MT4525940000000,45,25940,"Hilton Head Island-Bluffton-Port Royal, SC MSA",2022,10,93873,91130,2743,2.9
MT4534820000000,45,34820,"Myrtle Beach-Conway-North Myrtle Beach, SC MSA",2022,10,162291,156142,6149,3.8
MT4543900000000,45,43900,"Spartanburg, SC MSA",2022,10,168103,162607,5496,3.3
MT4544940000000,45,44940,"Sumter, SC MSA",2022,10,41375,39770,1605,3.9
MT4639660000000,46,39660,"Rapid City, SD MSA",2022,10,77945,76425,1520,2
MT4643620000000,46,43620,"Sioux Falls, SD-MN MSA",2022,10,168680,165764,2916,1.7
MT4716860000000,47,16860,"Chattanooga, TN-GA MSA",2022,10,278579,269671,8908,3.2
MT4717300000000,47,17300,"Clarksville, TN-KY MSA",2022,10,134119,128876,5243,3.9
MT4717420000000,47,17420,"Cleveland, TN MSA",2022,10,56000,53948,2052,3.7
MT4727180000000,47,27180,"Jackson, TN MSA",2022,10,77729,74836,2893,3.7
MT4727740000000,47,27740,"Johnson City, TN MSA",2022,10,95563,92268,3295,3.4
MT4728700000000,47,28700,"Kingsport-Bristol, TN-VA MSA",2022,10,130718,126033,4685,3.6
MT4728940000000,47,28940,"Knoxville, TN MSA",2022,10,440346,426410,13936,3.2
MT4732820000000,47,32820,"Memphis, TN-MS-AR MSA",2022,10,627673,602219,25454,4.1
MT4734100000000,47,34100,"Morristown, TN MSA",2022,10,52721,50793,1928,3.7
MT4734980000000,47,34980,"Nashville-Davidson--Murfreesboro--Franklin, TN MSA",2022,10,1126766,1095532,31234,2.8
MT4810180000000,48,10180,"Abilene, TX MSA",2022,10,82743,79857,2886,3.5
MT4811100000000,48,11100,"Amarillo, TX MSA",2022,10,131821,127724,4097,3.1
MT4812420000000,48,12420,"Austin-Round Rock-San Marcos, TX MSA",2022,10,1412658,1369917,42741,3
MT4813140000000,48,13140,"Beaumont-Port Arthur, TX MSA",2022,10,172219,162803,9416,5.5
MT4815180000000,48,15180,"Brownsville-Harlingen, TX MSA",2022,10,181794,171802,9992,5.5
MT4817780000000,48,17780,"College Station-Bryan, TX MSA",2022,10,142054,137152,4902,3.5
MT4818580000000,48,18580,"Corpus Christi, TX MSA",2022,10,200762,191333,9429,4.7
MT4819100000000,48,19100,"Dallas-Fort Worth-Arlington, TX MSA",2022,10,4276416,4122904,153512,3.6
MT4820580000000,48,20580,"Eagle Pass, TX MSA",2022,10,23303,21489,1814,7.8
MT4821340000000,48,21340,"El Paso, TX MSA",2022,10,390024,373877,16147,4.1
MT4826420000000,48,26420,"Houston-Pasadena-The Woodlands, TX MSA",2022,10,3632150,3482790,149360,4.1
MT4828660000000,48,28660,"Killeen-Temple, TX MSA",2022,10,194521,186205,8316,4.3
MT4829700000000,48,29700,"Laredo, TX MSA",2022,10,112239,107702,4537,4
MT4830980000000,48,30980,"Longview, TX MSA",2022,10,126701,121289,5412,4.3
MT4831180000000,48,31180,"Lubbock, TX MSA",2022,10,176111,169889,6222,3.5
MT4832580000000,48,32580,"McAllen-Edinburg-Mission, TX MSA",2022,10,380203,355887,24316,6.4
MT4833260000000,48,33260,"Midland, TX MSA",2022,10,95515,92629,2886,3
MT4836220000000,48,36220,"Odessa, TX MSA",2022,10,80861,77946,2915,3.6
MT4841660000000,48,41660,"San Angelo, TX MSA",2022,10,59299,57444,1855,3.1
MT4841700000000,48,41700,"San Antonio-New Braunfels, TX MSA",2022,10,1267926,1221439,46487,3.7
MT4843300000000,48,43300,"Sherman-Denison, TX MSA",2022,10,67459,64933,2526,3.7
MT4845500000000,48,45500,"Texarkana, TX-AR MSA",2022,10,60303,57712,2591,4.3
MT4846340000000,48,46340,"Tyler, TX MSA",2022,10,112612,108460,4152,3.7
MT4847020000000,48,47020,"Victoria, TX MSA",2022,10,44256,42466,1790,4
MT4847380000000,48,47380,"Waco, TX MSA",2022,10,139940,134732,5208,3.7
MT4848660000000,48,48660,"Wichita Falls, TX MSA",2022,10,65454,63052,2402,3.7
MT4930860000000,49,30860,"Logan, UT-ID MSA",2022,10,78792,77021,1771,2.2
MT4936260000000,49,36260,"Ogden, UT MSA",2022,10,336725,328879,7846,2.3
MT4939340000000,49,39340,"Provo-Orem-Lehi, UT MSA",2022,10,356838,348379,8459,2.4
MT4941100000000,49,41100,"St. George, UT MSA",2022,10,87215,84814,2401,2.8
MT4941620000000,49,41620,"Salt Lake City-Murray, UT MSA",2022,10,712457,694920,17537,2.5
MT5015540000000,50,15540,"Burlington-South Burlington, VT MSA",2022,10,126857,124446,2411,1.9
MT5113980000000,51,13980,"Blacksburg-Christiansburg-Radford, VA MSA",2022,10,91172,88473,2699,3
MT5116820000000,51,16820,"Charlottesville, VA MSA",2022,10,115964,112928,3036,2.6
MT5125500000000,51,25500,"Harrisonburg, VA MSA",2022,10,71442,69477,1965,2.8
MT5131340000000,51,31340,"Lynchburg, VA MSA",2022,10,126921,122956,3965,3.1
MT5140060000000,51,40060,"Richmond, VA MSA",2022,10,707550,686892,20658,2.9
MT5140220000000,51,40220,"Roanoke, VA MSA",2022,10,155404,150960,4444,2.9
MT5144420000000,51,44420,"Staunton-Stuarts Draft, VA MSA",2022,10,64754,63102,1652,2.6
MT5147260000000,51,47260,"Virginia Beach-Chesapeake-Norfolk, VA-NC MSA",2022,10,863182,836083,27099,3.1
MT5149020000000,51,49020,"Winchester, VA-WV MSA",2022,10,75395,73356,2039,2.7
MT5313380000000,53,13380,"Bellingham, WA MSA",2022,10,114492,109775,4717,4.1
MT5314740000000,53,14740,"Bremerton-Silverdale-Port Orchard, WA MSA",2022,10,121654,116709,4945,4.1
MT5328420000000,53,28420,"Kennewick-Richland, WA MSA",2022,10,145400,138467,6933,4.8
MT5331020000000,53,31020,"Longview-Kelso, WA MSA",2022,10,47615,45248,2367,5
MT5334580000000,53,34580,"Mount Vernon-Anacortes, WA MSA",2022,10,57716,55031,2685,4.7
MT5336500000000,53,36500,"Olympia-Lacey-Tumwater, WA MSA",2022,10,140236,134379,5857,4.2
MT5342660000000,53,42660,"Seattle-Tacoma-Bellevue, WA MSA",2022,10,2259776,2170061,89715,4
MT5344060000000,53,44060,"Spokane-Spokane Valley, WA MSA",2022,10,281085,268769,12316,4.4
MT5347460000000,53,47460,"Walla Walla, WA MSA",2022,10,29614,28455,1159,3.9
MT5348300000000,53,48300,"Wenatchee-East Wenatchee, WA MSA",2022,10,62452,59606,2846,4.6
MT5349420000000,53,49420,"Yakima, WA MSA",2022,10,128008,120459,7549,5.9
MT5413220000000,54,13220,"Beckley, WV MSA",2022,10,45334,43561,1773,3.9
MT5416620000000,54,16620,"Charleston, WV MSA",2022,10,89379,86013,3366,3.8
MT5426580000000,54,26580,"Huntington-Ashland, WV-KY-OH MSA",2022,10,154547,147736,6811,4.4
MT5434060000000,54,34060,"Morgantown, WV MSA",2022,10,70617,68169,2448,3.5
MT5437620000000,54,37620,"Parkersburg-Vienna, WV MSA",2022,10,39022,37427,1595,4.1
MT5448540000000,54,48540,"Wheeling, WV-OH MSA",2022,10,58862,55997,2865,4.9
MT5511540000000,55,11540,"Appleton, WI MSA",2022,10,135522,132379,3143,2.3
MT5520740000000,55,20740,"Eau Claire, WI MSA",2022,10,93782,91220,2562,2.7
MT5522540000000,55,22540,"Fond du Lac, WI MSA",2022,10,55748,54377,1371,2.5
MT5524580000000,55,24580,"Green Bay, WI MSA",2022,10,176120,171636,4484,2.5
MT5527500000000,55,27500,"Janesville-Beloit, WI MSA",2022,10,84393,81641,2752,3.3
MT5528450000000,55,28450,"Kenosha, WI MSA",2022,10,92698,89962,2736,3
MT5529100000000,55,29100,"La Crosse-Onalaska, WI-MN MSA",2022,10,88817,86580,2237,2.5
MT5531540000000,55,31540,"Madison, WI MSA",2022,10,396441,387834,8607,2.2
MT5533340000000,55,33340,"Milwaukee-Waukesha, WI MSA",2022,10,808964,785475,23489,2.9
MT5536780000000,55,36780,"Oshkosh-Neenah, WI MSA",2022,10,92095,89861,2234,2.4
MT5539540000000,55,39540,"Racine-Mount Pleasant, WI MSA",2022,10,100022,96833,3189,3.2
MT5543100000000,55,43100,"Sheboygan, WI MSA",2022,10,61842,60372,1470,2.4
MT5548140000000,55,48140,"Wausau, WI MSA",2022,10,74104,72339,1765,2.4
MT5616220000000,56,16220,"Casper, WY MSA",2022,10,41765,40285,1480,3.5
MT5616940000000,56,16940,"Cheyenne, WY MSA",2022,10,48449,46756,1693,3.5
MT7210380000000,72,10380,"Aguadilla, PR MSA",2022,10,86169,79583,6586,7.6
MT7211640000000,72,11640,"Arecibo, PR MSA",2022,10,64799,60141,4658,7.2
MT7225020000000,72,25020,"Guayama, PR MSA",2022,10,18445,16821,1624,8.8
MT7232420000000,72,32420,"Mayaguez, PR MSA",2022,10,65088,60218,4870,7.5
MT7238660000000,72,38660,"Ponce, PR MSA",2022,10,86984,79179,7805,9
MT7241980000000,72,41980,"San Juan-Bayamon-Caguas, PR MSA",2022,10,793631,753756,39875,5
MT0111500000000,1,11500,"Anniston-Oxford, AL MSA",2022,11,49127,47932,1195,2.4
MT0112220000000,1,12220,"Auburn-Opelika, AL MSA",2022,11,92010,89967,2043,2.2
MT0113820000000,1,13820,"Birmingham, AL MSA",2022,11,556253,544224,12029,2.2
MT0119300000000,1,19300,"Daphne-Fairhope-Foley, AL MSA",2022,11,111521,109308,2213,2
MT0119460000000,1,19460,"Decatur, AL MSA",2022,11,73021,71569,1452,2
MT0120020000000,1,20020,"Dothan, AL MSA",2022,11,66380,64847,1533,2.3
MT0122520000000,1,22520,"Florence-Muscle Shoals, AL MSA",2022,11,67006,65324,1682,2.5
MT0123460000000,1,23460,"Gadsden, AL MSA",2022,11,40722,39692,1030,2.5
MT0126620000000,1,26620,"Huntsville, AL MSA",2022,11,260409,255453,4956,1.9
MT0133660000000,1,33660,"Mobile, AL MSA",2022,11,182071,176560,5511,3
MT0133860000000,1,33860,"Montgomery, AL MSA",2022,11,171923,167460,4463,2.6
MT0146220000000,1,46220,"Tuscaloosa, AL MSA",2022,11,122209,119125,3084,2.5
MT0211260000000,2,11260,"Anchorage, AK MSA",2022,11,198070,191038,7032,3.6
MT0221820000000,2,21820,"Fairbanks-College, AK MSA",2022,11,44709,43124,1585,3.5
MT0422380000000,4,22380,"Flagstaff, AZ MSA",2022,11,72954,69867,3087,4.2
MT0429420000000,4,29420,"Lake Havasu City-Kingman, AZ MSA",2022,11,85966,81981,3985,4.6
MT0438060000000,4,38060,"Phoenix-Mesa-Chandler, AZ MSA",2022,11,2607055,2523123,83932,3.2
MT0439150000000,4,39150,"Prescott Valley-Prescott, AZ MSA",2022,11,104548,100803,3745,3.6
MT0443420000000,4,43420,"Sierra Vista-Douglas, AZ MSA",2022,11,47598,45435,2163,4.5
MT0446060000000,4,46060,"Tucson, AZ MSA",2022,11,488515,470530,17985,3.7
MT0449740000000,4,49740,"Yuma, AZ MSA",2022,11,98526,86326,12200,12.4
MT0522220000000,5,22220,"Fayetteville-Springdale-Rogers, AR MSA",2022,11,292697,286003,6694,2.3
MT0522900000000,5,22900,"Fort Smith, AR-OK MSA",2022,11,100028,97205,2823,2.8
MT0526300000000,5,26300,"Hot Springs, AR MSA",2022,11,43645,42179,1466,3.4
MT0527860000000,5,27860,"Jonesboro, AR MSA",2022,11,64520,62764,1756,2.7
MT0530780000000,5,30780,"Little Rock-North Little Rock-Conway, AR MSA",2022,11,365689,355267,10422,2.8
MT0612540000000,6,12540,"Bakersfield-Delano, CA MSA",2022,11,396150,366886,29264,7.4
MT0617020000000,6,17020,"Chico, CA MSA",2022,11,90314,86003,4311,4.8
MT0620940000000,6,20940,"El Centro, CA MSA",2022,11,69396,57953,11443,16.5
MT0623420000000,6,23420,"Fresno, CA MSA",2022,11,516298,481842,34456,6.7
MT0625260000000,6,25260,"Hanford-Corcoran, CA MSA",2022,11,55366,51106,4260,7.7
MT0631080000000,6,31080,"Los Angeles-Long Beach-Anaheim, CA MSA",2022,11,6622991,6336468,286523,4.3
MT0632900000000,6,32900,"Merced, CA MSA",2022,11,116075,106598,9477,8.2
MT0633700000000,6,33700,"Modesto, CA MSA",2022,11,245625,231765,13860,5.6
MT0634900000000,6,34900,"Napa, CA MSA",2022,11,71693,69442,2251,3.1
MT0637100000000,6,37100,"Oxnard-Thousand Oaks-Ventura, CA MSA",2022,11,412567,397430,15137,3.7
MT0639820000000,6,39820,"Redding, CA MSA",2022,11,76461,72979,3482,4.6
MT0640140000000,6,40140,"Riverside-San Bernardino-Ontario, CA MSA",2022,11,2146620,2057453,89167,4.2
MT0640900000000,6,40900,"Sacramento-Roseville-Folsom, CA MSA",2022,11,1147093,1103890,43203,3.8
MT0641500000000,6,41500,"Salinas, CA MSA",2022,11,214541,200617,13924,6.5
MT0641740000000,6,41740,"San Diego-Chula Vista-Carlsbad, CA MSA",2022,11,1620012,1566739,53273,3.3
MT0641860000000,6,41860,"San Francisco-Oakland-Fremont, CA MSA",2022,11,2505637,2431211,74426,3
MT0641940000000,6,41940,"San Jose-Sunnyvale-Santa Clara, CA MSA",2022,11,1051079,1021543,29536,2.8
MT0642020000000,6,42020,"San Luis Obispo-Paso Robles, CA MSA",2022,11,131100,126928,4172,3.2
MT0642100000000,6,42100,"Santa Cruz-Watsonville, CA MSA",2022,11,134425,127829,6596,4.9
MT0642200000000,6,42200,"Santa Maria-Santa Barbara, CA MSA",2022,11,217665,209762,7903,3.6
MT0642220000000,6,42220,"Santa Rosa-Petaluma, CA MSA",2022,11,244767,237064,7703,3.1
MT0644700000000,6,44700,"Stockton-Lodi, CA MSA",2022,11,357620,338639,18981,5.3
MT0646700000000,6,46700,"Vallejo, CA MSA",2022,11,209995,201494,8501,4
MT0647300000000,6,47300,"Visalia, CA MSA",2022,11,212495,193730,18765,8.8
MT0649700000000,6,49700,"Yuba City, CA MSA",2022,11,78274,72994,5280,6.7
MT0814500000000,8,14500,"Boulder, CO MSA",2022,11,192164,187255,4909,2.6
MT0817820000000,8,17820,"Colorado Springs, CO MSA",2022,11,383028,371216,11812,3.1
MT0819740000000,8,19740,"Denver-Aurora-Centennial, CO MSA",2022,11,1746559,1697247,49312,2.8
MT0822660000000,8,22660,"Fort Collins-Loveland, CO MSA",2022,11,202285,196721,5564,2.8
MT0824300000000,8,24300,"Grand Junction, CO MSA",2022,11,78048,75452,2596,3.3
MT0824540000000,8,24540,"Greeley, CO MSA",2022,11,170579,165215,5364,3.1
MT0839380000000,8,39380,"Pueblo, CO MSA",2022,11,73855,70643,3212,4.3
MT0914860000000,9,14860,"Bridgeport-Stamford-Danbury, CT MSA",2022,11,504920,487972,16948,3.4
MT0925540000000,9,25540,"Hartford-West Hartford-East Hartford, CT MSA",2022,11,602444,580838,21606,3.6
MT0935300000000,9,35300,"New Haven, CT MSA",2022,11,308644,297688,10956,3.5
MT0935980000000,9,35980,"Norwich-New London-Willimantic, CT MSA",2022,11,139721,134622,5099,3.6
MT0947930000000,9,47930,"Waterbury-Shelton, CT MSA",2022,11,237856,228325,9531,4
MT1020100000000,10,20100,"Dover, DE MSA",2022,11,84273,80531,3742,4.4
MT1147900000000,11,47900,"Washington-Arlington-Alexandria, DC-VA-MD-WV MSA",2022,11,3471437,3378703,92734,2.7
MT1215980000000,12,15980,"Cape Coral-Fort Myers, FL MSA",2022,11,360724,345897,14827,4.1
MT1218880000000,12,18880,"Crestview-Fort Walton Beach-Destin, FL MSA",2022,11,140251,136868,3383,2.4
MT1219660000000,12,19660,"Deltona-Daytona Beach-Ormond Beach, FL MSA",2022,11,312123,301995,10128,3.2
MT1223540000000,12,23540,"Gainesville, FL MSA",2022,11,166784,161895,4889,2.9
MT1226140000000,12,26140,"Homosassa Springs, FL MSA",2022,11,52924,50827,2097,4
MT1227260000000,12,27260,"Jacksonville, FL MSA",2022,11,835795,812122,23673,2.8
MT1229460000000,12,29460,"Lakeland-Winter Haven, FL MSA",2022,11,348808,337047,11761,3.4
MT1233100000000,12,33100,"Miami-Fort Lauderdale-West Palm Beach, FL MSA",2022,11,3210824,3129230,81594,2.5
MT1234940000000,12,34940,"Naples-Marco Island, FL MSA",2022,11,176442,170956,5486,3.1
MT1235840000000,12,35840,"North Port-Bradenton-Sarasota, FL MSA",2022,11,379754,368719,11035,2.9
MT1236100000000,12,36100,"Ocala, FL MSA",2022,11,153620,148465,5155,3.4
MT1236740000000,12,36740,"Orlando-Kissimmee-Sanford, FL MSA",2022,11,1479773,1438894,40879,2.8
MT1237340000000,12,37340,"Palm Bay-Melbourne-Titusville, FL MSA",2022,11,297027,288623,8404,2.8
MT1237460000000,12,37460,"Panama City-Panama City Beach, FL MSA",2022,11,98662,96000,2662,2.7
MT1237860000000,12,37860,"Pensacola-Ferry Pass-Brent, FL MSA",2022,11,236382,229648,6734,2.8
MT1238940000000,12,38940,"Port St. Lucie, FL MSA",2022,11,232556,225272,7284,3.1
MT1239460000000,12,39460,"Punta Gorda, FL MSA",2022,11,74444,71306,3138,4.2
MT1242680000000,12,42680,"Sebastian-Vero Beach-West Vero Corridor, FL MSA",2022,11,66497,64252,2245,3.4
MT1242700000000,12,42700,"Sebring, FL MSA",2022,11,35945,34461,1484,4.1
MT1245220000000,12,45220,"Tallahassee, FL MSA",2022,11,201830,195941,5889,2.9
MT1245300000000,12,45300,"Tampa-St. Petersburg-Clearwater, FL MSA",2022,11,1661253,1615625,45628,2.7
MT1248680000000,12,48680,"Wildwood-The Villages, FL MSA",2022,11,32344,30774,1570,4.9
MT1310500000000,13,10500,"Albany, GA MSA",2022,11,63378,60834,2544,4
MT1312020000000,13,12020,"Athens-Clarke County, GA MSA",2022,11,103207,99986,3221,3.1
MT1312060000000,13,12060,"Atlanta-Sandy Springs-Roswell, GA MSA",2022,11,3215808,3115515,100293,3.1
MT1312260000000,13,12260,"Augusta-Richmond County, GA-SC MSA",2022,11,264043,254214,9829,3.7
MT1315260000000,13,15260,"Brunswick-St. Simons, GA MSA",2022,11,53311,51677,1634,3.1
MT1317980000000,13,17980,"Columbus, GA-AL MSA",2022,11,128507,123650,4857,3.8
MT1319140000000,13,19140,"Dalton, GA MSA",2022,11,66573,64048,2525,3.8
MT1323580000000,13,23580,"Gainesville, GA MSA",2022,11,105041,102173,2868,2.7
MT1325980000000,13,25980,"Hinesville, GA MSA",2022,11,31034,29823,1211,3.9
MT1331420000000,13,31420,"Macon-Bibb County, GA MSA",2022,11,96967,93270,3697,3.8
MT1340660000000,13,40660,"Rome, GA MSA",2022,11,45622,44133,1489,3.3
MT1342340000000,13,42340,"Savannah, GA MSA",2022,11,204007,197807,6200,3
MT1346660000000,13,46660,"Valdosta, GA MSA",2022,11,60439,58235,2204,3.6
MT1347580000000,13,47580,"Warner Robins, GA MSA",2022,11,87967,85053,2914,3.3
MT1527980000000,15,27980,"Kahului-Wailuku, HI MSA",2022,11,83835,81170,2665,3.2
MT1546520000000,15,46520,"Urban Honolulu, HI MSA",2022,11,468349,453267,15082,3.2
MT1614260000000,16,14260,"Boise City, ID MSA",2022,11,428373,417069,11304,2.6
MT1617660000000,16,17660,"Coeur d'Alene, ID MSA",2022,11,87007,83866,3141,3.6
MT1626820000000,16,26820,"Idaho Falls, ID MSA",2022,11,80813,78770,2043,2.5
MT1630300000000,16,30300,"Lewiston, ID-WA MSA",2022,11,30420,29476,944,3.1
MT1638540000000,16,38540,"Pocatello, ID MSA",2022,11,39609,38355,1254,3.2
MT1646300000000,16,46300,"Twin Falls, ID MSA",2022,11,58158,56480,1678,2.9
MT1714010000000,17,14010,"Bloomington, IL MSA",2022,11,91757,88617,3140,3.4
MT1716580000000,17,16580,"Champaign-Urbana, IL MSA",2022,11,121716,117045,4671,3.8
MT1716980000000,17,16980,"Chicago-Naperville-Elgin, IL-IN MSA",2022,11,4865735,4646078,219657,4.5
MT1719340000000,17,19340,"Davenport-Moline-Rock Island, IA-IL MSA",2022,11,188966,181654,7312,3.9
MT1719500000000,17,19500,"Decatur, IL MSA",2022,11,44946,42522,2424,5.4
MT1728100000000,17,28100,"Kankakee, IL MSA",2022,11,49968,47163,2805,5.6
MT1737900000000,17,37900,"Peoria, IL MSA",2022,11,171780,164121,7659,4.5
MT1740420000000,17,40420,"Rockford, IL MSA",2022,11,158225,149555,8670,5.5
MT1744100000000,17,44100,"Springfield, IL MSA",2022,11,101572,97403,4169,4.1
MT1814020000000,18,14020,"Bloomington, IN MSA",2022,11,83656,81295,2361,2.8
MT1818020000000,18,18020,"Columbus, IN MSA",2022,11,39430,38309,1121,2.8
MT1821140000000,18,21140,"Elkhart-Goshen, IN MSA",2022,11,105397,101650,3747,3.6
MT1821780000000,18,21780,"Evansville, IN MSA",2022,11,134330,130269,4061,3
MT1823060000000,18,23060,"Fort Wayne, IN MSA",2022,11,228550,222059,6491,2.8
MT1826900000000,18,26900,"Indianapolis-Carmel-Greenwood, IN MSA",2022,11,1104872,1072761,32111,2.9
MT1829020000000,18,29020,"Kokomo, IN MSA",2022,11,35576,33927,1649,4.6
MT1829200000000,18,29200,"Lafayette-West Lafayette, IN MSA",2022,11,118259,114966,3293,2.8
MT1833140000000,18,33140,"Michigan City-La Porte, IN MSA",2022,11,50827,48935,1892,3.7
MT1834620000000,18,34620,"Muncie, IN MSA",2022,11,51478,49632,1846,3.6
MT1843780000000,18,43780,"South Bend-Mishawaka, IN-MI MSA",2022,11,154564,148595,5969,3.9
MT1845460000000,18,45460,"Terre Haute, IN MSA",2022,11,76287,73562,2725,3.6
MT1911180000000,19,11180,"Ames, IA MSA",2022,11,69437,67768,1669,2.4
MT1916300000000,19,16300,"Cedar Rapids, IA MSA",2022,11,149421,144600,4821,3.2
MT1919780000000,19,19780,"Des Moines-West Des Moines, IA MSA",2022,11,402842,391576,11266,2.8
MT1920220000000,19,20220,"Dubuque, IA MSA",2022,11,54020,52244,1776,3.3
MT1926980000000,19,26980,"Iowa City, IA MSA",2022,11,98951,96486,2465,2.5
MT1943580000000,19,43580,"Sioux City, IA-NE-SD MSA",2022,11,76995,74775,2220,2.9
MT1947940000000,19,47940,"Waterloo-Cedar Falls, IA MSA",2022,11,88950,86270,2680,3
MT2029940000000,20,29940,"Lawrence, KS MSA",2022,11,69248,67375,1873,2.7
MT2031740000000,20,31740,"Manhattan, KS MSA",2022,11,63123,61271,1852,2.9
MT2045820000000,20,45820,"Topeka, KS MSA",2022,11,117177,113603,3574,3.1
MT2048620000000,20,48620,"Wichita, KS MSA",2022,11,327453,317267,10186,3.1
MT2114540000000,21,14540,"Bowling Green, KY MSA",2022,11,89597,86198,3399,3.8
MT2121060000000,21,21060,"Elizabethtown, KY MSA",2022,11,53243,50920,2323,4.4
MT2130460000000,21,30460,"Lexington-Fayette, KY MSA",2022,11,268971,259867,9104,3.4
MT2131140000000,21,31140,"Louisville/Jefferson County, KY-IN MSA",2022,11,685214,660640,24574,3.6
MT2136980000000,21,36980,"Owensboro, KY MSA",2022,11,50987,48768,2219,4.4
MT2137140000000,21,37140,"Paducah, KY-IL MSA",2022,11,45243,43281,1962,4.3
MT2210780000000,22,10780,"Alexandria, LA MSA",2022,11,64848,62743,2105,3.2
MT2212940000000,22,12940,"Baton Rouge, LA MSA",2022,11,418448,404145,14303,3.4
MT2225220000000,22,25220,"Hammond, LA MSA",2022,11,59361,56991,2370,4
MT2226380000000,22,26380,"Houma-Bayou Cane-Thibodaux, LA MSA",2022,11,86997,84174,2823,3.2
MT2229180000000,22,29180,"Lafayette, LA MSA",2022,11,196359,190395,5964,3
MT2229340000000,22,29340,"Lake Charles, LA MSA",2022,11,98626,95005,3621,3.7
MT2233740000000,22,33740,"Monroe, LA MSA",2022,11,96149,92391,3758,3.9
MT2235380000000,22,35380,"New Orleans-Metairie, LA MSA",2022,11,467924,451159,16765,3.6
MT2243340000000,22,43340,"Shreveport-Bossier City, LA MSA",2022,11,168392,162379,6013,3.6
MT2243640000000,22,43640,"Slidell-Mandeville-Covington, LA MSA",2022,11,127473,123835,3638,2.9
MT2312620000000,23,12620,"Bangor, ME MSA",2022,11,73089,71008,2081,2.8
MT2330340000000,23,30340,"Lewiston-Auburn, ME MSA",2022,11,53705,52239,1466,2.7
MT2338860000000,23,38860,"Portland-South Portland, ME MSA",2022,11,302365,295883,6482,2.1
MT2412580000000,24,12580,"Baltimore-Columbia-Towson, MD MSA",2022,11,1459501,1420601,38900,2.7
MT2425180000000,24,25180,"Hagerstown-Martinsburg, MD-WV MSA",2022,11,141518,137458,4060,2.9
MT2430500000000,24,30500,"Lexington Park, MD MSA",2022,11,104811,102165,2646,2.5
MT2441540000000,24,41540,"Salisbury, MD MSA",2022,11,61923,60012,1911,3.1
MT2511200000000,25,11200,"Amherst Town-Northampton, MA MSA",2022,11,83215,80324,2891,3.5
MT2512700000000,25,12700,"Barnstable Town, MA MSA",2022,11,113507,108184,5323,4.7
MT2514460000000,25,14460,"Boston-Cambridge-Newton, MA-NH MSA",2022,11,2737317,2649559,87758,3.2
MT2538340000000,25,38340,"Pittsfield, MA MSA",2022,11,63255,60615,2640,4.2
MT2544140000000,25,44140,"Springfield, MA MSA",2022,11,221197,210791,10406,4.7
MT2549340000000,25,49340,"Worcester, MA MSA",2022,11,451739,434760,16979,3.8
MT2611460000000,26,11460,"Ann Arbor, MI MSA",2022,11,200875,193933,6942,3.5
MT2612980000000,26,12980,"Battle Creek, MI MSA",2022,11,60597,57749,2848,4.7
MT2613020000000,26,13020,"Bay City, MI MSA",2022,11,48816,46226,2590,5.3
MT2619820000000,26,19820,"Detroit-Warren-Dearborn, MI MSA",2022,11,2119120,2041899,77221,3.6
MT2622420000000,26,22420,"Flint, MI MSA",2022,11,183348,173616,9732,5.3
MT2624340000000,26,24340,"Grand Rapids-Wyoming-Kentwood, MI MSA",2022,11,609530,587871,21659,3.6
MT2627100000000,26,27100,"Jackson, MI MSA",2022,11,73600,70308,3292,4.5
MT2628020000000,26,28020,"Kalamazoo-Portage, MI MSA",2022,11,135368,130202,5166,3.8
MT2629620000000,26,29620,"Lansing-East Lansing, MI MSA",2022,11,243280,233206,10074,4.1
MT2633220000000,26,33220,"Midland, MI MSA",2022,11,40447,38691,1756,4.3
MT2633780000000,26,33780,"Monroe, MI MSA",2022,11,74822,71351,3471,4.6
MT2634740000000,26,34740,"Muskegon-Norton Shores, MI MSA",2022,11,82032,78132,3900,4.8
MT2635660000000,26,35660,"Niles, MI MSA",2022,11,74182,70842,3340,4.5
MT2640980000000,26,40980,"Saginaw, MI MSA",2022,11,83202,78618,4584,5.5
MT2645900000000,26,45900,"Traverse City, MI MSA",2022,11,79013,75669,3344,4.2
MT2720260000000,27,20260,"Duluth, MN-WI MSA",2022,11,138754,133999,4755,3.4
MT2731860000000,27,31860,"Mankato, MN MSA",2022,11,59382,58036,1346,2.3
MT2733460000000,27,33460,"Minneapolis-St. Paul-Bloomington, MN-WI MSA",2022,11,2040253,1989205,51048,2.5
MT2740340000000,27,40340,"Rochester, MN MSA",2022,11,124273,121399,2874,2.3
MT2741060000000,27,41060,"St. Cloud, MN MSA",2022,11,108801,105625,3176,2.9
MT2825060000000,28,25060,"Gulfport-Biloxi, MS MSA",2022,11,182477,176274,6203,3.4
MT2825620000000,28,25620,"Hattiesburg, MS MSA",2022,11,69919,67646,2273,3.3
MT2827140000000,28,27140,"Jackson, MS MSA",2022,11,276167,267269,8898,3.2
MT2916020000000,29,16020,"Cape Girardeau, MO-IL MSA",2022,11,48125,46854,1271,2.6
MT2917860000000,29,17860,"Columbia, MO MSA",2022,11,113222,110636,2586,2.3
MT2927620000000,29,27620,"Jefferson City, MO MSA",2022,11,73613,71858,1755,2.4
MT2927900000000,29,27900,"Joplin, MO-KS MSA",2022,11,95635,93097,2538,2.7
MT2928140000000,29,28140,"Kansas City, MO-KS MSA",2022,11,1167344,1134420,32924,2.8
MT2941140000000,29,41140,"St. Joseph, MO-KS MSA",2022,11,53625,52077,1548,2.9
MT2941180000000,29,41180,"St. Louis, MO-IL MSA",2022,11,1451983,1409098,42885,3
MT2944180000000,29,44180,"Springfield, MO MSA",2022,11,236221,230476,5745,2.4
MT3013740000000,30,13740,"Billings, MT MSA",2022,11,98692,96482,2210,2.2
MT3014580000000,30,14580,"Bozeman, MT MSA",2022,11,75523,74121,1402,1.9
MT3024500000000,30,24500,"Great Falls, MT MSA",2022,11,39784,38790,994,2.5
MT3025740000000,30,25740,"Helena, MT MSA",2022,11,46991,45871,1120,2.4
MT3033540000000,30,33540,"Missoula, MT MSA",2022,11,72643,70957,1686,2.3
MT3124260000000,31,24260,"Grand Island, NE MSA",2022,11,41766,40851,915,2.2
MT3130700000000,31,30700,"Lincoln, NE MSA",2022,11,189762,185823,3939,2.1
MT3136540000000,31,36540,"Omaha, NE-IA MSA",2022,11,516222,503593,12629,2.4
MT3216180000000,32,16180,"Carson City, NV MSA",2022,11,28307,27049,1258,4.4
MT3229820000000,32,29820,"Las Vegas-Henderson-North Las Vegas, NV MSA",2022,11,1169744,1105979,63765,5.5
MT3239900000000,32,39900,"Reno, NV MSA",2022,11,291924,279056,12868,4.4
MT3331700000000,33,31700,"Manchester-Nashua, NH MSA",2022,11,239648,233314,6334,2.6
MT3412100000000,34,12100,"Atlantic City-Hammonton, NJ MSA",2022,11,179399,170223,9176,5.1
MT3445940000000,34,45940,"Trenton-Princeton, NJ MSA",2022,11,198005,191169,6836,3.5
MT3447220000000,34,47220,"Vineland, NJ MSA",2022,11,65448,61863,3585,5.5
MT3510740000000,35,10740,"Albuquerque, NM MSA",2022,11,450001,435901,14100,3.1
MT3522140000000,35,22140,"Farmington, NM MSA",2022,11,48533,46535,1998,4.1
MT3529740000000,35,29740,"Las Cruces, NM MSA",2022,11,97776,93717,4059,4.2
MT3542140000000,35,42140,"Santa Fe, NM MSA",2022,11,72454,70199,2255,3.1
MT3610580000000,36,10580,"Albany-Schenectady-Troy, NY MSA",2022,11,451913,438341,13572,3
MT3613780000000,36,13780,"Binghamton, NY MSA",2022,11,105720,101974,3746,3.5
MT3615380000000,36,15380,"Buffalo-Cheektowaga, NY MSA",2022,11,554423,535263,19160,3.5
MT3621300000000,36,21300,"Elmira, NY MSA",2022,11,35263,33997,1266,3.6
MT3624020000000,36,24020,"Glens Falls, NY MSA",2022,11,59256,57360,1896,3.2
MT3627060000000,36,27060,"Ithaca, NY MSA",2022,11,48254,46800,1454,3
MT3628740000000,36,28740,"Kingston, NY MSA",2022,11,85842,83160,2682,3.1
MT3628880000000,36,28880,"Kiryas Joel-Poughkeepsie-Newburgh, NY MSA",2022,11,333413,323106,10307,3.1
MT3635620000000,36,35620,"New York-Newark-Jersey City, NY-NJ MSA",2022,11,9988945,9590986,397959,4
MT3640380000000,36,40380,"Rochester, NY MSA",2022,11,509279,492605,16674,3.3
MT3645060000000,36,45060,"Syracuse, NY MSA",2022,11,309594,299263,10331,3.3
MT3646540000000,36,46540,"Utica-Rome, NY MSA",2022,11,127334,122808,4526,3.6
MT3648060000000,36,48060,"Watertown-Fort Drum, NY MSA",2022,11,44698,42898,1800,4
MT3711700000000,37,11700,"Asheville, NC MSA",2022,11,208324,201879,6445,3.1
MT3715500000000,37,15500,"Burlington, NC MSA",2022,11,83588,80425,3163,3.8
MT3716740000000,37,16740,"Charlotte-Concord-Gastonia, NC-SC MSA",2022,11,1445275,1394655,50620,3.5
MT3720500000000,37,20500,"Durham-Chapel Hill, NC MSA",2022,11,316220,305915,10305,3.3
MT3722180000000,37,22180,"Fayetteville, NC MSA",2022,11,153238,145884,7354,4.8
MT3724140000000,37,24140,"Goldsboro, NC MSA",2022,11,49841,47919,1922,3.9
MT3724660000000,37,24660,"Greensboro-High Point, NC MSA",2022,11,373432,358385,15047,4
MT3724780000000,37,24780,"Greenville, NC MSA",2022,11,82565,79053,3512,4.3
MT3725860000000,37,25860,"Hickory-Lenoir-Morganton, NC MSA",2022,11,172800,166874,5926,3.4
MT3727340000000,37,27340,"Jacksonville, NC MSA",2022,11,72952,70109,2843,3.9
MT3738240000000,37,38240,"Pinehurst-Southern Pines, NC MSA",2022,11,43566,41992,1574,3.6
MT3739580000000,37,39580,"Raleigh-Cary, NC MSA",2022,11,815363,790233,25130,3.1
MT3740580000000,37,40580,"Rocky Mount, NC MSA",2022,11,63472,60063,3409,5.4
MT3748900000000,37,48900,"Wilmington, NC MSA",2022,11,217367,209264,8103,3.7
MT3749180000000,37,49180,"Winston-Salem, NC MSA",2022,11,324948,312871,12077,3.7
MT3813900000000,38,13900,"Bismarck, ND MSA",2022,11,72135,70712,1423,2
MT3822020000000,38,22020,"Fargo, ND-MN MSA",2022,11,150364,147601,2763,1.8
MT3824220000000,38,24220,"Grand Forks, ND-MN MSA",2022,11,54748,53552,1196,2.2
MT3833500000000,38,33500,"Minot, ND MSA",2022,11,39382,38547,835,2.1
MT3910420000000,39,10420,"Akron, OH MSA",2022,11,356030,342151,13879,3.9
MT3915940000000,39,15940,"Canton-Massillon, OH MSA",2022,11,189120,181276,7844,4.1
MT3917140000000,39,17140,"Cincinnati, OH-KY-IN MSA",2022,11,1150639,1110192,40447,3.5
MT3917410000000,39,17410,"Cleveland, OH MSA",2022,11,1076404,1031068,45336,4.2
MT3918140000000,39,18140,"Columbus, OH MSA",2022,11,1117310,1078562,38748,3.5
MT3919430000000,39,19430,"Dayton-Kettering-Beavercreek, OH MSA",2022,11,382937,368140,14797,3.9
MT3930620000000,39,30620,"Lima, OH MSA",2022,11,47284,45363,1921,4.1
MT3931900000000,39,31900,"Mansfield, OH MSA",2022,11,52012,49664,2348,4.5
MT3941780000000,39,41780,"Sandusky, OH MSA",2022,11,56069,53390,2679,4.8
MT3944220000000,39,44220,"Springfield, OH MSA",2022,11,61133,58694,2439,4
MT3945780000000,39,45780,"Toledo, OH MSA",2022,11,290396,277994,12402,4.3
MT3948260000000,39,48260,"Weirton-Steubenville, WV-OH MSA",2022,11,52232,49717,2515,4.8
MT3949660000000,39,49660,"Youngstown-Warren, OH MSA",2022,11,189893,181123,8770,4.6
MT4021420000000,40,21420,"Enid, OK MSA",2022,11,28103,27297,806,2.9
MT4030020000000,40,30020,"Lawton, OK MSA",2022,11,51014,49203,1811,3.6
MT4036420000000,40,36420,"Oklahoma City, OK MSA",2022,11,740116,719077,21039,2.8
MT4046140000000,40,46140,"Tulsa, OK MSA",2022,11,502610,487024,15586,3.1
MT4110540000000,41,10540,"Albany, OR MSA",2022,11,60833,58077,2756,4.5
MT4113460000000,41,13460,"Bend, OR MSA",2022,11,126977,121471,5506,4.3
MT4118700000000,41,18700,"Corvallis, OR MSA",2022,11,48498,46733,1765,3.6
MT4121660000000,41,21660,"Eugene-Springfield, OR MSA",2022,11,185389,177069,8320,4.5
MT4124420000000,41,24420,"Grants Pass, OR MSA",2022,11,34925,32844,2081,6
MT4132780000000,41,32780,"Medford, OR MSA",2022,11,103992,98794,5198,5
MT4138900000000,41,38900,"Portland-Vancouver-Hillsboro, OR-WA MSA",2022,11,1369209,1318098,51111,3.7
MT4141420000000,41,41420,"Salem, OR MSA",2022,11,214750,205827,8923,4.2
MT4210900000000,42,10900,"Allentown-Bethlehem-Easton, PA-NJ MSA",2022,11,445359,427478,17881,4
MT4211020000000,42,11020,"Altoona, PA MSA",2022,11,56674,54310,2364,4.2
MT4216540000000,42,16540,"Chambersburg, PA MSA",2022,11,76867,74216,2651,3.4
MT4221500000000,42,21500,"Erie, PA MSA",2022,11,125299,119607,5692,4.5
MT4223900000000,42,23900,"Gettysburg, PA MSA",2022,11,52160,50486,1674,3.2
MT4225420000000,42,25420,"Harrisburg-Carlisle, PA MSA",2022,11,308092,297566,10526,3.4
MT4227780000000,42,27780,"Johnstown, PA MSA",2022,11,56886,54146,2740,4.8
MT4229540000000,42,29540,"Lancaster, PA MSA",2022,11,289188,280140,9048,3.1
MT4230140000000,42,30140,"Lebanon, PA MSA",2022,11,71608,69184,2424,3.4
MT4237980000000,42,37980,"Philadelphia-Camden-Wilmington, PA-NJ-DE-MD MSA",2022,11,3245390,3123095,122295,3.8
MT4238300000000,42,38300,"Pittsburgh, PA MSA",2022,11,1221305,1170950,50355,4.1
MT4239740000000,42,39740,"Reading, PA MSA",2022,11,216427,208151,8276,3.8
MT4242540000000,42,42540,"Scranton--Wilkes-Barre, PA MSA",2022,11,276215,263343,12872,4.7
MT4244300000000,42,44300,"State College, PA MSA",2022,11,76370,73892,2478,3.2
MT4248700000000,42,48700,"Williamsport, PA MSA",2022,11,52062,49734,2328,4.5
MT4249620000000,42,49620,"York-Hanover, PA MSA",2022,11,236383,228192,8191,3.5
MT4439300000000,44,39300,"Providence-Warwick, RI-MA MSA",2022,11,872030,841085,30945,3.5
MT4516700000000,45,16700,"Charleston-North Charleston, SC MSA",2022,11,417919,406507,11412,2.7
MT4517900000000,45,17900,"Columbia, SC MSA",2022,11,400701,388476,12225,3.1
MT4522500000000,45,22500,"Florence, SC MSA",2022,11,90122,87078,3044,3.4
MT4524860000000,45,24860,"Greenville-Anderson-Greer, SC MSA",2022,11,460052,447104,12948,2.8
MT4525940000000,45,25940,"Hilton Head Island-Bluffton-Port Royal, SC MSA",2022,11,94380,91647,2733,2.9
MT4534820000000,45,34820,"Myrtle Beach-Conway-North Myrtle Beach, SC MSA",2022,11,163235,157102,6133,3.8
MT4543900000000,45,43900,"Spartanburg, SC MSA",2022,11,168691,163204,5487,3.3
MT4544940000000,45,44940,"Sumter, SC MSA",2022,11,41296,39647,1649,4
MT4639660000000,46,39660,"Rapid City, SD MSA",2022,11,77900,76417,1483,1.9
MT4643620000000,46,43620,"Sioux Falls, SD-MN MSA",2022,11,168750,165848,2902,1.7
MT4716860000000,47,16860,"Chattanooga, TN-GA MSA",2022,11,279512,270649,8863,3.2
MT4717300000000,47,17300,"Clarksville, TN-KY MSA",2022,11,134287,129038,5249,3.9
MT4717420000000,47,17420,"Cleveland, TN MSA",2022,11,55817,53764,2053,3.7
MT4727180000000,47,27180,"Jackson, TN MSA",2022,11,77656,74764,2892,3.7
MT4727740000000,47,27740,"Johnson City, TN MSA",2022,11,95464,92186,3278,3.4
MT4728700000000,47,28700,"Kingsport-Bristol, TN-VA MSA",2022,11,130700,126056,4644,3.6
MT4728940000000,47,28940,"Knoxville, TN MSA",2022,11,440422,426551,13871,3.1
MT4732820000000,47,32820,"Memphis, TN-MS-AR MSA",2022,11,625827,600614,25213,4
MT4734100000000,47,34100,"Morristown, TN MSA",2022,11,52618,50691,1927,3.7
MT4734980000000,47,34980,"Nashville-Davidson--Murfreesboro--Franklin, TN MSA",2022,11,1126912,1095681,31231,2.8
MT4810180000000,48,10180,"Abilene, TX MSA",2022,11,83044,80060,2984,3.6
MT4811100000000,48,11100,"Amarillo, TX MSA",2022,11,132153,127991,4162,3.1
MT4812420000000,48,12420,"Austin-Round Rock-San Marcos, TX MSA",2022,11,1418829,1374842,43987,3.1
MT4813140000000,48,13140,"Beaumont-Port Arthur, TX MSA",2022,11,172888,163270,9618,5.6
MT4815180000000,48,15180,"Brownsville-Harlingen, TX MSA",2022,11,182202,172106,10096,5.5
MT4817780000000,48,17780,"College Station-Bryan, TX MSA",2022,11,142677,137625,5052,3.5
MT4818580000000,48,18580,"Corpus Christi, TX MSA",2022,11,201381,191916,9465,4.7
MT4819100000000,48,19100,"Dallas-Fort Worth-Arlington, TX MSA",2022,11,4292651,4136212,156439,3.6
MT4820580000000,48,20580,"Eagle Pass, TX MSA",2022,11,23418,21581,1837,7.8
MT4821340000000,48,21340,"El Paso, TX MSA",2022,11,391103,374647,16456,4.2
MT4826420000000,48,26420,"Houston-Pasadena-The Woodlands, TX MSA",2022,11,3648589,3496614,151975,4.2
MT4828660000000,48,28660,"Killeen-Temple, TX MSA",2022,11,194971,186473,8498,4.4
MT4829700000000,48,29700,"Laredo, TX MSA",2022,11,112575,107915,4660,4.1
MT4830980000000,48,30980,"Longview, TX MSA",2022,11,127266,121758,5508,4.3
MT4831180000000,48,31180,"Lubbock, TX MSA",2022,11,176585,170276,6309,3.6
MT4832580000000,48,32580,"McAllen-Edinburg-Mission, TX MSA",2022,11,381276,356840,24436,6.4
MT4833260000000,48,33260,"Midland, TX MSA",2022,11,96238,93340,2898,3
MT4836220000000,48,36220,"Odessa, TX MSA",2022,11,81293,78350,2943,3.6
MT4841660000000,48,41660,"San Angelo, TX MSA",2022,11,59510,57618,1892,3.2
MT4841700000000,48,41700,"San Antonio-New Braunfels, TX MSA",2022,11,1272693,1225459,47234,3.7
MT4843300000000,48,43300,"Sherman-Denison, TX MSA",2022,11,67779,65192,2587,3.8
MT4845500000000,48,45500,"Texarkana, TX-AR MSA",2022,11,60360,57802,2558,4.2
MT4846340000000,48,46340,"Tyler, TX MSA",2022,11,113110,108897,4213,3.7
MT4847020000000,48,47020,"Victoria, TX MSA",2022,11,44321,42506,1815,4.1
MT4847380000000,48,47380,"Waco, TX MSA",2022,11,140368,134965,5403,3.8
MT4848660000000,48,48660,"Wichita Falls, TX MSA",2022,11,65584,63149,2435,3.7
MT4930860000000,49,30860,"Logan, UT-ID MSA",2022,11,78895,77080,1815,2.3
MT4936260000000,49,36260,"Ogden, UT MSA",2022,11,338016,330060,7956,2.4
MT4939340000000,49,39340,"Provo-Orem-Lehi, UT MSA",2022,11,357834,349185,8649,2.4
MT4941100000000,49,41100,"St. George, UT MSA",2022,11,87730,85291,2439,2.8
MT4941620000000,49,41620,"Salt Lake City-Murray, UT MSA",2022,11,713939,696145,17794,2.5
MT5015540000000,50,15540,"Burlington-South Burlington, VT MSA",2022,11,127179,124803,2376,1.9
MT5113980000000,51,13980,"Blacksburg-Christiansburg-Radford, VA MSA",2022,11,91418,88720,2698,3
MT5116820000000,51,16820,"Charlottesville, VA MSA",2022,11,116416,113362,3054,2.6
MT5125500000000,51,25500,"Harrisonburg, VA MSA",2022,11,71730,69782,1948,2.7
MT5131340000000,51,31340,"Lynchburg, VA MSA",2022,11,127282,123306,3976,3.1
MT5140060000000,51,40060,"Richmond, VA MSA",2022,11,709992,689384,20608,2.9
MT5140220000000,51,40220,"Roanoke, VA MSA",2022,11,155809,151366,4443,2.9
MT5144420000000,51,44420,"Staunton-Stuarts Draft, VA MSA",2022,11,65028,63406,1622,2.5
MT5147260000000,51,47260,"Virginia Beach-Chesapeake-Norfolk, VA-NC MSA",2022,11,866282,839249,27033,3.1
MT5149020000000,51,49020,"Winchester, VA-WV MSA",2022,11,75644,73608,2036,2.7
MT5313380000000,53,13380,"Bellingham, WA MSA",2022,11,114564,109877,4687,4.1
MT5314740000000,53,14740,"Bremerton-Silverdale-Port Orchard, WA MSA",2022,11,121776,116833,4943,4.1
MT5328420000000,53,28420,"Kennewick-Richland, WA MSA",2022,11,145285,138364,6921,4.8
MT5331020000000,53,31020,"Longview-Kelso, WA MSA",2022,11,47596,45228,2368,5
MT5334580000000,53,34580,"Mount Vernon-Anacortes, WA MSA",2022,11,57721,55081,2640,4.6
MT5336500000000,53,36500,"Olympia-Lacey-Tumwater, WA MSA",2022,11,140420,134557,5863,4.2
MT5342660000000,53,42660,"Seattle-Tacoma-Bellevue, WA MSA",2022,11,2264741,2175110,89631,4
MT5344060000000,53,44060,"Spokane-Spokane Valley, WA MSA",2022,11,281051,268768,12283,4.4
MT5347460000000,53,47460,"Walla Walla, WA MSA",2022,11,29610,28458,1152,3.9
MT5348300000000,53,48300,"Wenatchee-East Wenatchee, WA MSA",2022,11,62287,59427,2860,4.6
MT5349420000000,53,49420,"Yakima, WA MSA",2022,11,127660,120090,7570,5.9
MT5413220000000,54,13220,"Beckley, WV MSA",2022,11,45272,43586,1686,3.7
MT5416620000000,54,16620,"Charleston, WV MSA",2022,11,89463,86220,3243,3.6
MT5426580000000,54,26580,"Huntington-Ashland, WV-KY-OH MSA",2022,11,154695,147948,6747,4.4
MT5434060000000,54,34060,"Morgantown, WV MSA",2022,11,70644,68282,2362,3.3
MT5437620000000,54,37620,"Parkersburg-Vienna, WV MSA",2022,11,38998,37434,1564,4
MT5448540000000,54,48540,"Wheeling, WV-OH MSA",2022,11,59020,56240,2780,4.7
MT5511540000000,55,11540,"Appleton, WI MSA",2022,11,135558,132554,3004,2.2
MT5520740000000,55,20740,"Eau Claire, WI MSA",2022,11,93868,91343,2525,2.7
MT5522540000000,55,22540,"Fond du Lac, WI MSA",2022,11,55712,54381,1331,2.4
MT5524580000000,55,24580,"Green Bay, WI MSA",2022,11,176465,172118,4347,2.5
MT5527500000000,55,27500,"Janesville-Beloit, WI MSA",2022,11,84584,81936,2648,3.1
MT5528450000000,55,28450,"Kenosha, WI MSA",2022,11,92803,90100,2703,2.9
MT5529100000000,55,29100,"La Crosse-Onalaska, WI-MN MSA",2022,11,89010,86831,2179,2.4
MT5531540000000,55,31540,"Madison, WI MSA",2022,11,396799,388503,8296,2.1
MT5533340000000,55,33340,"Milwaukee-Waukesha, WI MSA",2022,11,808730,785699,23031,2.8
MT5536780000000,55,36780,"Oshkosh-Neenah, WI MSA",2022,11,92050,89883,2167,2.4
MT5539540000000,55,39540,"Racine-Mount Pleasant, WI MSA",2022,11,100010,96921,3089,3.1
MT5543100000000,55,43100,"Sheboygan, WI MSA",2022,11,61931,60512,1419,2.3
MT5548140000000,55,48140,"Wausau, WI MSA",2022,11,74150,72445,1705,2.3
MT5616220000000,56,16220,"Casper, WY MSA",2022,11,41898,40433,1465,3.5
MT5616940000000,56,16940,"Cheyenne, WY MSA",2022,11,48480,46806,1674,3.5
MT7210380000000,72,10380,"Aguadilla, PR MSA",2022,11,86573,79873,6700,7.7
MT7211640000000,72,11640,"Arecibo, PR MSA",2022,11,65060,60415,4645,7.1
MT7225020000000,72,25020,"Guayama, PR MSA",2022,11,18607,16972,1635,8.8
MT7232420000000,72,32420,"Mayaguez, PR MSA",2022,11,65668,60728,4940,7.5
MT7238660000000,72,38660,"Ponce, PR MSA",2022,11,87914,79908,8006,9.1
MT7241980000000,72,41980,"San Juan-Bayamon-Caguas, PR MSA",2022,11,800798,760896,39902,5
MT0111500000000,1,11500,"Anniston-Oxford, AL MSA",2022,12,49145,47994,1151,2.3
MT0112220000000,1,12220,"Auburn-Opelika, AL MSA",2022,12,92292,90274,2018,2.2
MT0113820000000,1,13820,"Birmingham, AL MSA",2022,12,557037,545243,11794,2.1
MT0119300000000,1,19300,"Daphne-Fairhope-Foley, AL MSA",2022,12,111774,109618,2156,1.9
MT0119460000000,1,19460,"Decatur, AL MSA",2022,12,73154,71763,1391,1.9
MT0120020000000,1,20020,"Dothan, AL MSA",2022,12,66429,64932,1497,2.3
MT0122520000000,1,22520,"Florence-Muscle Shoals, AL MSA",2022,12,67180,65548,1632,2.4
MT0123460000000,1,23460,"Gadsden, AL MSA",2022,12,40849,39862,987,2.4
MT0126620000000,1,26620,"Huntsville, AL MSA",2022,12,261037,256189,4848,1.9
MT0133660000000,1,33660,"Mobile, AL MSA",2022,12,182144,176792,5352,2.9
MT0133860000000,1,33860,"Montgomery, AL MSA",2022,12,172215,167832,4383,2.5
MT0146220000000,1,46220,"Tuscaloosa, AL MSA",2022,12,122537,119558,2979,2.4
MT0211260000000,2,11260,"Anchorage, AK MSA",2022,12,198302,191271,7031,3.5
MT0221820000000,2,21820,"Fairbanks-College, AK MSA",2022,12,44770,43173,1597,3.6
MT0422380000000,4,22380,"Flagstaff, AZ MSA",2022,12,73098,70097,3001,4.1
MT0429420000000,4,29420,"Lake Havasu City-Kingman, AZ MSA",2022,12,85915,82004,3911,4.6
MT0438060000000,4,38060,"Phoenix-Mesa-Chandler, AZ MSA",2022,12,2611933,2529601,82332,3.2
MT0439150000000,4,39150,"Prescott Valley-Prescott, AZ MSA",2022,12,104666,100973,3693,3.5
MT0443420000000,4,43420,"Sierra Vista-Douglas, AZ MSA",2022,12,47701,45541,2160,4.5
MT0446060000000,4,46060,"Tucson, AZ MSA",2022,12,488652,471058,17594,3.6
MT0449740000000,4,49740,"Yuma, AZ MSA",2022,12,98728,86422,12306,12.5
MT0522220000000,5,22220,"Fayetteville-Springdale-Rogers, AR MSA",2022,12,293303,286660,6643,2.3
MT0522900000000,5,22900,"Fort Smith, AR-OK MSA",2022,12,100203,97471,2732,2.7
MT0526300000000,5,26300,"Hot Springs, AR MSA",2022,12,43621,42198,1423,3.3
MT0527860000000,5,27860,"Jonesboro, AR MSA",2022,12,64534,62829,1705,2.6
MT0530780000000,5,30780,"Little Rock-North Little Rock-Conway, AR MSA",2022,12,366769,356628,10141,2.8
MT0612540000000,6,12540,"Bakersfield-Delano, CA MSA",2022,12,396903,367025,29878,7.5
MT0617020000000,6,17020,"Chico, CA MSA",2022,12,90480,86096,4384,4.8
MT0620940000000,6,20940,"El Centro, CA MSA",2022,12,69656,57928,11728,16.8
MT0623420000000,6,23420,"Fresno, CA MSA",2022,12,517659,482611,35048,6.8
MT0625260000000,6,25260,"Hanford-Corcoran, CA MSA",2022,12,55547,51210,4337,7.8
MT0631080000000,6,31080,"Los Angeles-Long Beach-Anaheim, CA MSA",2022,12,6634519,6341595,292924,4.4
MT0632900000000,6,32900,"Merced, CA MSA",2022,12,116363,106706,9657,8.3
MT0633700000000,6,33700,"Modesto, CA MSA",2022,12,245966,231825,14141,5.7
MT0634900000000,6,34900,"Napa, CA MSA",2022,12,71876,69588,2288,3.2
MT0637100000000,6,37100,"Oxnard-Thousand Oaks-Ventura, CA MSA",2022,12,412759,397313,15446,3.7
MT0639820000000,6,39820,"Redding, CA MSA",2022,12,76686,73167,3519,4.6
MT0640140000000,6,40140,"Riverside-San Bernardino-Ontario, CA MSA",2022,12,2151162,2059804,91358,4.2
MT0640900000000,6,40900,"Sacramento-Roseville-Folsom, CA MSA",2022,12,1150004,1105891,44113,3.8
MT0641500000000,6,41500,"Salinas, CA MSA",2022,12,213781,199682,14099,6.6
MT0641740000000,6,41740,"San Diego-Chula Vista-Carlsbad, CA MSA",2022,12,1624046,1569721,54325,3.3
MT0641860000000,6,41860,"San Francisco-Oakland-Fremont, CA MSA",2022,12,2509844,2432888,76956,3.1
MT0641940000000,6,41940,"San Jose-Sunnyvale-Santa Clara, CA MSA",2022,12,1053495,1022952,30543,2.9
MT0642020000000,6,42020,"San Luis Obispo-Paso Robles, CA MSA",2022,12,131359,127087,4272,3.3
MT0642100000000,6,42100,"Santa Cruz-Watsonville, CA MSA",2022,12,134542,127832,6710,5
MT0642200000000,6,42200,"Santa Maria-Santa Barbara, CA MSA",2022,12,217589,209538,8051,3.7
MT0642220000000,6,42220,"Santa Rosa-Petaluma, CA MSA",2022,12,245088,237235,7853,3.2
MT0644700000000,6,44700,"Stockton-Lodi, CA MSA",2022,12,357780,338417,19363,5.4
MT0646700000000,6,46700,"Vallejo, CA MSA",2022,12,210423,201773,8650,4.1
MT0647300000000,6,47300,"Visalia, CA MSA",2022,12,212983,193842,19141,9
MT0649700000000,6,49700,"Yuba City, CA MSA",2022,12,78370,72984,5386,6.9
MT0814500000000,8,14500,"Boulder, CO MSA",2022,12,192345,187393,4952,2.6
MT0817820000000,8,17820,"Colorado Springs, CO MSA",2022,12,383781,372000,11781,3.1
MT0819740000000,8,19740,"Denver-Aurora-Centennial, CO MSA",2022,12,1750248,1700942,49306,2.8
MT0822660000000,8,22660,"Fort Collins-Loveland, CO MSA",2022,12,202561,197001,5560,2.7
MT0824300000000,8,24300,"Grand Junction, CO MSA",2022,12,78112,75544,2568,3.3
MT0824540000000,8,24540,"Greeley, CO MSA",2022,12,171025,165663,5362,3.1
MT0839380000000,8,39380,"Pueblo, CO MSA",2022,12,73865,70661,3204,4.3
MT0914860000000,9,14860,"Bridgeport-Stamford-Danbury, CT MSA",2022,12,504916,488368,16548,3.3
MT0925540000000,9,25540,"Hartford-West Hartford-East Hartford, CT MSA",2022,12,602288,581275,21013,3.5
MT0935300000000,9,35300,"New Haven, CT MSA",2022,12,308233,297547,10686,3.5
MT0935980000000,9,35980,"Norwich-New London-Willimantic, CT MSA",2022,12,139801,134878,4923,3.5
MT0947930000000,9,47930,"Waterbury-Shelton, CT MSA",2022,12,237678,228390,9288,3.9
MT1020100000000,10,20100,"Dover, DE MSA",2022,12,84417,80734,3683,4.4
MT1147900000000,11,47900,"Washington-Arlington-Alexandria, DC-VA-MD-WV MSA",2022,12,3479535,3388106,91429,2.6
MT1215980000000,12,15980,"Cape Coral-Fort Myers, FL MSA",2022,12,362823,349244,13579,3.7
MT1218880000000,12,18880,"Crestview-Fort Walton Beach-Destin, FL MSA",2022,12,140650,137259,3391,2.4
MT1219660000000,12,19660,"Deltona-Daytona Beach-Ormond Beach, FL MSA",2022,12,312986,302828,10158,3.2
MT1223540000000,12,23540,"Gainesville, FL MSA",2022,12,167301,162393,4908,2.9
MT1226140000000,12,26140,"Homosassa Springs, FL MSA",2022,12,53066,50962,2104,4
MT1227260000000,12,27260,"Jacksonville, FL MSA",2022,12,838461,814633,23828,2.8
MT1229460000000,12,29460,"Lakeland-Winter Haven, FL MSA",2022,12,349824,337899,11925,3.4
MT1233100000000,12,33100,"Miami-Fort Lauderdale-West Palm Beach, FL MSA",2022,12,3220813,3140400,80413,2.5
MT1234940000000,12,34940,"Naples-Marco Island, FL MSA",2022,12,176876,171448,5428,3.1
MT1235840000000,12,35840,"North Port-Bradenton-Sarasota, FL MSA",2022,12,381777,370621,11156,2.9
MT1236100000000,12,36100,"Ocala, FL MSA",2022,12,154312,149143,5169,3.3
MT1236740000000,12,36740,"Orlando-Kissimmee-Sanford, FL MSA",2022,12,1485584,1444416,41168,2.8
MT1237340000000,12,37340,"Palm Bay-Melbourne-Titusville, FL MSA",2022,12,298265,289807,8458,2.8
MT1237460000000,12,37460,"Panama City-Panama City Beach, FL MSA",2022,12,98884,96224,2660,2.7
MT1237860000000,12,37860,"Pensacola-Ferry Pass-Brent, FL MSA",2022,12,236973,230216,6757,2.9
MT1238940000000,12,38940,"Port St. Lucie, FL MSA",2022,12,233248,225884,7364,3.2
MT1239460000000,12,39460,"Punta Gorda, FL MSA",2022,12,74461,71532,2929,3.9
MT1242680000000,12,42680,"Sebastian-Vero Beach-West Vero Corridor, FL MSA",2022,12,66678,64391,2287,3.4
MT1242700000000,12,42700,"Sebring, FL MSA",2022,12,36102,34603,1499,4.2
MT1245220000000,12,45220,"Tallahassee, FL MSA",2022,12,202206,196310,5896,2.9
MT1245300000000,12,45300,"Tampa-St. Petersburg-Clearwater, FL MSA",2022,12,1667329,1621410,45919,2.8
MT1248680000000,12,48680,"Wildwood-The Villages, FL MSA",2022,12,32466,30891,1575,4.9
MT1310500000000,13,10500,"Albany, GA MSA",2022,12,63384,60860,2524,4
MT1312020000000,13,12020,"Athens-Clarke County, GA MSA",2022,12,103605,100377,3228,3.1
MT1312060000000,13,12060,"Atlanta-Sandy Springs-Roswell, GA MSA",2022,12,3226104,3124553,101551,3.1
MT1312260000000,13,12260,"Augusta-Richmond County, GA-SC MSA",2022,12,264577,254708,9869,3.7
MT1315260000000,13,15260,"Brunswick-St. Simons, GA MSA",2022,12,53459,51829,1630,3
MT1317980000000,13,17980,"Columbus, GA-AL MSA",2022,12,128686,123848,4838,3.8
MT1319140000000,13,19140,"Dalton, GA MSA",2022,12,66707,64173,2534,3.8
MT1323580000000,13,23580,"Gainesville, GA MSA",2022,12,105545,102671,2874,2.7
MT1325980000000,13,25980,"Hinesville, GA MSA",2022,12,31088,29876,1212,3.9
MT1331420000000,13,31420,"Macon-Bibb County, GA MSA",2022,12,97190,93490,3700,3.8
MT1340660000000,13,40660,"Rome, GA MSA",2022,12,45951,44450,1501,3.3
MT1342340000000,13,42340,"Savannah, GA MSA",2022,12,204746,198547,6199,3
MT1346660000000,13,46660,"Valdosta, GA MSA",2022,12,60360,58145,2215,3.7
MT1347580000000,13,47580,"Warner Robins, GA MSA",2022,12,88265,85385,2880,3.3
MT1527980000000,15,27980,"Kahului-Wailuku, HI MSA",2022,12,83981,81362,2619,3.1
MT1546520000000,15,46520,"Urban Honolulu, HI MSA",2022,12,468322,453692,14630,3.1
MT1614260000000,16,14260,"Boise City, ID MSA",2022,12,429446,418155,11291,2.6
MT1617660000000,16,17660,"Coeur d'Alene, ID MSA",2022,12,87240,84103,3137,3.6
MT1626820000000,16,26820,"Idaho Falls, ID MSA",2022,12,81261,79203,2058,2.5
MT1630300000000,16,30300,"Lewiston, ID-WA MSA",2022,12,30413,29492,921,3
MT1638540000000,16,38540,"Pocatello, ID MSA",2022,12,39670,38457,1213,3.1
MT1646300000000,16,46300,"Twin Falls, ID MSA",2022,12,58345,56648,1697,2.9
MT1714010000000,17,14010,"Bloomington, IL MSA",2022,12,91983,88829,3154,3.4
MT1716580000000,17,16580,"Champaign-Urbana, IL MSA",2022,12,121779,117074,4705,3.9
MT1716980000000,17,16980,"Chicago-Naperville-Elgin, IL-IN MSA",2022,12,4866534,4652140,214394,4.4
MT1719340000000,17,19340,"Davenport-Moline-Rock Island, IA-IL MSA",2022,12,189083,181745,7338,3.9
MT1719500000000,17,19500,"Decatur, IL MSA",2022,12,45028,42576,2452,5.4
MT1728100000000,17,28100,"Kankakee, IL MSA",2022,12,49988,47179,2809,5.6
MT1737900000000,17,37900,"Peoria, IL MSA",2022,12,171948,164186,7762,4.5
MT1740420000000,17,40420,"Rockford, IL MSA",2022,12,158241,149470,8771,5.5
MT1744100000000,17,44100,"Springfield, IL MSA",2022,12,101698,97525,4173,4.1
MT1814020000000,18,14020,"Bloomington, IN MSA",2022,12,84169,81795,2374,2.8
MT1818020000000,18,18020,"Columbus, IN MSA",2022,12,39494,38369,1125,2.8
MT1821140000000,18,21140,"Elkhart-Goshen, IN MSA",2022,12,104970,101037,3933,3.7
MT1821780000000,18,21780,"Evansville, IN MSA",2022,12,134490,130415,4075,3
MT1823060000000,18,23060,"Fort Wayne, IN MSA",2022,12,228699,222167,6532,2.9
MT1826900000000,18,26900,"Indianapolis-Carmel-Greenwood, IN MSA",2022,12,1107148,1074782,32366,2.9
MT1829020000000,18,29020,"Kokomo, IN MSA",2022,12,35603,33966,1637,4.6
MT1829200000000,18,29200,"Lafayette-West Lafayette, IN MSA",2022,12,118655,115362,3293,2.8
MT1833140000000,18,33140,"Michigan City-La Porte, IN MSA",2022,12,50994,49089,1905,3.7
MT1834620000000,18,34620,"Muncie, IN MSA",2022,12,51494,49659,1835,3.6
MT1843780000000,18,43780,"South Bend-Mishawaka, IN-MI MSA",2022,12,154778,148750,6028,3.9
MT1845460000000,18,45460,"Terre Haute, IN MSA",2022,12,76303,73590,2713,3.6
MT1911180000000,19,11180,"Ames, IA MSA",2022,12,69417,67768,1649,2.4
MT1916300000000,19,16300,"Cedar Rapids, IA MSA",2022,12,149193,144367,4826,3.2
MT1919780000000,19,19780,"Des Moines-West Des Moines, IA MSA",2022,12,403780,392440,11340,2.8
MT1920220000000,19,20220,"Dubuque, IA MSA",2022,12,53987,52263,1724,3.2
MT1926980000000,19,26980,"Iowa City, IA MSA",2022,12,98868,96416,2452,2.5
MT1943580000000,19,43580,"Sioux City, IA-NE-SD MSA",2022,12,77052,74882,2170,2.8
MT1947940000000,19,47940,"Waterloo-Cedar Falls, IA MSA",2022,12,88826,86139,2687,3
MT2029940000000,20,29940,"Lawrence, KS MSA",2022,12,69417,67527,1890,2.7
MT2031740000000,20,31740,"Manhattan, KS MSA",2022,12,63253,61391,1862,2.9
MT2045820000000,20,45820,"Topeka, KS MSA",2022,12,117344,113757,3587,3.1
MT2048620000000,20,48620,"Wichita, KS MSA",2022,12,328155,318011,10144,3.1
MT2114540000000,21,14540,"Bowling Green, KY MSA",2022,12,89922,86511,3411,3.8
MT2121060000000,21,21060,"Elizabethtown, KY MSA",2022,12,53310,51016,2294,4.3
MT2130460000000,21,30460,"Lexington-Fayette, KY MSA",2022,12,269277,260237,9040,3.4
MT2131140000000,21,31140,"Louisville/Jefferson County, KY-IN MSA",2022,12,685931,660997,24934,3.6
MT2136980000000,21,36980,"Owensboro, KY MSA",2022,12,51018,48828,2190,4.3
MT2137140000000,21,37140,"Paducah, KY-IL MSA",2022,12,45326,43417,1909,4.2
MT2210780000000,22,10780,"Alexandria, LA MSA",2022,12,64753,62616,2137,3.3
MT2212940000000,22,12940,"Baton Rouge, LA MSA",2022,12,418898,404481,14417,3.4
MT2225220000000,22,25220,"Hammond, LA MSA",2022,12,59602,57205,2397,4
MT2226380000000,22,26380,"Houma-Bayou Cane-Thibodaux, LA MSA",2022,12,87086,84278,2808,3.2
MT2229180000000,22,29180,"Lafayette, LA MSA",2022,12,196577,190593,5984,3
MT2229340000000,22,29340,"Lake Charles, LA MSA",2022,12,98701,95057,3644,3.7
MT2233740000000,22,33740,"Monroe, LA MSA",2022,12,96241,92460,3781,3.9
MT2235380000000,22,35380,"New Orleans-Metairie, LA MSA",2022,12,468294,451311,16983,3.6
MT2243340000000,22,43340,"Shreveport-Bossier City, LA MSA",2022,12,168772,162704,6068,3.6
MT2243640000000,22,43640,"Slidell-Mandeville-Covington, LA MSA",2022,12,127770,124058,3712,2.9
MT2312620000000,23,12620,"Bangor, ME MSA",2022,12,73076,71069,2007,2.7
MT2330340000000,23,30340,"Lewiston-Auburn, ME MSA",2022,12,53777,52316,1461,2.7
MT2338860000000,23,38860,"Portland-South Portland, ME MSA",2022,12,303013,296664,6349,2.1
MT2412580000000,24,12580,"Baltimore-Columbia-Towson, MD MSA",2022,12,1459884,1423018,36866,2.5
MT2425180000000,24,25180,"Hagerstown-Martinsburg, MD-WV MSA",2022,12,141449,137521,3928,2.8
MT2430500000000,24,30500,"Lexington Park, MD MSA",2022,12,105054,102556,2498,2.4
MT2441540000000,24,41540,"Salisbury, MD MSA",2022,12,62044,60247,1797,2.9
MT2511200000000,25,11200,"Amherst Town-Northampton, MA MSA",2022,12,83241,80388,2853,3.4
MT2512700000000,25,12700,"Barnstable Town, MA MSA",2022,12,113511,108235,5276,4.6
MT2514460000000,25,14460,"Boston-Cambridge-Newton, MA-NH MSA",2022,12,2740794,2653530,87264,3.2
MT2538340000000,25,38340,"Pittsfield, MA MSA",2022,12,63287,60691,2596,4.1
MT2544140000000,25,44140,"Springfield, MA MSA",2022,12,220888,210618,10270,4.6
MT2549340000000,25,49340,"Worcester, MA MSA",2022,12,451933,435003,16930,3.7
MT2611460000000,26,11460,"Ann Arbor, MI MSA",2022,12,201398,194412,6986,3.5
MT2612980000000,26,12980,"Battle Creek, MI MSA",2022,12,60886,58046,2840,4.7
MT2613020000000,26,13020,"Bay City, MI MSA",2022,12,48967,46367,2600,5.3
MT2619820000000,26,19820,"Detroit-Warren-Dearborn, MI MSA",2022,12,2125817,2048615,77202,3.6
MT2622420000000,26,22420,"Flint, MI MSA",2022,12,183840,174121,9719,5.3
MT2624340000000,26,24340,"Grand Rapids-Wyoming-Kentwood, MI MSA",2022,12,612206,590665,21541,3.5
MT2627100000000,26,27100,"Jackson, MI MSA",2022,12,73836,70547,3289,4.5
MT2628020000000,26,28020,"Kalamazoo-Portage, MI MSA",2022,12,135944,130765,5179,3.8
MT2629620000000,26,29620,"Lansing-East Lansing, MI MSA",2022,12,244202,234130,10072,4.1
MT2633220000000,26,33220,"Midland, MI MSA",2022,12,40530,38783,1747,4.3
MT2633780000000,26,33780,"Monroe, MI MSA",2022,12,75158,71687,3471,4.6
MT2634740000000,26,34740,"Muskegon-Norton Shores, MI MSA",2022,12,82247,78398,3849,4.7
MT2635660000000,26,35660,"Niles, MI MSA",2022,12,74444,71097,3347,4.5
MT2640980000000,26,40980,"Saginaw, MI MSA",2022,12,83360,78739,4621,5.5
MT2645900000000,26,45900,"Traverse City, MI MSA",2022,12,79198,75890,3308,4.2
MT2720260000000,27,20260,"Duluth, MN-WI MSA",2022,12,138798,134011,4787,3.4
MT2731860000000,27,31860,"Mankato, MN MSA",2022,12,59539,58138,1401,2.4
MT2733460000000,27,33460,"Minneapolis-St. Paul-Bloomington, MN-WI MSA",2022,12,2043664,1991205,52459,2.6
MT2740340000000,27,40340,"Rochester, MN MSA",2022,12,124503,121568,2935,2.4
MT2741060000000,27,41060,"St. Cloud, MN MSA",2022,12,109034,105764,3270,3
MT2825060000000,28,25060,"Gulfport-Biloxi, MS MSA",2022,12,182438,176472,5966,3.3
MT2825620000000,28,25620,"Hattiesburg, MS MSA",2022,12,69764,67537,2227,3.2
MT2827140000000,28,27140,"Jackson, MS MSA",2022,12,275936,267330,8606,3.1
MT2916020000000,29,16020,"Cape Girardeau, MO-IL MSA",2022,12,48251,46981,1270,2.6
MT2917860000000,29,17860,"Columbia, MO MSA",2022,12,113234,110609,2625,2.3
MT2927620000000,29,27620,"Jefferson City, MO MSA",2022,12,73845,72091,1754,2.4
MT2927900000000,29,27900,"Joplin, MO-KS MSA",2022,12,95865,93297,2568,2.7
MT2928140000000,29,28140,"Kansas City, MO-KS MSA",2022,12,1169314,1135979,33335,2.9
MT2941140000000,29,41140,"St. Joseph, MO-KS MSA",2022,12,53580,52044,1536,2.9
MT2941180000000,29,41180,"St. Louis, MO-IL MSA",2022,12,1454807,1411767,43040,3
MT2944180000000,29,44180,"Springfield, MO MSA",2022,12,236519,230761,5758,2.4
MT3013740000000,30,13740,"Billings, MT MSA",2022,12,98617,96461,2156,2.2
MT3014580000000,30,14580,"Bozeman, MT MSA",2022,12,75652,74271,1381,1.8
MT3024500000000,30,24500,"Great Falls, MT MSA",2022,12,39616,38651,965,2.4
MT3025740000000,30,25740,"Helena, MT MSA",2022,12,47100,45999,1101,2.3
MT3033540000000,30,33540,"Missoula, MT MSA",2022,12,72800,71152,1648,2.3
MT3124260000000,31,24260,"Grand Island, NE MSA",2022,12,41911,40997,914,2.2
MT3130700000000,31,30700,"Lincoln, NE MSA",2022,12,189977,186140,3837,2
MT3136540000000,31,36540,"Omaha, NE-IA MSA",2022,12,516427,504116,12311,2.4
MT3216180000000,32,16180,"Carson City, NV MSA",2022,12,28377,27120,1257,4.4
MT3229820000000,32,29820,"Las Vegas-Henderson-North Las Vegas, NV MSA",2022,12,1172398,1108941,63457,5.4
MT3239900000000,32,39900,"Reno, NV MSA",2022,12,292478,279564,12914,4.4
MT3331700000000,33,31700,"Manchester-Nashua, NH MSA",2022,12,239285,233097,6188,2.6
MT3412100000000,34,12100,"Atlantic City-Hammonton, NJ MSA",2022,12,179465,170119,9346,5.2
MT3445940000000,34,45940,"Trenton-Princeton, NJ MSA",2022,12,198420,191290,7130,3.6
MT3447220000000,34,47220,"Vineland, NJ MSA",2022,12,65464,61735,3729,5.7
MT3510740000000,35,10740,"Albuquerque, NM MSA",2022,12,451183,436855,14328,3.2
MT3522140000000,35,22140,"Farmington, NM MSA",2022,12,48792,46759,2033,4.2
MT3529740000000,35,29740,"Las Cruces, NM MSA",2022,12,98168,94071,4097,4.2
MT3542140000000,35,42140,"Santa Fe, NM MSA",2022,12,72582,70316,2266,3.1
MT3610580000000,36,10580,"Albany-Schenectady-Troy, NY MSA",2022,12,452279,438883,13396,3
MT3613780000000,36,13780,"Binghamton, NY MSA",2022,12,105832,102189,3643,3.4
MT3615380000000,36,15380,"Buffalo-Cheektowaga, NY MSA",2022,12,555390,536533,18857,3.4
MT3621300000000,36,21300,"Elmira, NY MSA",2022,12,35245,34000,1245,3.5
MT3624020000000,36,24020,"Glens Falls, NY MSA",2022,12,59364,57531,1833,3.1
MT3627060000000,36,27060,"Ithaca, NY MSA",2022,12,48263,46816,1447,3
MT3628740000000,36,28740,"Kingston, NY MSA",2022,12,86047,83401,2646,3.1
MT3628880000000,36,28880,"Kiryas Joel-Poughkeepsie-Newburgh, NY MSA",2022,12,333863,323653,10210,3.1
MT3635620000000,36,35620,"New York-Newark-Jersey City, NY-NJ MSA",2022,12,10014706,9608130,406576,4.1
MT3640380000000,36,40380,"Rochester, NY MSA",2022,12,509878,493470,16408,3.2
MT3645060000000,36,45060,"Syracuse, NY MSA",2022,12,309236,299128,10108,3.3
MT3646540000000,36,46540,"Utica-Rome, NY MSA",2022,12,127384,122989,4395,3.5
MT3648060000000,36,48060,"Watertown-Fort Drum, NY MSA",2022,12,44738,43000,1738,3.9
MT3711700000000,37,11700,"Asheville, NC MSA",2022,12,208850,202555,6295,3
MT3715500000000,37,15500,"Burlington, NC MSA",2022,12,83872,80783,3089,3.7
MT3716740000000,37,16740,"Charlotte-Concord-Gastonia, NC-SC MSA",2022,12,1448256,1398370,49886,3.4
MT3720500000000,37,20500,"Durham-Chapel Hill, NC MSA",2022,12,316691,306521,10170,3.2
MT3722180000000,37,22180,"Fayetteville, NC MSA",2022,12,153586,146366,7220,4.7
MT3724140000000,37,24140,"Goldsboro, NC MSA",2022,12,50011,48124,1887,3.8
MT3724660000000,37,24660,"Greensboro-High Point, NC MSA",2022,12,373498,358692,14806,4
MT3724780000000,37,24780,"Greenville, NC MSA",2022,12,82650,79158,3492,4.2
MT3725860000000,37,25860,"Hickory-Lenoir-Morganton, NC MSA",2022,12,172913,167169,5744,3.3
MT3727340000000,37,27340,"Jacksonville, NC MSA",2022,12,73078,70288,2790,3.8
MT3738240000000,37,38240,"Pinehurst-Southern Pines, NC MSA",2022,12,43610,42062,1548,3.5
MT3739580000000,37,39580,"Raleigh-Cary, NC MSA",2022,12,817180,792264,24916,3
MT3740580000000,37,40580,"Rocky Mount, NC MSA",2022,12,63447,60117,3330,5.2
MT3748900000000,37,48900,"Wilmington, NC MSA",2022,12,218053,210066,7987,3.7
MT3749180000000,37,49180,"Winston-Salem, NC MSA",2022,12,324811,312974,11837,3.6
MT3813900000000,38,13900,"Bismarck, ND MSA",2022,12,72157,70767,1390,1.9
MT3822020000000,38,22020,"Fargo, ND-MN MSA",2022,12,150682,147918,2764,1.8
MT3824220000000,38,24220,"Grand Forks, ND-MN MSA",2022,12,54808,53621,1187,2.2
MT3833500000000,38,33500,"Minot, ND MSA",2022,12,39459,38640,819,2.1
MT3910420000000,39,10420,"Akron, OH MSA",2022,12,356884,343381,13503,3.8
MT3915940000000,39,15940,"Canton-Massillon, OH MSA",2022,12,189398,181847,7551,4
MT3917140000000,39,17140,"Cincinnati, OH-KY-IN MSA",2022,12,1153017,1113374,39643,3.4
MT3917410000000,39,17410,"Cleveland, OH MSA",2022,12,1076974,1033317,43657,4.1
MT3918140000000,39,18140,"Columbus, OH MSA",2022,12,1120180,1082339,37841,3.4
MT3919430000000,39,19430,"Dayton-Kettering-Beavercreek, OH MSA",2022,12,383798,369441,14357,3.7
MT3930620000000,39,30620,"Lima, OH MSA",2022,12,47376,45519,1857,3.9
MT3931900000000,39,31900,"Mansfield, OH MSA",2022,12,52063,49771,2292,4.4
MT3941780000000,39,41780,"Sandusky, OH MSA",2022,12,55969,53385,2584,4.6
MT3944220000000,39,44220,"Springfield, OH MSA",2022,12,61228,58880,2348,3.8
MT3945780000000,39,45780,"Toledo, OH MSA",2022,12,290949,278903,12046,4.1
MT3948260000000,39,48260,"Weirton-Steubenville, WV-OH MSA",2022,12,52151,49641,2510,4.8
MT3949660000000,39,49660,"Youngstown-Warren, OH MSA",2022,12,190333,181820,8513,4.5
MT4021420000000,40,21420,"Enid, OK MSA",2022,12,28104,27306,798,2.8
MT4030020000000,40,30020,"Lawton, OK MSA",2022,12,50996,49230,1766,3.5
MT4036420000000,40,36420,"Oklahoma City, OK MSA",2022,12,743346,722417,20929,2.8
MT4046140000000,40,46140,"Tulsa, OK MSA",2022,12,504058,488780,15278,3
MT4110540000000,41,10540,"Albany, OR MSA",2022,12,60787,58127,2660,4.4
MT4113460000000,41,13460,"Bend, OR MSA",2022,12,127523,122194,5329,4.2
MT4118700000000,41,18700,"Corvallis, OR MSA",2022,12,48518,46824,1694,3.5
MT4121660000000,41,21660,"Eugene-Springfield, OR MSA",2022,12,185392,177332,8060,4.3
MT4124420000000,41,24420,"Grants Pass, OR MSA",2022,12,34892,32850,2042,5.9
MT4132780000000,41,32780,"Medford, OR MSA",2022,12,103680,98589,5091,4.9
MT4138900000000,41,38900,"Portland-Vancouver-Hillsboro, OR-WA MSA",2022,12,1369478,1319420,50058,3.7
MT4141420000000,41,41420,"Salem, OR MSA",2022,12,214922,206281,8641,4
MT4210900000000,42,10900,"Allentown-Bethlehem-Easton, PA-NJ MSA",2022,12,445670,427901,17769,4
MT4211020000000,42,11020,"Altoona, PA MSA",2022,12,56741,54432,2309,4.1
MT4216540000000,42,16540,"Chambersburg, PA MSA",2022,12,76880,74266,2614,3.4
MT4221500000000,42,21500,"Erie, PA MSA",2022,12,125484,119889,5595,4.5
MT4223900000000,42,23900,"Gettysburg, PA MSA",2022,12,52258,50620,1638,3.1
MT4225420000000,42,25420,"Harrisburg-Carlisle, PA MSA",2022,12,308576,298183,10393,3.4
MT4227780000000,42,27780,"Johnstown, PA MSA",2022,12,56929,54241,2688,4.7
MT4229540000000,42,29540,"Lancaster, PA MSA",2022,12,289416,280531,8885,3.1
MT4230140000000,42,30140,"Lebanon, PA MSA",2022,12,71777,69407,2370,3.3
MT4237980000000,42,37980,"Philadelphia-Camden-Wilmington, PA-NJ-DE-MD MSA",2022,12,3250208,3128315,121893,3.8
MT4238300000000,42,38300,"Pittsburgh, PA MSA",2022,12,1222340,1172797,49543,4.1
MT4239740000000,42,39740,"Reading, PA MSA",2022,12,216807,208610,8197,3.8
MT4242540000000,42,42540,"Scranton--Wilkes-Barre, PA MSA",2022,12,276386,263593,12793,4.6
MT4244300000000,42,44300,"State College, PA MSA",2022,12,76629,74175,2454,3.2
MT4248700000000,42,48700,"Williamsport, PA MSA",2022,12,52187,49915,2272,4.4
MT4249620000000,42,49620,"York-Hanover, PA MSA",2022,12,236629,228542,8087,3.4
MT4439300000000,44,39300,"Providence-Warwick, RI-MA MSA",2022,12,872173,842005,30168,3.5
MT4516700000000,45,16700,"Charleston-North Charleston, SC MSA",2022,12,419883,408465,11418,2.7
MT4517900000000,45,17900,"Columbia, SC MSA",2022,12,402169,389863,12306,3.1
MT4522500000000,45,22500,"Florence, SC MSA",2022,12,90423,87398,3025,3.3
MT4524860000000,45,24860,"Greenville-Anderson-Greer, SC MSA",2022,12,462295,449370,12925,2.8
MT4525940000000,45,25940,"Hilton Head Island-Bluffton-Port Royal, SC MSA",2022,12,94872,92167,2705,2.9
MT4534820000000,45,34820,"Myrtle Beach-Conway-North Myrtle Beach, SC MSA",2022,12,164119,158035,6084,3.7
MT4543900000000,45,43900,"Spartanburg, SC MSA",2022,12,169373,163911,5462,3.2
MT4544940000000,45,44940,"Sumter, SC MSA",2022,12,41209,39532,1677,4.1
MT4639660000000,46,39660,"Rapid City, SD MSA",2022,12,77896,76457,1439,1.8
MT4643620000000,46,43620,"Sioux Falls, SD-MN MSA",2022,12,168906,166017,2889,1.7
MT4716860000000,47,16860,"Chattanooga, TN-GA MSA",2022,12,280481,271712,8769,3.1
MT4717300000000,47,17300,"Clarksville, TN-KY MSA",2022,12,134487,129256,5231,3.9
MT4717420000000,47,17420,"Cleveland, TN MSA",2022,12,55780,53733,2047,3.7
MT4727180000000,47,27180,"Jackson, TN MSA",2022,12,77598,74713,2885,3.7
MT4727740000000,47,27740,"Johnson City, TN MSA",2022,12,95416,92164,3252,3.4
MT4728700000000,47,28700,"Kingsport-Bristol, TN-VA MSA",2022,12,130685,126105,4580,3.5
MT4728940000000,47,28940,"Knoxville, TN MSA",2022,12,440729,426982,13747,3.1
MT4732820000000,47,32820,"Memphis, TN-MS-AR MSA",2022,12,624719,599834,24885,4
MT4734100000000,47,34100,"Morristown, TN MSA",2022,12,52564,50642,1922,3.7
MT4734980000000,47,34980,"Nashville-Davidson--Murfreesboro--Franklin, TN MSA",2022,12,1127984,1096937,31047,2.8
MT4810180000000,48,10180,"Abilene, TX MSA",2022,12,83352,80293,3059,3.7
MT4811100000000,48,11100,"Amarillo, TX MSA",2022,12,132611,128391,4220,3.2
MT4812420000000,48,12420,"Austin-Round Rock-San Marcos, TX MSA",2022,12,1425589,1380138,45451,3.2
MT4813140000000,48,13140,"Beaumont-Port Arthur, TX MSA",2022,12,173371,163555,9816,5.7
MT4815180000000,48,15180,"Brownsville-Harlingen, TX MSA",2022,12,182702,172522,10180,5.6
MT4817780000000,48,17780,"College Station-Bryan, TX MSA",2022,12,143317,138149,5168,3.6
MT4818580000000,48,18580,"Corpus Christi, TX MSA",2022,12,202225,192741,9484,4.7
MT4819100000000,48,19100,"Dallas-Fort Worth-Arlington, TX MSA",2022,12,4309937,4150516,159421,3.7
MT4820580000000,48,20580,"Eagle Pass, TX MSA",2022,12,23541,21686,1855,7.9
MT4821340000000,48,21340,"El Paso, TX MSA",2022,12,392342,375593,16749,4.3
MT4826420000000,48,26420,"Houston-Pasadena-The Woodlands, TX MSA",2022,12,3666099,3511421,154678,4.2
MT4828660000000,48,28660,"Killeen-Temple, TX MSA",2022,12,195429,186732,8697,4.5
MT4829700000000,48,29700,"Laredo, TX MSA",2022,12,113044,108276,4768,4.2
MT4830980000000,48,30980,"Longview, TX MSA",2022,12,127810,122232,5578,4.4
MT4831180000000,48,31180,"Lubbock, TX MSA",2022,12,177215,170832,6383,3.6
MT4832580000000,48,32580,"McAllen-Edinburg-Mission, TX MSA",2022,12,382405,357951,24454,6.4
MT4833260000000,48,33260,"Midland, TX MSA",2022,12,96970,94055,2915,3
MT4836220000000,48,36220,"Odessa, TX MSA",2022,12,81744,78780,2964,3.6
MT4841660000000,48,41660,"San Angelo, TX MSA",2022,12,59734,57809,1925,3.2
MT4841700000000,48,41700,"San Antonio-New Braunfels, TX MSA",2022,12,1278174,1230121,48053,3.8
MT4843300000000,48,43300,"Sherman-Denison, TX MSA",2022,12,68144,65502,2642,3.9
MT4845500000000,48,45500,"Texarkana, TX-AR MSA",2022,12,60435,57913,2522,4.2
MT4846340000000,48,46340,"Tyler, TX MSA",2022,12,113711,109424,4287,3.8
MT4847020000000,48,47020,"Victoria, TX MSA",2022,12,44381,42546,1835,4.1
MT4847380000000,48,47380,"Waco, TX MSA",2022,12,140791,135187,5604,4
MT4848660000000,48,48660,"Wichita Falls, TX MSA",2022,12,65769,63294,2475,3.8
MT4930860000000,49,30860,"Logan, UT-ID MSA",2022,12,78975,77133,1842,2.3
MT4936260000000,49,36260,"Ogden, UT MSA",2022,12,339476,331440,8036,2.4
MT4939340000000,49,39340,"Provo-Orem-Lehi, UT MSA",2022,12,358744,349954,8790,2.5
MT4941100000000,49,41100,"St. George, UT MSA",2022,12,88313,85848,2465,2.8
MT4941620000000,49,41620,"Salt Lake City-Murray, UT MSA",2022,12,715502,697487,18015,2.5
MT5015540000000,50,15540,"Burlington-South Burlington, VT MSA",2022,12,127589,125263,2326,1.8
MT5113980000000,51,13980,"Blacksburg-Christiansburg-Radford, VA MSA",2022,12,91743,89082,2661,2.9
MT5116820000000,51,16820,"Charlottesville, VA MSA",2022,12,116873,113825,3048,2.6
MT5125500000000,51,25500,"Harrisonburg, VA MSA",2022,12,72038,70123,1915,2.7
MT5131340000000,51,31340,"Lynchburg, VA MSA",2022,12,127677,123710,3967,3.1
MT5140060000000,51,40060,"Richmond, VA MSA",2022,12,712811,692357,20454,2.9
MT5140220000000,51,40220,"Roanoke, VA MSA",2022,12,156194,151774,4420,2.8
MT5144420000000,51,44420,"Staunton-Stuarts Draft, VA MSA",2022,12,65276,63687,1589,2.4
MT5147260000000,51,47260,"Virginia Beach-Chesapeake-Norfolk, VA-NC MSA",2022,12,869436,842598,26838,3.1
MT5149020000000,51,49020,"Winchester, VA-WV MSA",2022,12,75867,73851,2016,2.7
MT5313380000000,53,13380,"Bellingham, WA MSA",2022,12,114595,109972,4623,4
MT5314740000000,53,14740,"Bremerton-Silverdale-Port Orchard, WA MSA",2022,12,121855,116937,4918,4
MT5328420000000,53,28420,"Kennewick-Richland, WA MSA",2022,12,145124,138242,6882,4.7
MT5331020000000,53,31020,"Longview-Kelso, WA MSA",2022,12,47563,45214,2349,4.9
MT5334580000000,53,34580,"Mount Vernon-Anacortes, WA MSA",2022,12,57740,55156,2584,4.5
MT5336500000000,53,36500,"Olympia-Lacey-Tumwater, WA MSA",2022,12,140591,134759,5832,4.1
MT5342660000000,53,42660,"Seattle-Tacoma-Bellevue, WA MSA",2022,12,2270594,2181785,88809,3.9
MT5344060000000,53,44060,"Spokane-Spokane Valley, WA MSA",2022,12,280931,268830,12101,4.3
MT5347460000000,53,47460,"Walla Walla, WA MSA",2022,12,29616,28475,1141,3.9
MT5348300000000,53,48300,"Wenatchee-East Wenatchee, WA MSA",2022,12,62107,59259,2848,4.6
MT5349420000000,53,49420,"Yakima, WA MSA",2022,12,127148,119670,7478,5.9
MT5413220000000,54,13220,"Beckley, WV MSA",2022,12,45243,43637,1606,3.5
MT5416620000000,54,16620,"Charleston, WV MSA",2022,12,89653,86531,3122,3.5
MT5426580000000,54,26580,"Huntington-Ashland, WV-KY-OH MSA",2022,12,154860,148186,6674,4.3
MT5434060000000,54,34060,"Morgantown, WV MSA",2022,12,70703,68418,2285,3.2
MT5437620000000,54,37620,"Parkersburg-Vienna, WV MSA",2022,12,38998,37468,1530,3.9
MT5448540000000,54,48540,"Wheeling, WV-OH MSA",2022,12,59229,56552,2677,4.5
MT5511540000000,55,11540,"Appleton, WI MSA",2022,12,135557,132706,2851,2.1
MT5520740000000,55,20740,"Eau Claire, WI MSA",2022,12,94033,91550,2483,2.6
MT5522540000000,55,22540,"Fond du Lac, WI MSA",2022,12,55749,54459,1290,2.3
MT5524580000000,55,24580,"Green Bay, WI MSA",2022,12,176773,172586,4187,2.4
MT5527500000000,55,27500,"Janesville-Beloit, WI MSA",2022,12,84819,82265,2554,3
MT5528450000000,55,28450,"Kenosha, WI MSA",2022,12,92943,90272,2671,2.9
MT5529100000000,55,29100,"La Crosse-Onalaska, WI-MN MSA",2022,12,89167,87061,2106,2.4
MT5531540000000,55,31540,"Madison, WI MSA",2022,12,397336,389389,7947,2
MT5533340000000,55,33340,"Milwaukee-Waukesha, WI MSA",2022,12,808510,785960,22550,2.8
MT5536780000000,55,36780,"Oshkosh-Neenah, WI MSA",2022,12,91945,89859,2086,2.3
MT5539540000000,55,39540,"Racine-Mount Pleasant, WI MSA",2022,12,100001,96997,3004,3
MT5543100000000,55,43100,"Sheboygan, WI MSA",2022,12,62047,60693,1354,2.2
MT5548140000000,55,48140,"Wausau, WI MSA",2022,12,74305,72661,1644,2.2
MT5616220000000,56,16220,"Casper, WY MSA",2022,12,41998,40557,1441,3.4
MT5616940000000,56,16940,"Cheyenne, WY MSA",2022,12,48523,46879,1644,3.4
MT7210380000000,72,10380,"Aguadilla, PR MSA",2022,12,86864,80144,6720,7.7
MT7211640000000,72,11640,"Arecibo, PR MSA",2022,12,65224,60654,4570,7
MT7225020000000,72,25020,"Guayama, PR MSA",2022,12,18730,17096,1634,8.7
MT7232420000000,72,32420,"Mayaguez, PR MSA",2022,12,66058,61108,4950,7.5
MT7238660000000,72,38660,"Ponce, PR MSA",2022,12,88609,80513,8096,9.1
MT7241980000000,72,41980,"San Juan-Bayamon-Caguas, PR MSA",2022,12,806139,766330,39809,4.9
MT0111500000000,1,11500,"Anniston-Oxford, AL MSA",2023,1,49175,48051,1124,2.3
MT0112220000000,1,12220,"Auburn-Opelika, AL MSA",2023,1,92671,90660,2011,2.2
MT0113820000000,1,13820,"Birmingham, AL MSA",2023,1,558178,546516,11662,2.1
MT0119300000000,1,19300,"Daphne-Fairhope-Foley, AL MSA",2023,1,111910,109774,2136,1.9
MT0119460000000,1,19460,"Decatur, AL MSA",2023,1,73279,71924,1355,1.8
MT0120020000000,1,20020,"Dothan, AL MSA",2023,1,66485,65007,1478,2.2
MT0122520000000,1,22520,"Florence-Muscle Shoals, AL MSA",2023,1,67428,65823,1605,2.4
MT0123460000000,1,23460,"Gadsden, AL MSA",2023,1,41001,40047,954,2.3
MT0126620000000,1,26620,"Huntsville, AL MSA",2023,1,261908,257107,4801,1.8
MT0133660000000,1,33660,"Mobile, AL MSA",2023,1,182287,177054,5233,2.9
MT0133860000000,1,33860,"Montgomery, AL MSA",2023,1,172591,168251,4340,2.5
MT0146220000000,1,46220,"Tuscaloosa, AL MSA",2023,1,122923,120007,2916,2.4
MT0211260000000,2,11260,"Anchorage, AK MSA",2023,1,198463,191439,7024,3.5
MT0221820000000,2,21820,"Fairbanks-College, AK MSA",2023,1,44808,43202,1606,3.6
MT0422380000000,4,22380,"Flagstaff, AZ MSA",2023,1,73177,70250,2927,4
MT0429420000000,4,29420,"Lake Havasu City-Kingman, AZ MSA",2023,1,85889,82009,3880,4.5
MT0438060000000,4,38060,"Phoenix-Mesa-Chandler, AZ MSA",2023,1,2618818,2537132,81686,3.1
MT0439150000000,4,39150,"Prescott Valley-Prescott, AZ MSA",2023,1,104820,101136,3684,3.5
MT0443420000000,4,43420,"Sierra Vista-Douglas, AZ MSA",2023,1,47797,45640,2157,4.5
MT0446060000000,4,46060,"Tucson, AZ MSA",2023,1,489183,471823,17360,3.5
MT0449740000000,4,49740,"Yuma, AZ MSA",2023,1,98786,86483,12303,12.5
MT0522220000000,5,22220,"Fayetteville-Springdale-Rogers, AR MSA",2023,1,293870,287249,6621,2.3
MT0522900000000,5,22900,"Fort Smith, AR-OK MSA",2023,1,100370,97696,2674,2.7
MT0526300000000,5,26300,"Hot Springs, AR MSA",2023,1,43606,42212,1394,3.2
MT0527860000000,5,27860,"Jonesboro, AR MSA",2023,1,64604,62936,1668,2.6
MT0530780000000,5,30780,"Little Rock-North Little Rock-Conway, AR MSA",2023,1,367705,357762,9943,2.7
MT0612540000000,6,12540,"Bakersfield-Delano, CA MSA",2023,1,397568,367109,30459,7.7
MT0617020000000,6,17020,"Chico, CA MSA",2023,1,90583,86136,4447,4.9
MT0620940000000,6,20940,"El Centro, CA MSA",2023,1,69922,57994,11928,17.1
MT0623420000000,6,23420,"Fresno, CA MSA",2023,1,519046,483302,35744,6.9
MT0625260000000,6,25260,"Hanford-Corcoran, CA MSA",2023,1,55749,51332,4417,7.9
MT0631080000000,6,31080,"Los Angeles-Long Beach-Anaheim, CA MSA",2023,1,6643243,6346004,297239,4.5
MT0632900000000,6,32900,"Merced, CA MSA",2023,1,116778,106924,9854,8.4
MT0633700000000,6,33700,"Modesto, CA MSA",2023,1,246437,232034,14403,5.8
MT0634900000000,6,34900,"Napa, CA MSA",2023,1,72075,69746,2329,3.2
MT0637100000000,6,37100,"Oxnard-Thousand Oaks-Ventura, CA MSA",2023,1,413186,397444,15742,3.8
MT0639820000000,6,39820,"Redding, CA MSA",2023,1,76936,73375,3561,4.6
MT0640140000000,6,40140,"Riverside-San Bernardino-Ontario, CA MSA",2023,1,2156428,2063049,93379,4.3
MT0640900000000,6,40900,"Sacramento-Roseville-Folsom, CA MSA",2023,1,1152709,1107756,44953,3.9
MT0641500000000,6,41500,"Salinas, CA MSA",2023,1,213211,198868,14343,6.7
MT0641740000000,6,41740,"San Diego-Chula Vista-Carlsbad, CA MSA",2023,1,1627514,1572253,55261,3.4
MT0641860000000,6,41860,"San Francisco-Oakland-Fremont, CA MSA",2023,1,2513813,2434430,79383,3.2
MT0641940000000,6,41940,"San Jose-Sunnyvale-Santa Clara, CA MSA",2023,1,1055459,1023811,31648,3
MT0642020000000,6,42020,"San Luis Obispo-Paso Robles, CA MSA",2023,1,131637,127267,4370,3.3
MT0642100000000,6,42100,"Santa Cruz-Watsonville, CA MSA",2023,1,134625,127776,6849,5.1
MT0642200000000,6,42200,"Santa Maria-Santa Barbara, CA MSA",2023,1,217681,209458,8223,3.8
MT0642220000000,6,42220,"Santa Rosa-Petaluma, CA MSA",2023,1,245437,237430,8007,3.3
MT0644700000000,6,44700,"Stockton-Lodi, CA MSA",2023,1,358200,338443,19757,5.5
MT0646700000000,6,46700,"Vallejo, CA MSA",2023,1,210930,202157,8773,4.2
MT0647300000000,6,47300,"Visalia, CA MSA",2023,1,213543,194010,19533,9.1
MT0649700000000,6,49700,"Yuba City, CA MSA",2023,1,78498,73014,5484,7
MT0814500000000,8,14500,"Boulder, CO MSA",2023,1,192552,187528,5024,2.6
MT0817820000000,8,17820,"Colorado Springs, CO MSA",2023,1,384497,372754,11743,3.1
MT0819740000000,8,19740,"Denver-Aurora-Centennial, CO MSA",2023,1,1753488,1704100,49388,2.8
MT0822660000000,8,22660,"Fort Collins-Loveland, CO MSA",2023,1,202908,197344,5564,2.7
MT0824300000000,8,24300,"Grand Junction, CO MSA",2023,1,78173,75638,2535,3.2
MT0824540000000,8,24540,"Greeley, CO MSA",2023,1,171587,166230,5357,3.1
MT0839380000000,8,39380,"Pueblo, CO MSA",2023,1,73869,70675,3194,4.3
MT0914860000000,9,14860,"Bridgeport-Stamford-Danbury, CT MSA",2023,1,505195,489050,16145,3.2
MT0925540000000,9,25540,"Hartford-West Hartford-East Hartford, CT MSA",2023,1,602425,582043,20382,3.4
MT0935300000000,9,35300,"New Haven, CT MSA",2023,1,307833,297426,10407,3.4
MT0935980000000,9,35980,"Norwich-New London-Willimantic, CT MSA",2023,1,139803,135049,4754,3.4
MT0947930000000,9,47930,"Waterbury-Shelton, CT MSA",2023,1,237500,228437,9063,3.8
MT1020100000000,10,20100,"Dover, DE MSA",2023,1,84685,81064,3621,4.3
MT1147900000000,11,47900,"Washington-Arlington-Alexandria, DC-VA-MD-WV MSA",2023,1,3488317,3398500,89817,2.6
MT1215980000000,12,15980,"Cape Coral-Fort Myers, FL MSA",2023,1,364451,351671,12780,3.5
MT1218880000000,12,18880,"Crestview-Fort Walton Beach-Destin, FL MSA",2023,1,140980,137564,3416,2.4
MT1219660000000,12,19660,"Deltona-Daytona Beach-Ormond Beach, FL MSA",2023,1,313928,303735,10193,3.2
MT1223540000000,12,23540,"Gainesville, FL MSA",2023,1,167854,162898,4956,3
MT1226140000000,12,26140,"Homosassa Springs, FL MSA",2023,1,53176,51062,2114,4
MT1227260000000,12,27260,"Jacksonville, FL MSA",2023,1,841030,816958,24072,2.9
MT1229460000000,12,29460,"Lakeland-Winter Haven, FL MSA",2023,1,350947,338835,12112,3.5
MT1233100000000,12,33100,"Miami-Fort Lauderdale-West Palm Beach, FL MSA",2023,1,3230970,3151367,79603,2.5
MT1234940000000,12,34940,"Naples-Marco Island, FL MSA",2023,1,177378,171977,5401,3
MT1235840000000,12,35840,"North Port-Bradenton-Sarasota, FL MSA",2023,1,384018,372753,11265,2.9
MT1236100000000,12,36100,"Ocala, FL MSA",2023,1,154889,149677,5212,3.4
MT1236740000000,12,36740,"Orlando-Kissimmee-Sanford, FL MSA",2023,1,1491666,1450165,41501,2.8
MT1237340000000,12,37340,"Palm Bay-Melbourne-Titusville, FL MSA",2023,1,299436,290901,8535,2.9
MT1237460000000,12,37460,"Panama City-Panama City Beach, FL MSA",2023,1,99059,96383,2676,2.7
MT1237860000000,12,37860,"Pensacola-Ferry Pass-Brent, FL MSA",2023,1,237572,230782,6790,2.9
MT1238940000000,12,38940,"Port St. Lucie, FL MSA",2023,1,234044,226586,7458,3.2
MT1239460000000,12,39460,"Punta Gorda, FL MSA",2023,1,74502,71704,2798,3.8
MT1242680000000,12,42680,"Sebastian-Vero Beach-West Vero Corridor, FL MSA",2023,1,66889,64560,2329,3.5
MT1242700000000,12,42700,"Sebring, FL MSA",2023,1,36248,34741,1507,4.2
MT1245220000000,12,45220,"Tallahassee, FL MSA",2023,1,202624,196708,5916,2.9
MT1245300000000,12,45300,"Tampa-St. Petersburg-Clearwater, FL MSA",2023,1,1673156,1626861,46295,2.8
MT1248680000000,12,48680,"Wildwood-The Villages, FL MSA",2023,1,32624,31047,1577,4.8
MT1310500000000,13,10500,"Albany, GA MSA",2023,1,63295,60788,2507,4
MT1312020000000,13,12020,"Athens-Clarke County, GA MSA",2023,1,104088,100864,3224,3.1
MT1312060000000,13,12060,"Atlanta-Sandy Springs-Roswell, GA MSA",2023,1,3236240,3133555,102685,3.2
MT1312260000000,13,12260,"Augusta-Richmond County, GA-SC MSA",2023,1,265216,255323,9893,3.7
MT1315260000000,13,15260,"Brunswick-St. Simons, GA MSA",2023,1,53577,51960,1617,3
MT1317980000000,13,17980,"Columbus, GA-AL MSA",2023,1,129001,124181,4820,3.7
MT1319140000000,13,19140,"Dalton, GA MSA",2023,1,66844,64324,2520,3.8
MT1323580000000,13,23580,"Gainesville, GA MSA",2023,1,105995,103131,2864,2.7
MT1325980000000,13,25980,"Hinesville, GA MSA",2023,1,31126,29912,1214,3.9
MT1331420000000,13,31420,"Macon-Bibb County, GA MSA",2023,1,97390,93671,3719,3.8
MT1340660000000,13,40660,"Rome, GA MSA",2023,1,46349,44835,1514,3.3
MT1342340000000,13,42340,"Savannah, GA MSA",2023,1,205496,199305,6191,3
MT1346660000000,13,46660,"Valdosta, GA MSA",2023,1,60435,58214,2221,3.7
MT1347580000000,13,47580,"Warner Robins, GA MSA",2023,1,88582,85740,2842,3.2
MT1527980000000,15,27980,"Kahului-Wailuku, HI MSA",2023,1,84122,81552,2570,3.1
MT1546520000000,15,46520,"Urban Honolulu, HI MSA",2023,1,468280,454185,14095,3
MT1614260000000,16,14260,"Boise City, ID MSA",2023,1,430638,419220,11418,2.7
MT1617660000000,16,17660,"Coeur d'Alene, ID MSA",2023,1,87476,84351,3125,3.6
MT1626820000000,16,26820,"Idaho Falls, ID MSA",2023,1,81768,79676,2092,2.6
MT1630300000000,16,30300,"Lewiston, ID-WA MSA",2023,1,30406,29511,895,2.9
MT1638540000000,16,38540,"Pocatello, ID MSA",2023,1,39735,38545,1190,3
MT1646300000000,16,46300,"Twin Falls, ID MSA",2023,1,58605,56879,1726,2.9
MT1714010000000,17,14010,"Bloomington, IL MSA",2023,1,92313,89136,3177,3.4
MT1716580000000,17,16580,"Champaign-Urbana, IL MSA",2023,1,121932,117185,4747,3.9
MT1716980000000,17,16980,"Chicago-Naperville-Elgin, IL-IN MSA",2023,1,4868199,4659193,209006,4.3
MT1719340000000,17,19340,"Davenport-Moline-Rock Island, IA-IL MSA",2023,1,189355,181937,7418,3.9
MT1719500000000,17,19500,"Decatur, IL MSA",2023,1,45150,42651,2499,5.5
MT1728100000000,17,28100,"Kankakee, IL MSA",2023,1,50093,47277,2816,5.6
MT1737900000000,17,37900,"Peoria, IL MSA",2023,1,172448,164560,7888,4.6
MT1740420000000,17,40420,"Rockford, IL MSA",2023,1,158439,149478,8961,5.7
MT1744100000000,17,44100,"Springfield, IL MSA",2023,1,101939,97759,4180,4.1
MT1814020000000,18,14020,"Bloomington, IN MSA",2023,1,84659,82265,2394,2.8
MT1818020000000,18,18020,"Columbus, IN MSA",2023,1,39571,38431,1140,2.9
MT1821140000000,18,21140,"Elkhart-Goshen, IN MSA",2023,1,104489,100423,4066,3.9
MT1821780000000,18,21780,"Evansville, IN MSA",2023,1,134725,130623,4102,3
MT1823060000000,18,23060,"Fort Wayne, IN MSA",2023,1,228851,222252,6599,2.9
MT1826900000000,18,26900,"Indianapolis-Carmel-Greenwood, IN MSA",2023,1,1110053,1077261,32792,3
MT1829020000000,18,29020,"Kokomo, IN MSA",2023,1,35602,33961,1641,4.6
MT1829200000000,18,29200,"Lafayette-West Lafayette, IN MSA",2023,1,119000,115694,3306,2.8
MT1833140000000,18,33140,"Michigan City-La Porte, IN MSA",2023,1,51191,49272,1919,3.7
MT1834620000000,18,34620,"Muncie, IN MSA",2023,1,51548,49710,1838,3.6
MT1843780000000,18,43780,"South Bend-Mishawaka, IN-MI MSA",2023,1,155075,148995,6080,3.9
MT1845460000000,18,45460,"Terre Haute, IN MSA",2023,1,76425,73718,2707,3.5
MT1911180000000,19,11180,"Ames, IA MSA",2023,1,69391,67760,1631,2.4
MT1916300000000,19,16300,"Cedar Rapids, IA MSA",2023,1,149082,144256,4826,3.2
MT1919780000000,19,19780,"Des Moines-West Des Moines, IA MSA",2023,1,404775,393397,11378,2.8
MT1920220000000,19,20220,"Dubuque, IA MSA",2023,1,53967,52299,1668,3.1
MT1926980000000,19,26980,"Iowa City, IA MSA",2023,1,98843,96409,2434,2.5
MT1943580000000,19,43580,"Sioux City, IA-NE-SD MSA",2023,1,77052,74924,2128,2.8
MT1947940000000,19,47940,"Waterloo-Cedar Falls, IA MSA",2023,1,88787,86098,2689,3
MT2029940000000,20,29940,"Lawrence, KS MSA",2023,1,69602,67704,1898,2.7
MT2031740000000,20,31740,"Manhattan, KS MSA",2023,1,63378,61519,1859,2.9
MT2045820000000,20,45820,"Topeka, KS MSA",2023,1,117500,113900,3600,3.1
MT2048620000000,20,48620,"Wichita, KS MSA",2023,1,328864,318748,10116,3.1
MT2114540000000,21,14540,"Bowling Green, KY MSA",2023,1,90214,86785,3429,3.8
MT2121060000000,21,21060,"Elizabethtown, KY MSA",2023,1,53452,51184,2268,4.2
MT2130460000000,21,30460,"Lexington-Fayette, KY MSA",2023,1,269690,260704,8986,3.3
MT2131140000000,21,31140,"Louisville/Jefferson County, KY-IN MSA",2023,1,686918,661601,25317,3.7
MT2136980000000,21,36980,"Owensboro, KY MSA",2023,1,51058,48902,2156,4.2
MT2137140000000,21,37140,"Paducah, KY-IL MSA",2023,1,45433,43566,1867,4.1
MT2210780000000,22,10780,"Alexandria, LA MSA",2023,1,64672,62502,2170,3.4
MT2212940000000,22,12940,"Baton Rouge, LA MSA",2023,1,419467,404892,14575,3.5
MT2225220000000,22,25220,"Hammond, LA MSA",2023,1,59873,57441,2432,4.1
MT2226380000000,22,26380,"Houma-Bayou Cane-Thibodaux, LA MSA",2023,1,87222,84418,2804,3.2
MT2229180000000,22,29180,"Lafayette, LA MSA",2023,1,196755,190724,6031,3.1
MT2229340000000,22,29340,"Lake Charles, LA MSA",2023,1,98789,95114,3675,3.7
MT2233740000000,22,33740,"Monroe, LA MSA",2023,1,96353,92518,3835,4
MT2235380000000,22,35380,"New Orleans-Metairie, LA MSA",2023,1,468744,451423,17321,3.7
MT2243340000000,22,43340,"Shreveport-Bossier City, LA MSA",2023,1,169247,163087,6160,3.6
MT2243640000000,22,43640,"Slidell-Mandeville-Covington, LA MSA",2023,1,128063,124268,3795,3
MT2312620000000,23,12620,"Bangor, ME MSA",2023,1,73052,71136,1916,2.6
MT2330340000000,23,30340,"Lewiston-Auburn, ME MSA",2023,1,53860,52416,1444,2.7
MT2338860000000,23,38860,"Portland-South Portland, ME MSA",2023,1,303679,297454,6225,2
MT2412580000000,24,12580,"Baltimore-Columbia-Towson, MD MSA",2023,1,1460674,1426013,34661,2.4
MT2425180000000,24,25180,"Hagerstown-Martinsburg, MD-WV MSA",2023,1,141462,137640,3822,2.7
MT2430500000000,24,30500,"Lexington Park, MD MSA",2023,1,105332,102994,2338,2.2
MT2441540000000,24,41540,"Salisbury, MD MSA",2023,1,62191,60501,1690,2.7
MT2511200000000,25,11200,"Amherst Town-Northampton, MA MSA",2023,1,83228,80430,2798,3.4
MT2512700000000,25,12700,"Barnstable Town, MA MSA",2023,1,113526,108333,5193,4.6
MT2514460000000,25,14460,"Boston-Cambridge-Newton, MA-NH MSA",2023,1,2744574,2657802,86772,3.2
MT2538340000000,25,38340,"Pittsfield, MA MSA",2023,1,63342,60815,2527,4
MT2544140000000,25,44140,"Springfield, MA MSA",2023,1,220632,210517,10115,4.6
MT2549340000000,25,49340,"Worcester, MA MSA",2023,1,452206,435373,16833,3.7
MT2611460000000,26,11460,"Ann Arbor, MI MSA",2023,1,201946,195009,6937,3.4
MT2612980000000,26,12980,"Battle Creek, MI MSA",2023,1,61176,58363,2813,4.6
MT2613020000000,26,13020,"Bay City, MI MSA",2023,1,49129,46538,2591,5.3
MT2619820000000,26,19820,"Detroit-Warren-Dearborn, MI MSA",2023,1,2132875,2057077,75798,3.6
MT2622420000000,26,22420,"Flint, MI MSA",2023,1,184431,174784,9647,5.2
MT2624340000000,26,24340,"Grand Rapids-Wyoming-Kentwood, MI MSA",2023,1,614888,593612,21276,3.5
MT2627100000000,26,27100,"Jackson, MI MSA",2023,1,74089,70834,3255,4.4
MT2628020000000,26,28020,"Kalamazoo-Portage, MI MSA",2023,1,136563,131418,5145,3.8
MT2629620000000,26,29620,"Lansing-East Lansing, MI MSA",2023,1,245289,235284,10005,4.1
MT2633220000000,26,33220,"Midland, MI MSA",2023,1,40614,38892,1722,4.2
MT2633780000000,26,33780,"Monroe, MI MSA",2023,1,75570,72112,3458,4.6
MT2634740000000,26,34740,"Muskegon-Norton Shores, MI MSA",2023,1,82425,78660,3765,4.6
MT2635660000000,26,35660,"Niles, MI MSA",2023,1,74644,71332,3312,4.4
MT2640980000000,26,40980,"Saginaw, MI MSA",2023,1,83542,78913,4629,5.5
MT2645900000000,26,45900,"Traverse City, MI MSA",2023,1,79407,76158,3249,4.1
MT2720260000000,27,20260,"Duluth, MN-WI MSA",2023,1,138898,134070,4828,3.5
MT2731860000000,27,31860,"Mankato, MN MSA",2023,1,59680,58242,1438,2.4
MT2733460000000,27,33460,"Minneapolis-St. Paul-Bloomington, MN-WI MSA",2023,1,2048617,1994996,53621,2.6
MT2740340000000,27,40340,"Rochester, MN MSA",2023,1,124785,121798,2987,2.4
MT2741060000000,27,41060,"St. Cloud, MN MSA",2023,1,109227,105907,3320,3
MT2825060000000,28,25060,"Gulfport-Biloxi, MS MSA",2023,1,182523,176782,5741,3.1
MT2825620000000,28,25620,"Hattiesburg, MS MSA",2023,1,69684,67509,2175,3.1
MT2827140000000,28,27140,"Jackson, MS MSA",2023,1,276042,267711,8331,3
MT2916020000000,29,16020,"Cape Girardeau, MO-IL MSA",2023,1,48392,47123,1269,2.6
MT2917860000000,29,17860,"Columbia, MO MSA",2023,1,113334,110665,2669,2.4
MT2927620000000,29,27620,"Jefferson City, MO MSA",2023,1,74069,72315,1754,2.4
MT2927900000000,29,27900,"Joplin, MO-KS MSA",2023,1,96150,93551,2599,2.7
MT2928140000000,29,28140,"Kansas City, MO-KS MSA",2023,1,1171356,1137652,33704,2.9
MT2941140000000,29,41140,"St. Joseph, MO-KS MSA",2023,1,53549,52020,1529,2.9
MT2941180000000,29,41180,"St. Louis, MO-IL MSA",2023,1,1457860,1414668,43192,3
MT2944180000000,29,44180,"Springfield, MO MSA",2023,1,236867,231067,5800,2.4
MT3013740000000,30,13740,"Billings, MT MSA",2023,1,98649,96515,2134,2.2
MT3014580000000,30,14580,"Bozeman, MT MSA",2023,1,75766,74379,1387,1.8
MT3024500000000,30,24500,"Great Falls, MT MSA",2023,1,39495,38545,950,2.4
MT3025740000000,30,25740,"Helena, MT MSA",2023,1,47201,46108,1093,2.3
MT3033540000000,30,33540,"Missoula, MT MSA",2023,1,73021,71385,1636,2.2
MT3124260000000,31,24260,"Grand Island, NE MSA",2023,1,42060,41150,910,2.2
MT3130700000000,31,30700,"Lincoln, NE MSA",2023,1,190389,186628,3761,2
MT3136540000000,31,36540,"Omaha, NE-IA MSA",2023,1,517067,504986,12081,2.3
MT3216180000000,32,16180,"Carson City, NV MSA",2023,1,28458,27199,1259,4.4
MT3229820000000,32,29820,"Las Vegas-Henderson-North Las Vegas, NV MSA",2023,1,1174882,1111728,63154,5.4
MT3239900000000,32,39900,"Reno, NV MSA",2023,1,293222,280257,12965,4.4
MT3331700000000,33,31700,"Manchester-Nashua, NH MSA",2023,1,239013,233036,5977,2.5
MT3412100000000,34,12100,"Atlantic City-Hammonton, NJ MSA",2023,1,179480,169932,9548,5.3
MT3445940000000,34,45940,"Trenton-Princeton, NJ MSA",2023,1,198653,191292,7361,3.7
MT3447220000000,34,47220,"Vineland, NJ MSA",2023,1,65494,61632,3862,5.9
MT3510740000000,35,10740,"Albuquerque, NM MSA",2023,1,452476,437922,14554,3.2
MT3522140000000,35,22140,"Farmington, NM MSA",2023,1,49011,46950,2061,4.2
MT3529740000000,35,29740,"Las Cruces, NM MSA",2023,1,98645,94502,4143,4.2
MT3542140000000,35,42140,"Santa Fe, NM MSA",2023,1,72746,70471,2275,3.1
MT3610580000000,36,10580,"Albany-Schenectady-Troy, NY MSA",2023,1,453177,439913,13264,2.9
MT3613780000000,36,13780,"Binghamton, NY MSA",2023,1,105977,102411,3566,3.4
MT3615380000000,36,15380,"Buffalo-Cheektowaga, NY MSA",2023,1,556719,538055,18664,3.4
MT3621300000000,36,21300,"Elmira, NY MSA",2023,1,35286,34060,1226,3.5
MT3624020000000,36,24020,"Glens Falls, NY MSA",2023,1,59512,57720,1792,3
MT3627060000000,36,27060,"Ithaca, NY MSA",2023,1,48222,46792,1430,3
MT3628740000000,36,28740,"Kingston, NY MSA",2023,1,86293,83666,2627,3
MT3628880000000,36,28880,"Kiryas Joel-Poughkeepsie-Newburgh, NY MSA",2023,1,334675,324515,10160,3
MT3635620000000,36,35620,"New York-Newark-Jersey City, NY-NJ MSA",2023,1,10038702,9624873,413829,4.1
MT3640380000000,36,40380,"Rochester, NY MSA",2023,1,510837,494607,16230,3.2
MT3645060000000,36,45060,"Syracuse, NY MSA",2023,1,309073,299120,9953,3.2
MT3646540000000,36,46540,"Utica-Rome, NY MSA",2023,1,127523,123233,4290,3.4
MT3648060000000,36,48060,"Watertown-Fort Drum, NY MSA",2023,1,44823,43133,1690,3.8
MT3711700000000,37,11700,"Asheville, NC MSA",2023,1,209445,203306,6139,2.9
MT3715500000000,37,15500,"Burlington, NC MSA",2023,1,84266,81247,3019,3.6
MT3716740000000,37,16740,"Charlotte-Concord-Gastonia, NC-SC MSA",2023,1,1452098,1402884,49214,3.4
MT3720500000000,37,20500,"Durham-Chapel Hill, NC MSA",2023,1,317410,307368,10042,3.2
MT3722180000000,37,22180,"Fayetteville, NC MSA",2023,1,154035,146934,7101,4.6
MT3724140000000,37,24140,"Goldsboro, NC MSA",2023,1,50196,48336,1860,3.7
MT3724660000000,37,24660,"Greensboro-High Point, NC MSA",2023,1,373419,358829,14590,3.9
MT3724780000000,37,24780,"Greenville, NC MSA",2023,1,82726,79263,3463,4.2
MT3725860000000,37,25860,"Hickory-Lenoir-Morganton, NC MSA",2023,1,173028,167430,5598,3.2
MT3727340000000,37,27340,"Jacksonville, NC MSA",2023,1,73234,70492,2742,3.7
MT3738240000000,37,38240,"Pinehurst-Southern Pines, NC MSA",2023,1,43660,42135,1525,3.5
MT3739580000000,37,39580,"Raleigh-Cary, NC MSA",2023,1,819684,794957,24727,3
MT3740580000000,37,40580,"Rocky Mount, NC MSA",2023,1,63502,60251,3251,5.1
MT3748900000000,37,48900,"Wilmington, NC MSA",2023,1,218777,210899,7878,3.6
MT3749180000000,37,49180,"Winston-Salem, NC MSA",2023,1,324832,313212,11620,3.6
MT3813900000000,38,13900,"Bismarck, ND MSA",2023,1,72226,70846,1380,1.9
MT3822020000000,38,22020,"Fargo, ND-MN MSA",2023,1,151015,148238,2777,1.8
MT3824220000000,38,24220,"Grand Forks, ND-MN MSA",2023,1,54867,53692,1175,2.1
MT3833500000000,38,33500,"Minot, ND MSA",2023,1,39585,38776,809,2
MT3910420000000,39,10420,"Akron, OH MSA",2023,1,357649,344470,13179,3.7
MT3915940000000,39,15940,"Canton-Massillon, OH MSA",2023,1,189723,182424,7299,3.8
MT3917140000000,39,17140,"Cincinnati, OH-KY-IN MSA",2023,1,1155792,1116823,38969,3.4
MT3917410000000,39,17410,"Cleveland, OH MSA",2023,1,1078149,1036151,41998,3.9
MT3918140000000,39,18140,"Columbus, OH MSA",2023,1,1124029,1087070,36959,3.3
MT3919430000000,39,19430,"Dayton-Kettering-Beavercreek, OH MSA",2023,1,384978,370970,14008,3.6
MT3930620000000,39,30620,"Lima, OH MSA",2023,1,47458,45652,1806,3.8
MT3931900000000,39,31900,"Mansfield, OH MSA",2023,1,52147,49900,2247,4.3
MT3941780000000,39,41780,"Sandusky, OH MSA",2023,1,55968,53414,2554,4.6
MT3944220000000,39,44220,"Springfield, OH MSA",2023,1,61358,59073,2285,3.7
MT3945780000000,39,45780,"Toledo, OH MSA",2023,1,291639,279883,11756,4
MT3948260000000,39,48260,"Weirton-Steubenville, WV-OH MSA",2023,1,52141,49634,2507,4.8
MT3949660000000,39,49660,"Youngstown-Warren, OH MSA",2023,1,190570,182312,8258,4.3
MT4021420000000,40,21420,"Enid, OK MSA",2023,1,28117,27326,791,2.8
MT4030020000000,40,30020,"Lawton, OK MSA",2023,1,51016,49276,1740,3.4
MT4036420000000,40,36420,"Oklahoma City, OK MSA",2023,1,746597,725719,20878,2.8
MT4046140000000,40,46140,"Tulsa, OK MSA",2023,1,505761,490692,15069,3
MT4110540000000,41,10540,"Albany, OR MSA",2023,1,60835,58287,2548,4.2
MT4113460000000,41,13460,"Bend, OR MSA",2023,1,128148,123028,5120,4
MT4118700000000,41,18700,"Corvallis, OR MSA",2023,1,48635,47033,1602,3.3
MT4121660000000,41,21660,"Eugene-Springfield, OR MSA",2023,1,185535,177836,7699,4.1
MT4124420000000,41,24420,"Grants Pass, OR MSA",2023,1,34856,32888,1968,5.6
MT4132780000000,41,32780,"Medford, OR MSA",2023,1,103473,98569,4904,4.7
MT4138900000000,41,38900,"Portland-Vancouver-Hillsboro, OR-WA MSA",2023,1,1370498,1322041,48457,3.5
MT4141420000000,41,41420,"Salem, OR MSA",2023,1,215240,206952,8288,3.9
MT4210900000000,42,10900,"Allentown-Bethlehem-Easton, PA-NJ MSA",2023,1,446158,428519,17639,4
MT4211020000000,42,11020,"Altoona, PA MSA",2023,1,56837,54581,2256,4
MT4216540000000,42,16540,"Chambersburg, PA MSA",2023,1,76836,74267,2569,3.3
MT4221500000000,42,21500,"Erie, PA MSA",2023,1,125714,120254,5460,4.3
MT4223900000000,42,23900,"Gettysburg, PA MSA",2023,1,52301,50690,1611,3.1
MT4225420000000,42,25420,"Harrisburg-Carlisle, PA MSA",2023,1,309047,298797,10250,3.3
MT4227780000000,42,27780,"Johnstown, PA MSA",2023,1,56961,54318,2643,4.6
MT4229540000000,42,29540,"Lancaster, PA MSA",2023,1,289588,280837,8751,3
MT4230140000000,42,30140,"Lebanon, PA MSA",2023,1,71947,69619,2328,3.2
MT4237980000000,42,37980,"Philadelphia-Camden-Wilmington, PA-NJ-DE-MD MSA",2023,1,3255555,3134195,121360,3.7
MT4238300000000,42,38300,"Pittsburgh, PA MSA",2023,1,1223532,1174785,48747,4
MT4239740000000,42,39740,"Reading, PA MSA",2023,1,217140,209000,8140,3.7
MT4242540000000,42,42540,"Scranton--Wilkes-Barre, PA MSA",2023,1,276722,264009,12713,4.6
MT4244300000000,42,44300,"State College, PA MSA",2023,1,76901,74477,2424,3.2
MT4248700000000,42,48700,"Williamsport, PA MSA",2023,1,52332,50110,2222,4.2
MT4249620000000,42,49620,"York-Hanover, PA MSA",2023,1,236942,228951,7991,3.4
MT4439300000000,44,39300,"Providence-Warwick, RI-MA MSA",2023,1,872713,843153,29560,3.4
MT4516700000000,45,16700,"Charleston-North Charleston, SC MSA",2023,1,421824,410477,11347,2.7
MT4517900000000,45,17900,"Columbia, SC MSA",2023,1,403815,391502,12313,3
MT4522500000000,45,22500,"Florence, SC MSA",2023,1,90731,87724,3007,3.3
MT4524860000000,45,24860,"Greenville-Anderson-Greer, SC MSA",2023,1,464356,451474,12882,2.8
MT4525940000000,45,25940,"Hilton Head Island-Bluffton-Port Royal, SC MSA",2023,1,95290,92629,2661,2.8
MT4534820000000,45,34820,"Myrtle Beach-Conway-North Myrtle Beach, SC MSA",2023,1,164783,158770,6013,3.6
MT4543900000000,45,43900,"Spartanburg, SC MSA",2023,1,170062,164636,5426,3.2
MT4544940000000,45,44940,"Sumter, SC MSA",2023,1,41118,39436,1682,4.1
MT4639660000000,46,39660,"Rapid City, SD MSA",2023,1,77939,76538,1401,1.8
MT4643620000000,46,43620,"Sioux Falls, SD-MN MSA",2023,1,169206,166325,2881,1.7
MT4716860000000,47,16860,"Chattanooga, TN-GA MSA",2023,1,281524,272846,8678,3.1
MT4717300000000,47,17300,"Clarksville, TN-KY MSA",2023,1,134702,129500,5202,3.9
MT4717420000000,47,17420,"Cleveland, TN MSA",2023,1,55884,53847,2037,3.6
MT4727180000000,47,27180,"Jackson, TN MSA",2023,1,77567,74697,2870,3.7
MT4727740000000,47,27740,"Johnson City, TN MSA",2023,1,95430,92204,3226,3.4
MT4728700000000,47,28700,"Kingsport-Bristol, TN-VA MSA",2023,1,130761,126248,4513,3.5
MT4728940000000,47,28940,"Knoxville, TN MSA",2023,1,441343,427756,13587,3.1
MT4732820000000,47,32820,"Memphis, TN-MS-AR MSA",2023,1,624196,599618,24578,3.9
MT4734100000000,47,34100,"Morristown, TN MSA",2023,1,52561,50648,1913,3.6
MT4734980000000,47,34980,"Nashville-Davidson--Murfreesboro--Franklin, TN MSA",2023,1,1130088,1099340,30748,2.7
MT4810180000000,48,10180,"Abilene, TX MSA",2023,1,83636,80540,3096,3.7
MT4811100000000,48,11100,"Amarillo, TX MSA",2023,1,133047,128787,4260,3.2
MT4812420000000,48,12420,"Austin-Round Rock-San Marcos, TX MSA",2023,1,1432440,1385520,46920,3.3
MT4813140000000,48,13140,"Beaumont-Port Arthur, TX MSA",2023,1,173674,163686,9988,5.8
MT4815180000000,48,15180,"Brownsville-Harlingen, TX MSA",2023,1,183291,173060,10231,5.6
MT4817780000000,48,17780,"College Station-Bryan, TX MSA",2023,1,143906,138681,5225,3.6
MT4818580000000,48,18580,"Corpus Christi, TX MSA",2023,1,203137,193672,9465,4.7
MT4819100000000,48,19100,"Dallas-Fort Worth-Arlington, TX MSA",2023,1,4326308,4164294,162014,3.7
MT4820580000000,48,20580,"Eagle Pass, TX MSA",2023,1,23648,21779,1869,7.9
MT4821340000000,48,21340,"El Paso, TX MSA",2023,1,393531,376589,16942,4.3
MT4826420000000,48,26420,"Houston-Pasadena-The Woodlands, TX MSA",2023,1,3682632,3525617,157015,4.3
MT4828660000000,48,28660,"Killeen-Temple, TX MSA",2023,1,195775,186924,8851,4.5
MT4829700000000,48,29700,"Laredo, TX MSA",2023,1,113559,108720,4839,4.3
MT4830980000000,48,30980,"Longview, TX MSA",2023,1,128215,122600,5615,4.4
MT4831180000000,48,31180,"Lubbock, TX MSA",2023,1,177848,171427,6421,3.6
MT4832580000000,48,32580,"McAllen-Edinburg-Mission, TX MSA",2023,1,383502,359131,24371,6.4
MT4833260000000,48,33260,"Midland, TX MSA",2023,1,97657,94732,2925,3
MT4836220000000,48,36220,"Odessa, TX MSA",2023,1,82181,79216,2965,3.6
MT4841660000000,48,41660,"San Angelo, TX MSA",2023,1,59940,57987,1953,3.3
MT4841700000000,48,41700,"San Antonio-New Braunfels, TX MSA",2023,1,1283529,1234787,48742,3.8
MT4843300000000,48,43300,"Sherman-Denison, TX MSA",2023,1,68492,65814,2678,3.9
MT4845500000000,48,45500,"Texarkana, TX-AR MSA",2023,1,60510,58017,2493,4.1
MT4846340000000,48,46340,"Tyler, TX MSA",2023,1,114290,109939,4351,3.8
MT4847020000000,48,47020,"Victoria, TX MSA",2023,1,44431,42587,1844,4.2
MT4847380000000,48,47380,"Waco, TX MSA",2023,1,141176,135418,5758,4.1
MT4848660000000,48,48660,"Wichita Falls, TX MSA",2023,1,65974,63465,2509,3.8
MT4930860000000,49,30860,"Logan, UT-ID MSA",2023,1,79015,77165,1850,2.3
MT4936260000000,49,36260,"Ogden, UT MSA",2023,1,340985,332890,8095,2.4
MT4939340000000,49,39340,"Provo-Orem-Lehi, UT MSA",2023,1,359518,350642,8876,2.5
MT4941100000000,49,41100,"St. George, UT MSA",2023,1,88884,86402,2482,2.8
MT4941620000000,49,41620,"Salt Lake City-Murray, UT MSA",2023,1,717123,698922,18201,2.5
MT5015540000000,50,15540,"Burlington-South Burlington, VT MSA",2023,1,128016,125750,2266,1.8
MT5113980000000,51,13980,"Blacksburg-Christiansburg-Radford, VA MSA",2023,1,92089,89480,2609,2.8
MT5116820000000,51,16820,"Charlottesville, VA MSA",2023,1,117274,114250,3024,2.6
MT5125500000000,51,25500,"Harrisonburg, VA MSA",2023,1,72300,70420,1880,2.6
MT5131340000000,51,31340,"Lynchburg, VA MSA",2023,1,128040,124088,3952,3.1
MT5140060000000,51,40060,"Richmond, VA MSA",2023,1,715795,695525,20270,2.8
MT5140220000000,51,40220,"Roanoke, VA MSA",2023,1,156539,152149,4390,2.8
MT5144420000000,51,44420,"Staunton-Stuarts Draft, VA MSA",2023,1,65467,63900,1567,2.4
MT5147260000000,51,47260,"Virginia Beach-Chesapeake-Norfolk, VA-NC MSA",2023,1,872236,845652,26584,3
MT5149020000000,51,49020,"Winchester, VA-WV MSA",2023,1,76080,74089,1991,2.6
MT5313380000000,53,13380,"Bellingham, WA MSA",2023,1,114540,110049,4491,3.9
MT5314740000000,53,14740,"Bremerton-Silverdale-Port Orchard, WA MSA",2023,1,121798,116979,4819,4
MT5328420000000,53,28420,"Kennewick-Richland, WA MSA",2023,1,144876,138109,6767,4.7
MT5331020000000,53,31020,"Longview-Kelso, WA MSA",2023,1,47502,45211,2291,4.8
MT5334580000000,53,34580,"Mount Vernon-Anacortes, WA MSA",2023,1,57737,55234,2503,4.3
MT5336500000000,53,36500,"Olympia-Lacey-Tumwater, WA MSA",2023,1,140683,134976,5707,4.1
MT5342660000000,53,42660,"Seattle-Tacoma-Bellevue, WA MSA",2023,1,2277997,2189568,88429,3.9
MT5344060000000,53,44060,"Spokane-Spokane Valley, WA MSA",2023,1,280611,268914,11697,4.2
MT5347460000000,53,47460,"Walla Walla, WA MSA",2023,1,29613,28497,1116,3.8
MT5348300000000,53,48300,"Wenatchee-East Wenatchee, WA MSA",2023,1,61977,59189,2788,4.5
MT5349420000000,53,49420,"Yakima, WA MSA",2023,1,126591,119350,7241,5.7
MT5413220000000,54,13220,"Beckley, WV MSA",2023,1,45274,43715,1559,3.4
MT5416620000000,54,16620,"Charleston, WV MSA",2023,1,89903,86863,3040,3.4
MT5426580000000,54,26580,"Huntington-Ashland, WV-KY-OH MSA",2023,1,155014,148383,6631,4.3
MT5434060000000,54,34060,"Morgantown, WV MSA",2023,1,70792,68558,2234,3.2
MT5437620000000,54,37620,"Parkersburg-Vienna, WV MSA",2023,1,39021,37515,1506,3.9
MT5448540000000,54,48540,"Wheeling, WV-OH MSA",2023,1,59447,56862,2585,4.3
MT5511540000000,55,11540,"Appleton, WI MSA",2023,1,135591,132851,2740,2
MT5520740000000,55,20740,"Eau Claire, WI MSA",2023,1,94254,91795,2459,2.6
MT5522540000000,55,22540,"Fond du Lac, WI MSA",2023,1,55843,54580,1263,2.3
MT5524580000000,55,24580,"Green Bay, WI MSA",2023,1,177054,172992,4062,2.3
MT5527500000000,55,27500,"Janesville-Beloit, WI MSA",2023,1,85091,82585,2506,2.9
MT5528450000000,55,28450,"Kenosha, WI MSA",2023,1,93145,90485,2660,2.9
MT5529100000000,55,29100,"La Crosse-Onalaska, WI-MN MSA",2023,1,89314,87270,2044,2.3
MT5531540000000,55,31540,"Madison, WI MSA",2023,1,398110,390421,7689,1.9
MT5533340000000,55,33340,"Milwaukee-Waukesha, WI MSA",2023,1,808551,786257,22294,2.8
MT5536780000000,55,36780,"Oshkosh-Neenah, WI MSA",2023,1,91834,89813,2021,2.2
MT5539540000000,55,39540,"Racine-Mount Pleasant, WI MSA",2023,1,100029,97062,2967,3
MT5543100000000,55,43100,"Sheboygan, WI MSA",2023,1,62173,60876,1297,2.1
MT5548140000000,55,48140,"Wausau, WI MSA",2023,1,74533,72922,1611,2.2
MT5616220000000,56,16220,"Casper, WY MSA",2023,1,42065,40657,1408,3.3
MT5616940000000,56,16940,"Cheyenne, WY MSA",2023,1,48581,46971,1610,3.3
MT7210380000000,72,10380,"Aguadilla, PR MSA",2023,1,86962,80307,6655,7.7
MT7211640000000,72,11640,"Arecibo, PR MSA",2023,1,65244,60800,4444,6.8
MT7225020000000,72,25020,"Guayama, PR MSA",2023,1,18772,17143,1629,8.7
MT7232420000000,72,32420,"Mayaguez, PR MSA",2023,1,66098,61203,4895,7.4
MT7238660000000,72,38660,"Ponce, PR MSA",2023,1,88870,80793,8077,9.1
MT7241980000000,72,41980,"San Juan-Bayamon-Caguas, PR MSA",2023,1,807517,767932,39585,4.9
MT0111500000000,1,11500,"Anniston-Oxford, AL MSA",2023,2,49204,48086,1118,2.3
MT0112220000000,1,12220,"Auburn-Opelika, AL MSA",2023,2,93084,91063,2021,2.2
MT0113820000000,1,13820,"Birmingham, AL MSA",2023,2,559437,547804,11633,2.1
MT0119300000000,1,19300,"Daphne-Fairhope-Foley, AL MSA",2023,2,111942,109790,2152,1.9
MT0119460000000,1,19460,"Decatur, AL MSA",2023,2,73387,72043,1344,1.8
MT0120020000000,1,20020,"Dothan, AL MSA",2023,2,66544,65069,1475,2.2
MT0122520000000,1,22520,"Florence-Muscle Shoals, AL MSA",2023,2,67710,66109,1601,2.4
MT0123460000000,1,23460,"Gadsden, AL MSA",2023,2,41128,40191,937,2.3
MT0126620000000,1,26620,"Huntsville, AL MSA",2023,2,263010,258202,4808,1.8
MT0133660000000,1,33660,"Mobile, AL MSA",2023,2,182434,177276,5158,2.8
MT0133860000000,1,33860,"Montgomery, AL MSA",2023,2,172973,168647,4326,2.5
MT0146220000000,1,46220,"Tuscaloosa, AL MSA",2023,2,123338,120436,2902,2.4
MT0211260000000,2,11260,"Anchorage, AK MSA",2023,2,198632,191607,7025,3.5
MT0221820000000,2,21820,"Fairbanks-College, AK MSA",2023,2,44820,43211,1609,3.6
MT0422380000000,4,22380,"Flagstaff, AZ MSA",2023,2,73262,70375,2887,3.9
MT0429420000000,4,29420,"Lake Havasu City-Kingman, AZ MSA",2023,2,85906,82016,3890,4.5
MT0438060000000,4,38060,"Phoenix-Mesa-Chandler, AZ MSA",2023,2,2627644,2545445,82199,3.1
MT0439150000000,4,39150,"Prescott Valley-Prescott, AZ MSA",2023,2,105026,101300,3726,3.5
MT0443420000000,4,43420,"Sierra Vista-Douglas, AZ MSA",2023,2,47878,45722,2156,4.5
MT0446060000000,4,46060,"Tucson, AZ MSA",2023,2,490110,472766,17344,3.5
MT0449740000000,4,49740,"Yuma, AZ MSA",2023,2,98667,86493,12174,12.3
MT0522220000000,5,22220,"Fayetteville-Springdale-Rogers, AR MSA",2023,2,294437,287815,6622,2.2
MT0522900000000,5,22900,"Fort Smith, AR-OK MSA",2023,2,100521,97851,2670,2.7
MT0526300000000,5,26300,"Hot Springs, AR MSA",2023,2,43604,42223,1381,3.2
MT0527860000000,5,27860,"Jonesboro, AR MSA",2023,2,64703,63055,1648,2.5
MT0530780000000,5,30780,"Little Rock-North Little Rock-Conway, AR MSA",2023,2,368437,358598,9839,2.7
MT0612540000000,6,12540,"Bakersfield-Delano, CA MSA",2023,2,398200,367193,31007,7.8
MT0617020000000,6,17020,"Chico, CA MSA",2023,2,90631,86130,4501,5
MT0620940000000,6,20940,"El Centro, CA MSA",2023,2,70203,58159,12044,17.2
MT0623420000000,6,23420,"Fresno, CA MSA",2023,2,520578,484068,36510,7
MT0625260000000,6,25260,"Hanford-Corcoran, CA MSA",2023,2,55971,51469,4502,8
MT0631080000000,6,31080,"Los Angeles-Long Beach-Anaheim, CA MSA",2023,2,6648456,6349671,298785,4.5
MT0632900000000,6,32900,"Merced, CA MSA",2023,2,117267,107209,10058,8.6
MT0633700000000,6,33700,"Modesto, CA MSA",2023,2,247030,232374,14656,5.9
MT0634900000000,6,34900,"Napa, CA MSA",2023,2,72304,69936,2368,3.3
MT0637100000000,6,37100,"Oxnard-Thousand Oaks-Ventura, CA MSA",2023,2,413860,397850,16010,3.9
MT0639820000000,6,39820,"Redding, CA MSA",2023,2,77193,73588,3605,4.7
MT0640140000000,6,40140,"Riverside-San Bernardino-Ontario, CA MSA",2023,2,2161819,2066767,95052,4.4
MT0640900000000,6,40900,"Sacramento-Roseville-Folsom, CA MSA",2023,2,1154949,1109316,45633,4
MT0641500000000,6,41500,"Salinas, CA MSA",2023,2,213057,198423,14634,6.9
MT0641740000000,6,41740,"San Diego-Chula Vista-Carlsbad, CA MSA",2023,2,1630152,1574168,55984,3.4
MT0641860000000,6,41860,"San Francisco-Oakland-Fremont, CA MSA",2023,2,2516533,2435040,81493,3.2
MT0641940000000,6,41940,"San Jose-Sunnyvale-Santa Clara, CA MSA",2023,2,1056589,1023808,32781,3.1
MT0642020000000,6,42020,"San Luis Obispo-Paso Robles, CA MSA",2023,2,131905,127453,4452,3.4
MT0642100000000,6,42100,"Santa Cruz-Watsonville, CA MSA",2023,2,134696,127695,7001,5.2
MT0642200000000,6,42200,"Santa Maria-Santa Barbara, CA MSA",2023,2,218022,209627,8395,3.9
MT0642220000000,6,42220,"Santa Rosa-Petaluma, CA MSA",2023,2,245784,237620,8164,3.3
MT0644700000000,6,44700,"Stockton-Lodi, CA MSA",2023,2,359041,338881,20160,5.6
MT0646700000000,6,46700,"Vallejo, CA MSA",2023,2,211444,202586,8858,4.2
MT0647300000000,6,47300,"Visalia, CA MSA",2023,2,214149,194197,19952,9.3
MT0649700000000,6,49700,"Yuba City, CA MSA",2023,2,78671,73102,5569,7.1
MT0814500000000,8,14500,"Boulder, CO MSA",2023,2,192778,187630,5148,2.7
MT0817820000000,8,17820,"Colorado Springs, CO MSA",2023,2,385247,373478,11769,3.1
MT0819740000000,8,19740,"Denver-Aurora-Centennial, CO MSA",2023,2,1756276,1706379,49897,2.8
MT0822660000000,8,22660,"Fort Collins-Loveland, CO MSA",2023,2,203323,197717,5606,2.8
MT0824300000000,8,24300,"Grand Junction, CO MSA",2023,2,78227,75705,2522,3.2
MT0824540000000,8,24540,"Greeley, CO MSA",2023,2,172187,166811,5376,3.1
MT0839380000000,8,39380,"Pueblo, CO MSA",2023,2,73853,70656,3197,4.3
MT0914860000000,9,14860,"Bridgeport-Stamford-Danbury, CT MSA",2023,2,505734,489964,15770,3.1
MT0925540000000,9,25540,"Hartford-West Hartford-East Hartford, CT MSA",2023,2,602777,583032,19745,3.3
MT0935300000000,9,35300,"New Haven, CT MSA",2023,2,307512,297389,10123,3.3
MT0935980000000,9,35980,"Norwich-New London-Willimantic, CT MSA",2023,2,139761,135156,4605,3.3
MT0947930000000,9,47930,"Waterbury-Shelton, CT MSA",2023,2,237340,228486,8854,3.7
MT1020100000000,10,20100,"Dover, DE MSA",2023,2,85010,81446,3564,4.2
MT1147900000000,11,47900,"Washington-Arlington-Alexandria, DC-VA-MD-WV MSA",2023,2,3496851,3408930,87921,2.5
MT1215980000000,12,15980,"Cape Coral-Fort Myers, FL MSA",2023,2,365830,353552,12278,3.4
MT1218880000000,12,18880,"Crestview-Fort Walton Beach-Destin, FL MSA",2023,2,141231,137778,3453,2.4
MT1219660000000,12,19660,"Deltona-Daytona Beach-Ormond Beach, FL MSA",2023,2,314888,304656,10232,3.2
MT1223540000000,12,23540,"Gainesville, FL MSA",2023,2,168386,163355,5031,3
MT1226140000000,12,26140,"Homosassa Springs, FL MSA",2023,2,53270,51140,2130,4
MT1227260000000,12,27260,"Jacksonville, FL MSA",2023,2,843247,818871,24376,2.9
MT1229460000000,12,29460,"Lakeland-Winter Haven, FL MSA",2023,2,352082,339780,12302,3.5
MT1233100000000,12,33100,"Miami-Fort Lauderdale-West Palm Beach, FL MSA",2023,2,3240611,3161423,79188,2.4
MT1234940000000,12,34940,"Naples-Marco Island, FL MSA",2023,2,178008,172617,5391,3
MT1235840000000,12,35840,"North Port-Bradenton-Sarasota, FL MSA",2023,2,386199,374854,11345,2.9
MT1236100000000,12,36100,"Ocala, FL MSA",2023,2,155300,150018,5282,3.4
MT1236740000000,12,36740,"Orlando-Kissimmee-Sanford, FL MSA",2023,2,1497859,1456020,41839,2.8
MT1237340000000,12,37340,"Palm Bay-Melbourne-Titusville, FL MSA",2023,2,300482,291863,8619,2.9
MT1237460000000,12,37460,"Panama City-Panama City Beach, FL MSA",2023,2,99206,96502,2704,2.7
MT1237860000000,12,37860,"Pensacola-Ferry Pass-Brent, FL MSA",2023,2,238142,231306,6836,2.9
MT1238940000000,12,38940,"Port St. Lucie, FL MSA",2023,2,234936,227384,7552,3.2
MT1239460000000,12,39460,"Punta Gorda, FL MSA",2023,2,74561,71844,2717,3.6
MT1242680000000,12,42680,"Sebastian-Vero Beach-West Vero Corridor, FL MSA",2023,2,67113,64758,2355,3.5
MT1242700000000,12,42700,"Sebring, FL MSA",2023,2,36380,34868,1512,4.2
MT1245220000000,12,45220,"Tallahassee, FL MSA",2023,2,203033,197077,5956,2.9
MT1245300000000,12,45300,"Tampa-St. Petersburg-Clearwater, FL MSA",2023,2,1678286,1631546,46740,2.8
MT1248680000000,12,48680,"Wildwood-The Villages, FL MSA",2023,2,32811,31232,1579,4.8
MT1310500000000,13,10500,"Albany, GA MSA",2023,2,63126,60634,2492,3.9
MT1312020000000,13,12020,"Athens-Clarke County, GA MSA",2023,2,104574,101369,3205,3.1
MT1312060000000,13,12060,"Atlanta-Sandy Springs-Roswell, GA MSA",2023,2,3244979,3141576,103403,3.2
MT1312260000000,13,12260,"Augusta-Richmond County, GA-SC MSA",2023,2,265806,255895,9911,3.7
MT1315260000000,13,15260,"Brunswick-St. Simons, GA MSA",2023,2,53703,52105,1598,3
MT1317980000000,13,17980,"Columbus, GA-AL MSA",2023,2,129339,124533,4806,3.7
MT1319140000000,13,19140,"Dalton, GA MSA",2023,2,66940,64455,2485,3.7
MT1323580000000,13,23580,"Gainesville, GA MSA",2023,2,106367,103525,2842,2.7
MT1325980000000,13,25980,"Hinesville, GA MSA",2023,2,31137,29924,1213,3.9
MT1331420000000,13,31420,"Macon-Bibb County, GA MSA",2023,2,97483,93738,3745,3.8
MT1340660000000,13,40660,"Rome, GA MSA",2023,2,46718,45191,1527,3.3
MT1342340000000,13,42340,"Savannah, GA MSA",2023,2,206098,199925,6173,3
MT1346660000000,13,46660,"Valdosta, GA MSA",2023,2,60647,58427,2220,3.7
MT1347580000000,13,47580,"Warner Robins, GA MSA",2023,2,88835,86036,2799,3.2
MT1527980000000,15,27980,"Kahului-Wailuku, HI MSA",2023,2,84229,81712,2517,3
MT1546520000000,15,46520,"Urban Honolulu, HI MSA",2023,2,468263,454683,13580,2.9
MT1614260000000,16,14260,"Boise City, ID MSA",2023,2,431907,420229,11678,2.7
MT1617660000000,16,17660,"Coeur d'Alene, ID MSA",2023,2,87742,84633,3109,3.5
MT1626820000000,16,26820,"Idaho Falls, ID MSA",2023,2,82274,80136,2138,2.6
MT1630300000000,16,30300,"Lewiston, ID-WA MSA",2023,2,30408,29534,874,2.9
MT1638540000000,16,38540,"Pocatello, ID MSA",2023,2,39818,38625,1193,3
MT1646300000000,16,46300,"Twin Falls, ID MSA",2023,2,58868,57111,1757,3
MT1714010000000,17,14010,"Bloomington, IL MSA",2023,2,92626,89412,3214,3.5
MT1716580000000,17,16580,"Champaign-Urbana, IL MSA",2023,2,122165,117362,4803,3.9
MT1716980000000,17,16980,"Chicago-Naperville-Elgin, IL-IN MSA",2023,2,4870295,4666097,204198,4.2
MT1719340000000,17,19340,"Davenport-Moline-Rock Island, IA-IL MSA",2023,2,189641,182093,7548,4
MT1719500000000,17,19500,"Decatur, IL MSA",2023,2,45243,42682,2561,5.7
MT1728100000000,17,28100,"Kankakee, IL MSA",2023,2,50236,47401,2835,5.6
MT1737900000000,17,37900,"Peoria, IL MSA",2023,2,173105,165071,8034,4.6
MT1740420000000,17,40420,"Rockford, IL MSA",2023,2,158742,149507,9235,5.8
MT1744100000000,17,44100,"Springfield, IL MSA",2023,2,102169,97963,4206,4.1
MT1814020000000,18,14020,"Bloomington, IN MSA",2023,2,85108,82693,2415,2.8
MT1818020000000,18,18020,"Columbus, IN MSA",2023,2,39637,38476,1161,2.9
MT1821140000000,18,21140,"Elkhart-Goshen, IN MSA",2023,2,103870,99703,4167,4
MT1821780000000,18,21780,"Evansville, IN MSA",2023,2,134951,130823,4128,3.1
MT1823060000000,18,23060,"Fort Wayne, IN MSA",2023,2,228999,222330,6669,2.9
MT1826900000000,18,26900,"Indianapolis-Carmel-Greenwood, IN MSA",2023,2,1112883,1079640,33243,3
MT1829020000000,18,29020,"Kokomo, IN MSA",2023,2,35552,33893,1659,4.7
MT1829200000000,18,29200,"Lafayette-West Lafayette, IN MSA",2023,2,119320,115999,3321,2.8
MT1833140000000,18,33140,"Michigan City-La Porte, IN MSA",2023,2,51375,49447,1928,3.8
MT1834620000000,18,34620,"Muncie, IN MSA",2023,2,51629,49774,1855,3.6
MT1843780000000,18,43780,"South Bend-Mishawaka, IN-MI MSA",2023,2,155344,149222,6122,3.9
MT1845460000000,18,45460,"Terre Haute, IN MSA",2023,2,76616,73913,2703,3.5
MT1911180000000,19,11180,"Ames, IA MSA",2023,2,69379,67755,1624,2.3
MT1916300000000,19,16300,"Cedar Rapids, IA MSA",2023,2,149081,144255,4826,3.2
MT1919780000000,19,19780,"Des Moines-West Des Moines, IA MSA",2023,2,405816,394430,11386,2.8
MT1920220000000,19,20220,"Dubuque, IA MSA",2023,2,53951,52329,1622,3
MT1926980000000,19,26980,"Iowa City, IA MSA",2023,2,98892,96480,2412,2.4
MT1943580000000,19,43580,"Sioux City, IA-NE-SD MSA",2023,2,77016,74919,2097,2.7
MT1947940000000,19,47940,"Waterloo-Cedar Falls, IA MSA",2023,2,88813,86125,2688,3
MT2029940000000,20,29940,"Lawrence, KS MSA",2023,2,69775,67885,1890,2.7
MT2031740000000,20,31740,"Manhattan, KS MSA",2023,2,63471,61629,1842,2.9
MT2045820000000,20,45820,"Topeka, KS MSA",2023,2,117647,114039,3608,3.1
MT2048620000000,20,48620,"Wichita, KS MSA",2023,2,329494,319397,10097,3.1
MT2114540000000,21,14540,"Bowling Green, KY MSA",2023,2,90416,86962,3454,3.8
MT2121060000000,21,21060,"Elizabethtown, KY MSA",2023,2,53634,51383,2251,4.2
MT2130460000000,21,30460,"Lexington-Fayette, KY MSA",2023,2,270157,261182,8975,3.3
MT2131140000000,21,31140,"Louisville/Jefferson County, KY-IN MSA",2023,2,687968,662396,25572,3.7
MT2136980000000,21,36980,"Owensboro, KY MSA",2023,2,51076,48941,2135,4.2
MT2137140000000,21,37140,"Paducah, KY-IL MSA",2023,2,45539,43688,1851,4.1
MT2210780000000,22,10780,"Alexandria, LA MSA",2023,2,64591,62405,2186,3.4
MT2212940000000,22,12940,"Baton Rouge, LA MSA",2023,2,419839,405178,14661,3.5
MT2225220000000,22,25220,"Hammond, LA MSA",2023,2,60099,57643,2456,4.1
MT2226380000000,22,26380,"Houma-Bayou Cane-Thibodaux, LA MSA",2023,2,87388,84598,2790,3.2
MT2229180000000,22,29180,"Lafayette, LA MSA",2023,2,196826,190772,6054,3.1
MT2229340000000,22,29340,"Lake Charles, LA MSA",2023,2,98816,95129,3687,3.7
MT2233740000000,22,33740,"Monroe, LA MSA",2023,2,96437,92543,3894,4
MT2235380000000,22,35380,"New Orleans-Metairie, LA MSA",2023,2,468977,451367,17610,3.8
MT2243340000000,22,43340,"Shreveport-Bossier City, LA MSA",2023,2,169658,163423,6235,3.7
MT2243640000000,22,43640,"Slidell-Mandeville-Covington, LA MSA",2023,2,128271,124423,3848,3
MT2312620000000,23,12620,"Bangor, ME MSA",2023,2,73079,71238,1841,2.5
MT2330340000000,23,30340,"Lewiston-Auburn, ME MSA",2023,2,53970,52547,1423,2.6
MT2338860000000,23,38860,"Portland-South Portland, ME MSA",2023,2,304397,298235,6162,2
MT2412580000000,24,12580,"Baltimore-Columbia-Towson, MD MSA",2023,2,1461881,1429519,32362,2.2
MT2425180000000,24,25180,"Hagerstown-Martinsburg, MD-WV MSA",2023,2,141560,137818,3742,2.6
MT2430500000000,24,30500,"Lexington Park, MD MSA",2023,2,105597,103428,2169,2.1
MT2441540000000,24,41540,"Salisbury, MD MSA",2023,2,62353,60756,1597,2.6
MT2511200000000,25,11200,"Amherst Town-Northampton, MA MSA",2023,2,83169,80439,2730,3.3
MT2512700000000,25,12700,"Barnstable Town, MA MSA",2023,2,113566,108471,5095,4.5
MT2514460000000,25,14460,"Boston-Cambridge-Newton, MA-NH MSA",2023,2,2747948,2661640,86308,3.1
MT2538340000000,25,38340,"Pittsfield, MA MSA",2023,2,63380,60936,2444,3.9
MT2544140000000,25,44140,"Springfield, MA MSA",2023,2,220403,210456,9947,4.5
MT2549340000000,25,49340,"Worcester, MA MSA",2023,2,452419,435762,16657,3.7
MT2611460000000,26,11460,"Ann Arbor, MI MSA",2023,2,202574,195778,6796,3.4
MT2612980000000,26,12980,"Battle Creek, MI MSA",2023,2,61459,58689,2770,4.5
MT2613020000000,26,13020,"Bay City, MI MSA",2023,2,49303,46742,2561,5.2
MT2619820000000,26,19820,"Detroit-Warren-Dearborn, MI MSA",2023,2,2140347,2066635,73712,3.4
MT2622420000000,26,22420,"Flint, MI MSA",2023,2,185144,175635,9509,5.1
MT2624340000000,26,24340,"Grand Rapids-Wyoming-Kentwood, MI MSA",2023,2,617409,596463,20946,3.4
MT2627100000000,26,27100,"Jackson, MI MSA",2023,2,74344,71151,3193,4.3
MT2628020000000,26,28020,"Kalamazoo-Portage, MI MSA",2023,2,137157,132079,5078,3.7
MT2629620000000,26,29620,"Lansing-East Lansing, MI MSA",2023,2,246428,236596,9832,4
MT2633220000000,26,33220,"Midland, MI MSA",2023,2,40691,39009,1682,4.1
MT2633780000000,26,33780,"Monroe, MI MSA",2023,2,76028,72613,3415,4.5
MT2634740000000,26,34740,"Muskegon-Norton Shores, MI MSA",2023,2,82591,78918,3673,4.4
MT2635660000000,26,35660,"Niles, MI MSA",2023,2,74799,71556,3243,4.3
MT2640980000000,26,40980,"Saginaw, MI MSA",2023,2,83751,79160,4591,5.5
MT2645900000000,26,45900,"Traverse City, MI MSA",2023,2,79672,76488,3184,4
MT2720260000000,27,20260,"Duluth, MN-WI MSA",2023,2,139128,134242,4886,3.5
MT2731860000000,27,31860,"Mankato, MN MSA",2023,2,59806,58353,1453,2.4
MT2733460000000,27,33460,"Minneapolis-St. Paul-Bloomington, MN-WI MSA",2023,2,2055012,2000509,54503,2.7
MT2740340000000,27,40340,"Rochester, MN MSA",2023,2,125102,122075,3027,2.4
MT2741060000000,27,41060,"St. Cloud, MN MSA",2023,2,109378,106041,3337,3.1
MT2825060000000,28,25060,"Gulfport-Biloxi, MS MSA",2023,2,182690,177142,5548,3
MT2825620000000,28,25620,"Hattiesburg, MS MSA",2023,2,69685,67566,2119,3
MT2827140000000,28,27140,"Jackson, MS MSA",2023,2,276373,268296,8077,2.9
MT2916020000000,29,16020,"Cape Girardeau, MO-IL MSA",2023,2,48531,47252,1279,2.6
MT2917860000000,29,17860,"Columbia, MO MSA",2023,2,113448,110715,2733,2.4
MT2927620000000,29,27620,"Jefferson City, MO MSA",2023,2,74289,72510,1779,2.4
MT2927900000000,29,27900,"Joplin, MO-KS MSA",2023,2,96450,93801,2649,2.7
MT2928140000000,29,28140,"Kansas City, MO-KS MSA",2023,2,1173687,1139725,33962,2.9
MT2941140000000,29,41140,"St. Joseph, MO-KS MSA",2023,2,53536,51994,1542,2.9
MT2941180000000,29,41180,"St. Louis, MO-IL MSA",2023,2,1460833,1417181,43652,3
MT2944180000000,29,44180,"Springfield, MO MSA",2023,2,237288,231376,5912,2.5
MT3013740000000,30,13740,"Billings, MT MSA",2023,2,98760,96617,2143,2.2
MT3014580000000,30,14580,"Bozeman, MT MSA",2023,2,75852,74440,1412,1.9
MT3024500000000,30,24500,"Great Falls, MT MSA",2023,2,39433,38482,951,2.4
MT3025740000000,30,25740,"Helena, MT MSA",2023,2,47269,46172,1097,2.3
MT3033540000000,30,33540,"Missoula, MT MSA",2023,2,73254,71604,1650,2.3
MT3124260000000,31,24260,"Grand Island, NE MSA",2023,2,42186,41279,907,2.2
MT3130700000000,31,30700,"Lincoln, NE MSA",2023,2,190943,187202,3741,2
MT3136540000000,31,36540,"Omaha, NE-IA MSA",2023,2,518149,506149,12000,2.3
MT3216180000000,32,16180,"Carson City, NV MSA",2023,2,28539,27280,1259,4.4
MT3229820000000,32,29820,"Las Vegas-Henderson-North Las Vegas, NV MSA",2023,2,1177222,1114334,62888,5.3
MT3239900000000,32,39900,"Reno, NV MSA",2023,2,294077,281077,13000,4.4
MT3331700000000,33,31700,"Manchester-Nashua, NH MSA",2023,2,238859,233111,5748,2.4
MT3412100000000,34,12100,"Atlantic City-Hammonton, NJ MSA",2023,2,179573,169802,9771,5.4
MT3445940000000,34,45940,"Trenton-Princeton, NJ MSA",2023,2,198728,191204,7524,3.8
MT3447220000000,34,47220,"Vineland, NJ MSA",2023,2,65574,61594,3980,6.1
MT3510740000000,35,10740,"Albuquerque, NM MSA",2023,2,453783,439046,14737,3.2
MT3522140000000,35,22140,"Farmington, NM MSA",2023,2,49197,47118,2079,4.2
MT3529740000000,35,29740,"Las Cruces, NM MSA",2023,2,99193,94999,4194,4.2
MT3542140000000,35,42140,"Santa Fe, NM MSA",2023,2,72932,70654,2278,3.1
MT3610580000000,36,10580,"Albany-Schenectady-Troy, NY MSA",2023,2,454562,441379,13183,2.9
MT3613780000000,36,13780,"Binghamton, NY MSA",2023,2,106163,102639,3524,3.3
MT3615380000000,36,15380,"Buffalo-Cheektowaga, NY MSA",2023,2,558303,539725,18578,3.3
MT3621300000000,36,21300,"Elmira, NY MSA",2023,2,35362,34150,1212,3.4
MT3624020000000,36,24020,"Glens Falls, NY MSA",2023,2,59662,57881,1781,3
MT3627060000000,36,27060,"Ithaca, NY MSA",2023,2,48179,46773,1406,2.9
MT3628740000000,36,28740,"Kingston, NY MSA",2023,2,86560,83934,2626,3
MT3628880000000,36,28880,"Kiryas Joel-Poughkeepsie-Newburgh, NY MSA",2023,2,335767,325627,10140,3
MT3635620000000,36,35620,"New York-Newark-Jersey City, NY-NJ MSA",2023,2,10059763,9641454,418309,4.2
MT3640380000000,36,40380,"Rochester, NY MSA",2023,2,512097,495958,16139,3.2
MT3645060000000,36,45060,"Syracuse, NY MSA",2023,2,309217,299336,9881,3.2
MT3646540000000,36,46540,"Utica-Rome, NY MSA",2023,2,127699,123471,4228,3.3
MT3648060000000,36,48060,"Watertown-Fort Drum, NY MSA",2023,2,44941,43271,1670,3.7
MT3711700000000,37,11700,"Asheville, NC MSA",2023,2,210033,204035,5998,2.9
MT3715500000000,37,15500,"Burlington, NC MSA",2023,2,84717,81750,2967,3.5
MT3716740000000,37,16740,"Charlotte-Concord-Gastonia, NC-SC MSA",2023,2,1456605,1407927,48678,3.3
MT3720500000000,37,20500,"Durham-Chapel Hill, NC MSA",2023,2,318274,308337,9937,3.1
MT3722180000000,37,22180,"Fayetteville, NC MSA",2023,2,154469,147461,7008,4.5
MT3724140000000,37,24140,"Goldsboro, NC MSA",2023,2,50349,48507,1842,3.7
MT3724660000000,37,24660,"Greensboro-High Point, NC MSA",2023,2,373173,358744,14429,3.9
MT3724780000000,37,24780,"Greenville, NC MSA",2023,2,82797,79370,3427,4.1
MT3725860000000,37,25860,"Hickory-Lenoir-Morganton, NC MSA",2023,2,173095,167579,5516,3.2
MT3727340000000,37,27340,"Jacksonville, NC MSA",2023,2,73390,70688,2702,3.7
MT3738240000000,37,38240,"Pinehurst-Southern Pines, NC MSA",2023,2,43717,42211,1506,3.4
MT3739580000000,37,39580,"Raleigh-Cary, NC MSA",2023,2,822720,798129,24591,3
MT3740580000000,37,40580,"Rocky Mount, NC MSA",2023,2,63620,60440,3180,5
MT3748900000000,37,48900,"Wilmington, NC MSA",2023,2,219473,211682,7791,3.5
MT3749180000000,37,49180,"Winston-Salem, NC MSA",2023,2,325020,313563,11457,3.5
MT3813900000000,38,13900,"Bismarck, ND MSA",2023,2,72313,70917,1396,1.9
MT3822020000000,38,22020,"Fargo, ND-MN MSA",2023,2,151325,148519,2806,1.9
MT3824220000000,38,24220,"Grand Forks, ND-MN MSA",2023,2,54926,53761,1165,2.1
MT3833500000000,38,33500,"Minot, ND MSA",2023,2,39725,38921,804,2
MT3910420000000,39,10420,"Akron, OH MSA",2023,2,358153,345245,12908,3.6
MT3915940000000,39,15940,"Canton-Massillon, OH MSA",2023,2,189994,182885,7109,3.7
MT3917140000000,39,17140,"Cincinnati, OH-KY-IN MSA",2023,2,1158367,1119924,38443,3.3
MT3917410000000,39,17410,"Cleveland, OH MSA",2023,2,1079383,1038846,40537,3.8
MT3918140000000,39,18140,"Columbus, OH MSA",2023,2,1128033,1091881,36152,3.2
MT3919430000000,39,19430,"Dayton-Kettering-Beavercreek, OH MSA",2023,2,386080,372319,13761,3.6
MT3930620000000,39,30620,"Lima, OH MSA",2023,2,47518,45740,1778,3.7
MT3931900000000,39,31900,"Mansfield, OH MSA",2023,2,52243,50031,2212,4.2
MT3941780000000,39,41780,"Sandusky, OH MSA",2023,2,56075,53496,2579,4.6
MT3944220000000,39,44220,"Springfield, OH MSA",2023,2,61498,59249,2249,3.7
MT3945780000000,39,45780,"Toledo, OH MSA",2023,2,292342,280783,11559,4
MT3948260000000,39,48260,"Weirton-Steubenville, WV-OH MSA",2023,2,52190,49686,2504,4.8
MT3949660000000,39,49660,"Youngstown-Warren, OH MSA",2023,2,190465,182442,8023,4.2
MT4021420000000,40,21420,"Enid, OK MSA",2023,2,28133,27347,786,2.8
MT4030020000000,40,30020,"Lawton, OK MSA",2023,2,51088,49349,1739,3.4
MT4036420000000,40,36420,"Oklahoma City, OK MSA",2023,2,749626,728742,20884,2.8
MT4046140000000,40,46140,"Tulsa, OK MSA",2023,2,507694,492700,14994,3
MT4110540000000,41,10540,"Albany, OR MSA",2023,2,60961,58511,2450,4
MT4113460000000,41,13460,"Bend, OR MSA",2023,2,128777,123843,4934,3.8
MT4118700000000,41,18700,"Corvallis, OR MSA",2023,2,48822,47310,1512,3.1
MT4121660000000,41,21660,"Eugene-Springfield, OR MSA",2023,2,185774,178447,7327,3.9
MT4124420000000,41,24420,"Grants Pass, OR MSA",2023,2,34818,32941,1877,5.4
MT4132780000000,41,32780,"Medford, OR MSA",2023,2,103438,98744,4694,4.5
MT4138900000000,41,38900,"Portland-Vancouver-Hillsboro, OR-WA MSA",2023,2,1371882,1325155,46727,3.4
MT4141420000000,41,41420,"Salem, OR MSA",2023,2,215667,207713,7954,3.7
MT4210900000000,42,10900,"Allentown-Bethlehem-Easton, PA-NJ MSA",2023,2,446785,429306,17479,3.9
MT4211020000000,42,11020,"Altoona, PA MSA",2023,2,56950,54746,2204,3.9
MT4216540000000,42,16540,"Chambersburg, PA MSA",2023,2,76734,74223,2511,3.3
MT4221500000000,42,21500,"Erie, PA MSA",2023,2,125960,120666,5294,4.2
MT4223900000000,42,23900,"Gettysburg, PA MSA",2023,2,52292,50701,1591,3
MT4225420000000,42,25420,"Harrisburg-Carlisle, PA MSA",2023,2,309500,299422,10078,3.3
MT4227780000000,42,27780,"Johnstown, PA MSA",2023,2,56985,54390,2595,4.6
MT4229540000000,42,29540,"Lancaster, PA MSA",2023,2,289760,281125,8635,3
MT4230140000000,42,30140,"Lebanon, PA MSA",2023,2,72140,69845,2295,3.2
MT4237980000000,42,37980,"Philadelphia-Camden-Wilmington, PA-NJ-DE-MD MSA",2023,2,3261418,3140778,120640,3.7
MT4238300000000,42,38300,"Pittsburgh, PA MSA",2023,2,1224898,1177034,47864,3.9
MT4239740000000,42,39740,"Reading, PA MSA",2023,2,217389,209304,8085,3.7
MT4242540000000,42,42540,"Scranton--Wilkes-Barre, PA MSA",2023,2,277189,264568,12621,4.6
MT4244300000000,42,44300,"State College, PA MSA",2023,2,77129,74751,2378,3.1
MT4248700000000,42,48700,"Williamsport, PA MSA",2023,2,52473,50298,2175,4.1
MT4249620000000,42,49620,"York-Hanover, PA MSA",2023,2,237320,229438,7882,3.3
MT4439300000000,44,39300,"Providence-Warwick, RI-MA MSA",2023,2,873546,844399,29147,3.3
MT4516700000000,45,16700,"Charleston-North Charleston, SC MSA",2023,2,423704,412480,11224,2.6
MT4517900000000,45,17900,"Columbia, SC MSA",2023,2,405498,393255,12243,3
MT4522500000000,45,22500,"Florence, SC MSA",2023,2,90996,87996,3000,3.3
MT4524860000000,45,24860,"Greenville-Anderson-Greer, SC MSA",2023,2,465930,453090,12840,2.8
MT4525940000000,45,25940,"Hilton Head Island-Bluffton-Port Royal, SC MSA",2023,2,95616,93005,2611,2.7
MT4534820000000,45,34820,"Myrtle Beach-Conway-North Myrtle Beach, SC MSA",2023,2,165179,159239,5940,3.6
MT4543900000000,45,43900,"Spartanburg, SC MSA",2023,2,170684,165296,5388,3.2
MT4544940000000,45,44940,"Sumter, SC MSA",2023,2,41045,39380,1665,4.1
MT4639660000000,46,39660,"Rapid City, SD MSA",2023,2,78032,76655,1377,1.8
MT4643620000000,46,43620,"Sioux Falls, SD-MN MSA",2023,2,169645,166771,2874,1.7
MT4716860000000,47,16860,"Chattanooga, TN-GA MSA",2023,2,282636,274005,8631,3.1
MT4717300000000,47,17300,"Clarksville, TN-KY MSA",2023,2,134939,129774,5165,3.8
MT4717420000000,47,17420,"Cleveland, TN MSA",2023,2,56103,54081,2022,3.6
MT4727180000000,47,27180,"Jackson, TN MSA",2023,2,77582,74738,2844,3.7
MT4727740000000,47,27740,"Johnson City, TN MSA",2023,2,95524,92320,3204,3.4
MT4728700000000,47,28700,"Kingsport-Bristol, TN-VA MSA",2023,2,130996,126539,4457,3.4
MT4728940000000,47,28940,"Knoxville, TN MSA",2023,2,442257,428836,13421,3
MT4732820000000,47,32820,"Memphis, TN-MS-AR MSA",2023,2,624061,599774,24287,3.9
MT4734100000000,47,34100,"Morristown, TN MSA",2023,2,52590,50695,1895,3.6
MT4734980000000,47,34980,"Nashville-Davidson--Murfreesboro--Franklin, TN MSA",2023,2,1133123,1102752,30371,2.7
MT4810180000000,48,10180,"Abilene, TX MSA",2023,2,83880,80793,3087,3.7
MT4811100000000,48,11100,"Amarillo, TX MSA",2023,2,133369,129093,4276,3.2
MT4812420000000,48,12420,"Austin-Round Rock-San Marcos, TX MSA",2023,2,1438814,1390662,48152,3.3
MT4813140000000,48,13140,"Beaumont-Port Arthur, TX MSA",2023,2,173845,163746,10099,5.8
MT4815180000000,48,15180,"Brownsville-Harlingen, TX MSA",2023,2,183857,173628,10229,5.6
MT4817780000000,48,17780,"College Station-Bryan, TX MSA",2023,2,144392,139176,5216,3.6
MT4818580000000,48,18580,"Corpus Christi, TX MSA",2023,2,204019,194639,9380,4.6
MT4819100000000,48,19100,"Dallas-Fort Worth-Arlington, TX MSA",2023,2,4340545,4176851,163694,3.8
MT4820580000000,48,20580,"Eagle Pass, TX MSA",2023,2,23717,21845,1872,7.9
MT4821340000000,48,21340,"El Paso, TX MSA",2023,2,394648,377656,16992,4.3
MT4826420000000,48,26420,"Houston-Pasadena-The Woodlands, TX MSA",2023,2,3696779,3538406,158373,4.3
MT4828660000000,48,28660,"Killeen-Temple, TX MSA",2023,2,196007,187103,8904,4.5
MT4829700000000,48,29700,"Laredo, TX MSA",2023,2,114048,109192,4856,4.3
MT4830980000000,48,30980,"Longview, TX MSA",2023,2,128460,122848,5612,4.4
MT4831180000000,48,31180,"Lubbock, TX MSA",2023,2,178352,171952,6400,3.6
MT4832580000000,48,32580,"McAllen-Edinburg-Mission, TX MSA",2023,2,384491,360297,24194,6.3
MT4833260000000,48,33260,"Midland, TX MSA",2023,2,98241,95326,2915,3
MT4836220000000,48,36220,"Odessa, TX MSA",2023,2,82559,79622,2937,3.6
MT4841660000000,48,41660,"San Angelo, TX MSA",2023,2,60113,58137,1976,3.3
MT4841700000000,48,41700,"San Antonio-New Braunfels, TX MSA",2023,2,1288139,1239039,49100,3.8
MT4843300000000,48,43300,"Sherman-Denison, TX MSA",2023,2,68778,66089,2689,3.9
MT4845500000000,48,45500,"Texarkana, TX-AR MSA",2023,2,60574,58102,2472,4.1
MT4846340000000,48,46340,"Tyler, TX MSA",2023,2,114759,110374,4385,3.8
MT4847020000000,48,47020,"Victoria, TX MSA",2023,2,44491,42651,1840,4.1
MT4847380000000,48,47380,"Waco, TX MSA",2023,2,141565,135749,5816,4.1
MT4848660000000,48,48660,"Wichita Falls, TX MSA",2023,2,66162,63637,2525,3.8
MT4930860000000,49,30860,"Logan, UT-ID MSA",2023,2,79022,77181,1841,2.3
MT4936260000000,49,36260,"Ogden, UT MSA",2023,2,342384,334238,8146,2.4
MT4939340000000,49,39340,"Provo-Orem-Lehi, UT MSA",2023,2,360192,351271,8921,2.5
MT4941100000000,49,41100,"St. George, UT MSA",2023,2,89377,86882,2495,2.8
MT4941620000000,49,41620,"Salt Lake City-Murray, UT MSA",2023,2,718785,700437,18348,2.6
MT5015540000000,50,15540,"Burlington-South Burlington, VT MSA",2023,2,128436,126240,2196,1.7
MT5113980000000,51,13980,"Blacksburg-Christiansburg-Radford, VA MSA",2023,2,92363,89807,2556,2.8
MT5116820000000,51,16820,"Charlottesville, VA MSA",2023,2,117594,114610,2984,2.5
MT5125500000000,51,25500,"Harrisonburg, VA MSA",2023,2,72472,70622,1850,2.6
MT5131340000000,51,31340,"Lynchburg, VA MSA",2023,2,128318,124381,3937,3.1
MT5140060000000,51,40060,"Richmond, VA MSA",2023,2,718578,698471,20107,2.8
MT5140220000000,51,40220,"Roanoke, VA MSA",2023,2,156824,152467,4357,2.8
MT5144420000000,51,44420,"Staunton-Stuarts Draft, VA MSA",2023,2,65583,64023,1560,2.4
MT5147260000000,51,47260,"Virginia Beach-Chesapeake-Norfolk, VA-NC MSA",2023,2,874552,848253,26299,3
MT5149020000000,51,49020,"Winchester, VA-WV MSA",2023,2,76291,74324,1967,2.6
MT5313380000000,53,13380,"Bellingham, WA MSA",2023,2,114430,110125,4305,3.8
MT5314740000000,53,14740,"Bremerton-Silverdale-Port Orchard, WA MSA",2023,2,121629,116983,4646,3.8
MT5328420000000,53,28420,"Kennewick-Richland, WA MSA",2023,2,144527,137949,6578,4.6
MT5331020000000,53,31020,"Longview-Kelso, WA MSA",2023,2,47422,45221,2201,4.6
MT5334580000000,53,34580,"Mount Vernon-Anacortes, WA MSA",2023,2,57713,55306,2407,4.2
MT5336500000000,53,36500,"Olympia-Lacey-Tumwater, WA MSA",2023,2,140702,135210,5492,3.9
MT5342660000000,53,42660,"Seattle-Tacoma-Bellevue, WA MSA",2023,2,2286945,2198213,88732,3.9
MT5344060000000,53,44060,"Spokane-Spokane Valley, WA MSA",2023,2,280154,269026,11128,4
MT5347460000000,53,47460,"Walla Walla, WA MSA",2023,2,29577,28495,1082,3.7
MT5348300000000,53,48300,"Wenatchee-East Wenatchee, WA MSA",2023,2,61844,59159,2685,4.3
MT5349420000000,53,49420,"Yakima, WA MSA",2023,2,126038,119142,6896,5.5
MT5413220000000,54,13220,"Beckley, WV MSA",2023,2,45383,43828,1555,3.4
MT5416620000000,54,16620,"Charleston, WV MSA",2023,2,90176,87167,3009,3.3
MT5426580000000,54,26580,"Huntington-Ashland, WV-KY-OH MSA",2023,2,155118,148500,6618,4.3
MT5434060000000,54,34060,"Morgantown, WV MSA",2023,2,70897,68687,2210,3.1
MT5437620000000,54,37620,"Parkersburg-Vienna, WV MSA",2023,2,39063,37569,1494,3.8
MT5448540000000,54,48540,"Wheeling, WV-OH MSA",2023,2,59621,57107,2514,4.2
MT5511540000000,55,11540,"Appleton, WI MSA",2023,2,135699,132999,2700,2
MT5520740000000,55,20740,"Eau Claire, WI MSA",2023,2,94518,92060,2458,2.6
MT5522540000000,55,22540,"Fond du Lac, WI MSA",2023,2,55936,54679,1257,2.2
MT5524580000000,55,24580,"Green Bay, WI MSA",2023,2,177290,173285,4005,2.3
MT5527500000000,55,27500,"Janesville-Beloit, WI MSA",2023,2,85384,82864,2520,3
MT5528450000000,55,28450,"Kenosha, WI MSA",2023,2,93409,90733,2676,2.9
MT5529100000000,55,29100,"La Crosse-Onalaska, WI-MN MSA",2023,2,89474,87464,2010,2.2
MT5531540000000,55,31540,"Madison, WI MSA",2023,2,399131,391531,7600,1.9
MT5533340000000,55,33340,"Milwaukee-Waukesha, WI MSA",2023,2,809023,786692,22331,2.8
MT5536780000000,55,36780,"Oshkosh-Neenah, WI MSA",2023,2,91778,89786,1992,2.2
MT5539540000000,55,39540,"Racine-Mount Pleasant, WI MSA",2023,2,100119,97135,2984,3
MT5543100000000,55,43100,"Sheboygan, WI MSA",2023,2,62310,61045,1265,2
MT5548140000000,55,48140,"Wausau, WI MSA",2023,2,74749,73132,1617,2.2
MT5616220000000,56,16220,"Casper, WY MSA",2023,2,42102,40735,1367,3.2
MT5616940000000,56,16940,"Cheyenne, WY MSA",2023,2,48651,47080,1571,3.2
MT7210380000000,72,10380,"Aguadilla, PR MSA",2023,2,86937,80345,6592,7.6
MT7211640000000,72,11640,"Arecibo, PR MSA",2023,2,65176,60851,4325,6.6
MT7225020000000,72,25020,"Guayama, PR MSA",2023,2,18735,17097,1638,8.7
MT7232420000000,72,32420,"Mayaguez, PR MSA",2023,2,65809,60972,4837,7.4
MT7238660000000,72,38660,"Ponce, PR MSA",2023,2,88681,80654,8027,9.1
MT7241980000000,72,41980,"San Juan-Bayamon-Caguas, PR MSA",2023,2,804537,765120,39417,4.9
MT0111500000000,1,11500,"Anniston-Oxford, AL MSA",2023,3,49229,48099,1130,2.3
MT0112220000000,1,12220,"Auburn-Opelika, AL MSA",2023,3,93479,91442,2037,2.2
MT0113820000000,1,13820,"Birmingham, AL MSA",2023,3,560613,548929,11684,2.1
MT0119300000000,1,19300,"Daphne-Fairhope-Foley, AL MSA",2023,3,111945,109749,2196,2
MT0119460000000,1,19460,"Decatur, AL MSA",2023,3,73475,72119,1356,1.8
MT0120020000000,1,20020,"Dothan, AL MSA",2023,3,66620,65132,1488,2.2
MT0122520000000,1,22520,"Florence-Muscle Shoals, AL MSA",2023,3,67973,66358,1615,2.4
MT0123460000000,1,23460,"Gadsden, AL MSA",2023,3,41204,40269,935,2.3
MT0126620000000,1,26620,"Huntsville, AL MSA",2023,3,264227,259372,4855,1.8
MT0133660000000,1,33660,"Mobile, AL MSA",2023,3,182520,177403,5117,2.8
MT0133860000000,1,33860,"Montgomery, AL MSA",2023,3,173264,168946,4318,2.5
MT0146220000000,1,46220,"Tuscaloosa, AL MSA",2023,3,123732,120809,2923,2.4
MT0211260000000,2,11260,"Anchorage, AK MSA",2023,3,198827,191768,7059,3.6
MT0221820000000,2,21820,"Fairbanks-College, AK MSA",2023,3,44829,43217,1612,3.6
MT0422380000000,4,22380,"Flagstaff, AZ MSA",2023,3,73396,70511,2885,3.9
MT0429420000000,4,29420,"Lake Havasu City-Kingman, AZ MSA",2023,3,85977,82058,3919,4.6
MT0438060000000,4,38060,"Phoenix-Mesa-Chandler, AZ MSA",2023,3,2637650,2553997,83653,3.2
MT0439150000000,4,39150,"Prescott Valley-Prescott, AZ MSA",2023,3,105246,101442,3804,3.6
MT0443420000000,4,43420,"Sierra Vista-Douglas, AZ MSA",2023,3,47929,45777,2152,4.5
MT0446060000000,4,46060,"Tucson, AZ MSA",2023,3,491308,473804,17504,3.6
MT0449740000000,4,49740,"Yuma, AZ MSA",2023,3,98453,86480,11973,12.2
MT0522220000000,5,22220,"Fayetteville-Springdale-Rogers, AR MSA",2023,3,295025,288372,6653,2.3
MT0522900000000,5,22900,"Fort Smith, AR-OK MSA",2023,3,100666,97929,2737,2.7
MT0526300000000,5,26300,"Hot Springs, AR MSA",2023,3,43609,42228,1381,3.2
MT0527860000000,5,27860,"Jonesboro, AR MSA",2023,3,64804,63154,1650,2.5
MT0530780000000,5,30780,"Little Rock-North Little Rock-Conway, AR MSA",2023,3,369012,359185,9827,2.7
MT0612540000000,6,12540,"Bakersfield-Delano, CA MSA",2023,3,398752,367247,31505,7.9
MT0617020000000,6,17020,"Chico, CA MSA",2023,3,90632,86092,4540,5
MT0620940000000,6,20940,"El Centro, CA MSA",2023,3,70496,58389,12107,17.2
MT0623420000000,6,23420,"Fresno, CA MSA",2023,3,522247,484962,37285,7.1
MT0625260000000,6,25260,"Hanford-Corcoran, CA MSA",2023,3,56174,51587,4587,8.2
MT0631080000000,6,31080,"Los Angeles-Long Beach-Anaheim, CA MSA",2023,3,6650978,6352426,298552,4.5
MT0632900000000,6,32900,"Merced, CA MSA",2023,3,117781,107525,10256,8.7
MT0633700000000,6,33700,"Modesto, CA MSA",2023,3,247682,232786,14896,6
MT0634900000000,6,34900,"Napa, CA MSA",2023,3,72563,70160,2403,3.3
MT0637100000000,6,37100,"Oxnard-Thousand Oaks-Ventura, CA MSA",2023,3,414731,398487,16244,3.9
MT0639820000000,6,39820,"Redding, CA MSA",2023,3,77445,73802,3643,4.7
MT0640140000000,6,40140,"Riverside-San Bernardino-Ontario, CA MSA",2023,3,2166596,2070301,96295,4.4
MT0640900000000,6,40900,"Sacramento-Roseville-Folsom, CA MSA",2023,3,1156635,1110486,46149,4
MT0641500000000,6,41500,"Salinas, CA MSA",2023,3,213401,198488,14913,7
MT0641740000000,6,41740,"San Diego-Chula Vista-Carlsbad, CA MSA",2023,3,1632109,1575595,56514,3.5
MT0641860000000,6,41860,"San Francisco-Oakland-Fremont, CA MSA",2023,3,2517588,2434370,83218,3.3
MT0641940000000,6,41940,"San Jose-Sunnyvale-Santa Clara, CA MSA",2023,3,1056854,1022949,33905,3.2
MT0642020000000,6,42020,"San Luis Obispo-Paso Robles, CA MSA",2023,3,132172,127663,4509,3.4
MT0642100000000,6,42100,"Santa Cruz-Watsonville, CA MSA",2023,3,134771,127628,7143,5.3
MT0642200000000,6,42200,"Santa Maria-Santa Barbara, CA MSA",2023,3,218631,210091,8540,3.9
MT0642220000000,6,42220,"Santa Rosa-Petaluma, CA MSA",2023,3,246119,237806,8313,3.4
MT0644700000000,6,44700,"Stockton-Lodi, CA MSA",2023,3,360106,339554,20552,5.7
MT0646700000000,6,46700,"Vallejo, CA MSA",2023,3,211911,203004,8907,4.2
MT0647300000000,6,47300,"Visalia, CA MSA",2023,3,214726,194353,20373,9.5
MT0649700000000,6,49700,"Yuba City, CA MSA",2023,3,78885,73245,5640,7.1
MT0814500000000,8,14500,"Boulder, CO MSA",2023,3,193006,187674,5332,2.8
MT0817820000000,8,17820,"Colorado Springs, CO MSA",2023,3,386097,374199,11898,3.1
MT0819740000000,8,19740,"Denver-Aurora-Centennial, CO MSA",2023,3,1758597,1707630,50967,2.9
MT0822660000000,8,22660,"Fort Collins-Loveland, CO MSA",2023,3,203760,198054,5706,2.8
MT0824300000000,8,24300,"Grand Junction, CO MSA",2023,3,78277,75732,2545,3.3
MT0824540000000,8,24540,"Greeley, CO MSA",2023,3,172762,167325,5437,3.1
MT0839380000000,8,39380,"Pueblo, CO MSA",2023,3,73823,70607,3216,4.4
MT0914860000000,9,14860,"Bridgeport-Stamford-Danbury, CT MSA",2023,3,506354,490908,15446,3.1
MT0925540000000,9,25540,"Hartford-West Hartford-East Hartford, CT MSA",2023,3,603302,584144,19158,3.2
MT0935300000000,9,35300,"New Haven, CT MSA",2023,3,307348,297507,9841,3.2
MT0935980000000,9,35980,"Norwich-New London-Willimantic, CT MSA",2023,3,139718,135236,4482,3.2
MT0947930000000,9,47930,"Waterbury-Shelton, CT MSA",2023,3,237225,228566,8659,3.7
MT1020100000000,10,20100,"Dover, DE MSA",2023,3,85290,81768,3522,4.1
MT1147900000000,11,47900,"Washington-Arlington-Alexandria, DC-VA-MD-WV MSA",2023,3,3503900,3418010,85890,2.5
MT1215980000000,12,15980,"Cape Coral-Fort Myers, FL MSA",2023,3,367111,355131,11980,3.3
MT1218880000000,12,18880,"Crestview-Fort Walton Beach-Destin, FL MSA",2023,3,141411,137908,3503,2.5
MT1219660000000,12,19660,"Deltona-Daytona Beach-Ormond Beach, FL MSA",2023,3,315789,305490,10299,3.3
MT1223540000000,12,23540,"Gainesville, FL MSA",2023,3,168849,163721,5128,3
MT1226140000000,12,26140,"Homosassa Springs, FL MSA",2023,3,53361,51205,2156,4
MT1227260000000,12,27260,"Jacksonville, FL MSA",2023,3,844909,820185,24724,2.9
MT1229460000000,12,29460,"Lakeland-Winter Haven, FL MSA",2023,3,353122,340623,12499,3.5
MT1233100000000,12,33100,"Miami-Fort Lauderdale-West Palm Beach, FL MSA",2023,3,3249021,3169955,79066,2.4
MT1234940000000,12,34940,"Naples-Marco Island, FL MSA",2023,3,178781,173391,5390,3
MT1235840000000,12,35840,"North Port-Bradenton-Sarasota, FL MSA",2023,3,388117,376695,11422,2.9
MT1236100000000,12,36100,"Ocala, FL MSA",2023,3,155550,150171,5379,3.5
MT1236740000000,12,36740,"Orlando-Kissimmee-Sanford, FL MSA",2023,3,1503678,1461481,42197,2.8
MT1237340000000,12,37340,"Palm Bay-Melbourne-Titusville, FL MSA",2023,3,301374,292660,8714,2.9
MT1237460000000,12,37460,"Panama City-Panama City Beach, FL MSA",2023,3,99358,96615,2743,2.8
MT1237860000000,12,37860,"Pensacola-Ferry Pass-Brent, FL MSA",2023,3,238673,231773,6900,2.9
MT1238940000000,12,38940,"Port St. Lucie, FL MSA",2023,3,235852,228210,7642,3.2
MT1239460000000,12,39460,"Punta Gorda, FL MSA",2023,3,74633,71958,2675,3.6
MT1242680000000,12,42680,"Sebastian-Vero Beach-West Vero Corridor, FL MSA",2023,3,67328,64966,2362,3.5
MT1242700000000,12,42700,"Sebring, FL MSA",2023,3,36492,34975,1517,4.2
MT1245220000000,12,45220,"Tallahassee, FL MSA",2023,3,203397,197380,6017,3
MT1245300000000,12,45300,"Tampa-St. Petersburg-Clearwater, FL MSA",2023,3,1682732,1635449,47283,2.8
MT1248680000000,12,48680,"Wildwood-The Villages, FL MSA",2023,3,33004,31417,1587,4.8
MT1310500000000,13,10500,"Albany, GA MSA",2023,3,62921,60450,2471,3.9
MT1312020000000,13,12020,"Athens-Clarke County, GA MSA",2023,3,105003,101821,3182,3
MT1312060000000,13,12060,"Atlanta-Sandy Springs-Roswell, GA MSA",2023,3,3251948,3148313,103635,3.2
MT1312260000000,13,12260,"Augusta-Richmond County, GA-SC MSA",2023,3,266217,256302,9915,3.7
MT1315260000000,13,15260,"Brunswick-St. Simons, GA MSA",2023,3,53852,52273,1579,2.9
MT1317980000000,13,17980,"Columbus, GA-AL MSA",2023,3,129619,124833,4786,3.7
MT1319140000000,13,19140,"Dalton, GA MSA",2023,3,66993,64547,2446,3.7
MT1323580000000,13,23580,"Gainesville, GA MSA",2023,3,106682,103865,2817,2.6
MT1325980000000,13,25980,"Hinesville, GA MSA",2023,3,31132,29923,1209,3.9
MT1331420000000,13,31420,"Macon-Bibb County, GA MSA",2023,3,97467,93704,3763,3.9
MT1340660000000,13,40660,"Rome, GA MSA",2023,3,46955,45413,1542,3.3
MT1342340000000,13,42340,"Savannah, GA MSA",2023,3,206492,200348,6144,3
MT1346660000000,13,46660,"Valdosta, GA MSA",2023,3,60936,58726,2210,3.6
MT1347580000000,13,47580,"Warner Robins, GA MSA",2023,3,89008,86253,2755,3.1
MT1527980000000,15,27980,"Kahului-Wailuku, HI MSA",2023,3,84249,81787,2462,2.9
MT1546520000000,15,46520,"Urban Honolulu, HI MSA",2023,3,468277,455096,13181,2.8
MT1614260000000,16,14260,"Boise City, ID MSA",2023,3,433143,421111,12032,2.8
MT1617660000000,16,17660,"Coeur d'Alene, ID MSA",2023,3,88028,84929,3099,3.5
MT1626820000000,16,26820,"Idaho Falls, ID MSA",2023,3,82717,80526,2191,2.6
MT1630300000000,16,30300,"Lewiston, ID-WA MSA",2023,3,30425,29559,866,2.8
MT1638540000000,16,38540,"Pocatello, ID MSA",2023,3,39903,38680,1223,3.1
MT1646300000000,16,46300,"Twin Falls, ID MSA",2023,3,59089,57303,1786,3
MT1714010000000,17,14010,"Bloomington, IL MSA",2023,3,92908,89640,3268,3.5
MT1716580000000,17,16580,"Champaign-Urbana, IL MSA",2023,3,122450,117576,4874,4
MT1716980000000,17,16980,"Chicago-Naperville-Elgin, IL-IN MSA",2023,3,4872261,4671526,200735,4.1
MT1719340000000,17,19340,"Davenport-Moline-Rock Island, IA-IL MSA",2023,3,189767,182084,7683,4
MT1719500000000,17,19500,"Decatur, IL MSA",2023,3,45247,42620,2627,5.8
MT1728100000000,17,28100,"Kankakee, IL MSA",2023,3,50372,47504,2868,5.7
MT1737900000000,17,37900,"Peoria, IL MSA",2023,3,173719,165524,8195,4.7
MT1740420000000,17,40420,"Rockford, IL MSA",2023,3,159076,149520,9556,6
MT1744100000000,17,44100,"Springfield, IL MSA",2023,3,102252,97995,4257,4.2
MT1814020000000,18,14020,"Bloomington, IN MSA",2023,3,85402,82966,2436,2.9
MT1818020000000,18,18020,"Columbus, IN MSA",2023,3,39666,38484,1182,3
MT1821140000000,18,21140,"Elkhart-Goshen, IN MSA",2023,3,103098,98827,4271,4.1
MT1821780000000,18,21780,"Evansville, IN MSA",2023,3,135111,130966,4145,3.1
MT1823060000000,18,23060,"Fort Wayne, IN MSA",2023,3,229126,222393,6733,2.9
MT1826900000000,18,26900,"Indianapolis-Carmel-Greenwood, IN MSA",2023,3,1114892,1081296,33596,3
MT1829020000000,18,29020,"Kokomo, IN MSA",2023,3,35471,33789,1682,4.7
MT1829200000000,18,29200,"Lafayette-West Lafayette, IN MSA",2023,3,119611,116281,3330,2.8
MT1833140000000,18,33140,"Michigan City-La Porte, IN MSA",2023,3,51494,49561,1933,3.8
MT1834620000000,18,34620,"Muncie, IN MSA",2023,3,51706,49823,1883,3.6
MT1843780000000,18,43780,"South Bend-Mishawaka, IN-MI MSA",2023,3,155492,149329,6163,4
MT1845460000000,18,45460,"Terre Haute, IN MSA",2023,3,76791,74095,2696,3.5
MT1911180000000,19,11180,"Ames, IA MSA",2023,3,69368,67746,1622,2.3
MT1916300000000,19,16300,"Cedar Rapids, IA MSA",2023,3,149077,144258,4819,3.2
MT1919780000000,19,19780,"Des Moines-West Des Moines, IA MSA",2023,3,406839,395496,11343,2.8
MT1920220000000,19,20220,"Dubuque, IA MSA",2023,3,53922,52327,1595,3
MT1926980000000,19,26980,"Iowa City, IA MSA",2023,3,98999,96604,2395,2.4
MT1943580000000,19,43580,"Sioux City, IA-NE-SD MSA",2023,3,76967,74889,2078,2.7
MT1947940000000,19,47940,"Waterloo-Cedar Falls, IA MSA",2023,3,88890,86206,2684,3
MT2029940000000,20,29940,"Lawrence, KS MSA",2023,3,69908,68044,1864,2.7
MT2031740000000,20,31740,"Manhattan, KS MSA",2023,3,63513,61707,1806,2.8
MT2045820000000,20,45820,"Topeka, KS MSA",2023,3,117768,114172,3596,3.1
MT2048620000000,20,48620,"Wichita, KS MSA",2023,3,329986,319917,10069,3.1
MT2114540000000,21,14540,"Bowling Green, KY MSA",2023,3,90504,87018,3486,3.9
MT2121060000000,21,21060,"Elizabethtown, KY MSA",2023,3,53795,51549,2246,4.2
MT2130460000000,21,30460,"Lexington-Fayette, KY MSA",2023,3,270613,261572,9041,3.3
MT2131140000000,21,31140,"Louisville/Jefferson County, KY-IN MSA",2023,3,688710,663121,25589,3.7
MT2136980000000,21,36980,"Owensboro, KY MSA",2023,3,51056,48926,2130,4.2
MT2137140000000,21,37140,"Paducah, KY-IL MSA",2023,3,45623,43756,1867,4.1
MT2210780000000,22,10780,"Alexandria, LA MSA",2023,3,64490,62326,2164,3.4
MT2212940000000,22,12940,"Baton Rouge, LA MSA",2023,3,419751,405175,14576,3.5
MT2225220000000,22,25220,"Hammond, LA MSA",2023,3,60226,57770,2456,4.1
MT2226380000000,22,26380,"Houma-Bayou Cane-Thibodaux, LA MSA",2023,3,87555,84813,2742,3.1
MT2229180000000,22,29180,"Lafayette, LA MSA",2023,3,196704,190703,6001,3.1
MT2229340000000,22,29340,"Lake Charles, LA MSA",2023,3,98707,95057,3650,3.7
MT2233740000000,22,33740,"Monroe, LA MSA",2023,3,96456,92533,3923,4.1
MT2235380000000,22,35380,"New Orleans-Metairie, LA MSA",2023,3,468768,451072,17696,3.8
MT2243340000000,22,43340,"Shreveport-Bossier City, LA MSA",2023,3,169848,163619,6229,3.7
MT2243640000000,22,43640,"Slidell-Mandeville-Covington, LA MSA",2023,3,128325,124480,3845,3
MT2312620000000,23,12620,"Bangor, ME MSA",2023,3,73204,71395,1809,2.5
MT2330340000000,23,30340,"Lewiston-Auburn, ME MSA",2023,3,54116,52707,1409,2.6
MT2338860000000,23,38860,"Portland-South Portland, ME MSA",2023,3,305197,299003,6194,2
MT2412580000000,24,12580,"Baltimore-Columbia-Towson, MD MSA",2023,3,1463506,1433300,30206,2.1
MT2425180000000,24,25180,"Hagerstown-Martinsburg, MD-WV MSA",2023,3,141724,138024,3700,2.6
MT2430500000000,24,30500,"Lexington Park, MD MSA",2023,3,105823,103818,2005,1.9
MT2441540000000,24,41540,"Salisbury, MD MSA",2023,3,62537,61013,1524,2.4
MT2511200000000,25,11200,"Amherst Town-Northampton, MA MSA",2023,3,83109,80453,2656,3.2
MT2512700000000,25,12700,"Barnstable Town, MA MSA",2023,3,113642,108641,5001,4.4
MT2514460000000,25,14460,"Boston-Cambridge-Newton, MA-NH MSA",2023,3,2750217,2664449,85768,3.1
MT2538340000000,25,38340,"Pittsfield, MA MSA",2023,3,63390,61028,2362,3.7
MT2544140000000,25,44140,"Springfield, MA MSA",2023,3,220190,210431,9759,4.4
MT2549340000000,25,49340,"Worcester, MA MSA",2023,3,452514,436134,16380,3.6
MT2611460000000,26,11460,"Ann Arbor, MI MSA",2023,3,203323,196716,6607,3.2
MT2612980000000,26,12980,"Battle Creek, MI MSA",2023,3,61700,58982,2718,4.4
MT2613020000000,26,13020,"Bay City, MI MSA",2023,3,49475,46962,2513,5.1
MT2619820000000,26,19820,"Detroit-Warren-Dearborn, MI MSA",2023,3,2148327,2076461,71866,3.3
MT2622420000000,26,22420,"Flint, MI MSA",2023,3,185873,176559,9314,5
MT2624340000000,26,24340,"Grand Rapids-Wyoming-Kentwood, MI MSA",2023,3,619630,598987,20643,3.3
MT2627100000000,26,27100,"Jackson, MI MSA",2023,3,74597,71483,3114,4.2
MT2628020000000,26,28020,"Kalamazoo-Portage, MI MSA",2023,3,137679,132682,4997,3.6
MT2629620000000,26,29620,"Lansing-East Lansing, MI MSA",2023,3,247493,237994,9499,3.8
MT2633220000000,26,33220,"Midland, MI MSA",2023,3,40758,39124,1634,4
MT2633780000000,26,33780,"Monroe, MI MSA",2023,3,76509,73163,3346,4.4
MT2634740000000,26,34740,"Muskegon-Norton Shores, MI MSA",2023,3,82768,79180,3588,4.3
MT2635660000000,26,35660,"Niles, MI MSA",2023,3,74951,71794,3157,4.2
MT2640980000000,26,40980,"Saginaw, MI MSA",2023,3,83968,79458,4510,5.4
MT2645900000000,26,45900,"Traverse City, MI MSA",2023,3,79955,76827,3128,3.9
MT2720260000000,27,20260,"Duluth, MN-WI MSA",2023,3,139491,134541,4950,3.5
MT2731860000000,27,31860,"Mankato, MN MSA",2023,3,59923,58475,1448,2.4
MT2733460000000,27,33460,"Minneapolis-St. Paul-Bloomington, MN-WI MSA",2023,3,2061520,2006412,55108,2.7
MT2740340000000,27,40340,"Rochester, MN MSA",2023,3,125401,122345,3056,2.4
MT2741060000000,27,41060,"St. Cloud, MN MSA",2023,3,109475,106129,3346,3.1
MT2825060000000,28,25060,"Gulfport-Biloxi, MS MSA",2023,3,182916,177500,5416,3
MT2825620000000,28,25620,"Hattiesburg, MS MSA",2023,3,69732,67666,2066,3
MT2827140000000,28,27140,"Jackson, MS MSA",2023,3,276759,268880,7879,2.8
MT2916020000000,29,16020,"Cape Girardeau, MO-IL MSA",2023,3,48637,47337,1300,2.7
MT2917860000000,29,17860,"Columbia, MO MSA",2023,3,113428,110628,2800,2.5
MT2927620000000,29,27620,"Jefferson City, MO MSA",2023,3,74489,72664,1825,2.5
MT2927900000000,29,27900,"Joplin, MO-KS MSA",2023,3,96703,93994,2709,2.8
MT2928140000000,29,28140,"Kansas City, MO-KS MSA",2023,3,1176206,1142118,34088,2.9
MT2941140000000,29,41140,"St. Joseph, MO-KS MSA",2023,3,53540,51967,1573,2.9
MT2941180000000,29,41180,"St. Louis, MO-IL MSA",2023,3,1463694,1419255,44439,3
MT2944180000000,29,44180,"Springfield, MO MSA",2023,3,237755,231682,6073,2.6
MT3013740000000,30,13740,"Billings, MT MSA",2023,3,98871,96695,2176,2.2
MT3014580000000,30,14580,"Bozeman, MT MSA",2023,3,75868,74422,1446,1.9
MT3024500000000,30,24500,"Great Falls, MT MSA",2023,3,39409,38444,965,2.4
MT3025740000000,30,25740,"Helena, MT MSA",2023,3,47264,46159,1105,2.3
MT3033540000000,30,33540,"Missoula, MT MSA",2023,3,73446,71765,1681,2.3
MT3124260000000,31,24260,"Grand Island, NE MSA",2023,3,42264,41359,905,2.1
MT3130700000000,31,30700,"Lincoln, NE MSA",2023,3,191510,187731,3779,2
MT3136540000000,31,36540,"Omaha, NE-IA MSA",2023,3,519432,507378,12054,2.3
MT3216180000000,32,16180,"Carson City, NV MSA",2023,3,28617,27359,1258,4.4
MT3229820000000,32,29820,"Las Vegas-Henderson-North Las Vegas, NV MSA",2023,3,1179252,1116575,62677,5.3
MT3239900000000,32,39900,"Reno, NV MSA",2023,3,294898,281887,13011,4.4
MT3331700000000,33,31700,"Manchester-Nashua, NH MSA",2023,3,238749,233208,5541,2.3
MT3412100000000,34,12100,"Atlantic City-Hammonton, NJ MSA",2023,3,179801,169789,10012,5.6
MT3445940000000,34,45940,"Trenton-Princeton, NJ MSA",2023,3,198657,190998,7659,3.9
MT3447220000000,34,47220,"Vineland, NJ MSA",2023,3,65696,61596,4100,6.2
MT3510740000000,35,10740,"Albuquerque, NM MSA",2023,3,454991,440096,14895,3.3
MT3522140000000,35,22140,"Farmington, NM MSA",2023,3,49339,47253,2086,4.2
MT3529740000000,35,29740,"Las Cruces, NM MSA",2023,3,99760,95505,4255,4.3
MT3542140000000,35,42140,"Santa Fe, NM MSA",2023,3,73119,70835,2284,3.1
MT3610580000000,36,10580,"Albany-Schenectady-Troy, NY MSA",2023,3,456163,443010,13153,2.9
MT3613780000000,36,13780,"Binghamton, NY MSA",2023,3,106383,102867,3516,3.3
MT3615380000000,36,15380,"Buffalo-Cheektowaga, NY MSA",2023,3,559881,541313,18568,3.3
MT3621300000000,36,21300,"Elmira, NY MSA",2023,3,35440,34236,1204,3.4
MT3624020000000,36,24020,"Glens Falls, NY MSA",2023,3,59787,57989,1798,3
MT3627060000000,36,27060,"Ithaca, NY MSA",2023,3,48174,46797,1377,2.9
MT3628740000000,36,28740,"Kingston, NY MSA",2023,3,86825,84186,2639,3
MT3628880000000,36,28880,"Kiryas Joel-Poughkeepsie-Newburgh, NY MSA",2023,3,336972,326842,10130,3
MT3635620000000,36,35620,"New York-Newark-Jersey City, NY-NJ MSA",2023,3,10077283,9656881,420402,4.2
MT3640380000000,36,40380,"Rochester, NY MSA",2023,3,513538,497428,16110,3.1
MT3645060000000,36,45060,"Syracuse, NY MSA",2023,3,309713,299829,9884,3.2
MT3646540000000,36,46540,"Utica-Rome, NY MSA",2023,3,127857,123649,4208,3.3
MT3648060000000,36,48060,"Watertown-Fort Drum, NY MSA",2023,3,45071,43390,1681,3.7
MT3711700000000,37,11700,"Asheville, NC MSA",2023,3,210523,204628,5895,2.8
MT3715500000000,37,15500,"Burlington, NC MSA",2023,3,85140,82202,2938,3.5
MT3716740000000,37,16740,"Charlotte-Concord-Gastonia, NC-SC MSA",2023,3,1461193,1412924,48269,3.3
MT3720500000000,37,20500,"Durham-Chapel Hill, NC MSA",2023,3,319105,309244,9861,3.1
MT3722180000000,37,22180,"Fayetteville, NC MSA",2023,3,154764,147830,6934,4.5
MT3724140000000,37,24140,"Goldsboro, NC MSA",2023,3,50431,48601,1830,3.6
MT3724660000000,37,24660,"Greensboro-High Point, NC MSA",2023,3,372748,358431,14317,3.8
MT3724780000000,37,24780,"Greenville, NC MSA",2023,3,82873,79488,3385,4.1
MT3725860000000,37,25860,"Hickory-Lenoir-Morganton, NC MSA",2023,3,173077,167568,5509,3.2
MT3727340000000,37,27340,"Jacksonville, NC MSA",2023,3,73526,70852,2674,3.6
MT3738240000000,37,38240,"Pinehurst-Southern Pines, NC MSA",2023,3,43781,42288,1493,3.4
MT3739580000000,37,39580,"Raleigh-Cary, NC MSA",2023,3,825818,801307,24511,3
MT3740580000000,37,40580,"Rocky Mount, NC MSA",2023,3,63742,60624,3118,4.9
MT3748900000000,37,48900,"Wilmington, NC MSA",2023,3,220078,212341,7737,3.5
MT3749180000000,37,49180,"Winston-Salem, NC MSA",2023,3,325278,313925,11353,3.5
MT3813900000000,38,13900,"Bismarck, ND MSA",2023,3,72381,70957,1424,2
MT3822020000000,38,22020,"Fargo, ND-MN MSA",2023,3,151583,148743,2840,1.9
MT3824220000000,38,24220,"Grand Forks, ND-MN MSA",2023,3,54990,53829,1161,2.1
MT3833500000000,38,33500,"Minot, ND MSA",2023,3,39833,39030,803,2
MT3910420000000,39,10420,"Akron, OH MSA",2023,3,358240,345534,12706,3.5
MT3915940000000,39,15940,"Canton-Massillon, OH MSA",2023,3,190149,183152,6997,3.7
MT3917140000000,39,17140,"Cincinnati, OH-KY-IN MSA",2023,3,1160148,1122078,38070,3.3
MT3917410000000,39,17410,"Cleveland, OH MSA",2023,3,1080395,1041017,39378,3.6
MT3918140000000,39,18140,"Columbus, OH MSA",2023,3,1131356,1095866,35490,3.1
MT3919430000000,39,19430,"Dayton-Kettering-Beavercreek, OH MSA",2023,3,386827,373206,13621,3.5
MT3930620000000,39,30620,"Lima, OH MSA",2023,3,47527,45751,1776,3.7
MT3931900000000,39,31900,"Mansfield, OH MSA",2023,3,52334,50150,2184,4.2
MT3941780000000,39,41780,"Sandusky, OH MSA",2023,3,56282,53649,2633,4.7
MT3944220000000,39,44220,"Springfield, OH MSA",2023,3,61620,59386,2234,3.6
MT3945780000000,39,45780,"Toledo, OH MSA",2023,3,292949,281504,11445,3.9
MT3948260000000,39,48260,"Weirton-Steubenville, WV-OH MSA",2023,3,52273,49772,2501,4.8
MT3949660000000,39,49660,"Youngstown-Warren, OH MSA",2023,3,190059,182228,7831,4.1
MT4021420000000,40,21420,"Enid, OK MSA",2023,3,28154,27369,785,2.8
MT4030020000000,40,30020,"Lawton, OK MSA",2023,3,51205,49441,1764,3.4
MT4036420000000,40,36420,"Oklahoma City, OK MSA",2023,3,752217,731293,20924,2.8
MT4046140000000,40,46140,"Tulsa, OK MSA",2023,3,509753,494700,15053,3
MT4110540000000,41,10540,"Albany, OR MSA",2023,3,61098,58714,2384,3.9
MT4113460000000,41,13460,"Bend, OR MSA",2023,3,129281,124467,4814,3.7
MT4118700000000,41,18700,"Corvallis, OR MSA",2023,3,49007,47565,1442,2.9
MT4121660000000,41,21660,"Eugene-Springfield, OR MSA",2023,3,185937,178916,7021,3.8
MT4124420000000,41,24420,"Grants Pass, OR MSA",2023,3,34771,32984,1787,5.1
MT4132780000000,41,32780,"Medford, OR MSA",2023,3,103555,99037,4518,4.4
MT4138900000000,41,38900,"Portland-Vancouver-Hillsboro, OR-WA MSA",2023,3,1372615,1327295,45320,3.3
MT4141420000000,41,41420,"Salem, OR MSA",2023,3,215992,208289,7703,3.6
MT4210900000000,42,10900,"Allentown-Bethlehem-Easton, PA-NJ MSA",2023,3,447320,430015,17305,3.9
MT4211020000000,42,11020,"Altoona, PA MSA",2023,3,57047,54899,2148,3.8
MT4216540000000,42,16540,"Chambersburg, PA MSA",2023,3,76600,74157,2443,3.2
MT4221500000000,42,21500,"Erie, PA MSA",2023,3,126253,121095,5158,4.1
MT4223900000000,42,23900,"Gettysburg, PA MSA",2023,3,52266,50692,1574,3
MT4225420000000,42,25420,"Harrisburg-Carlisle, PA MSA",2023,3,309883,300009,9874,3.2
MT4227780000000,42,27780,"Johnstown, PA MSA",2023,3,56994,54456,2538,4.5
MT4229540000000,42,29540,"Lancaster, PA MSA",2023,3,290024,281499,8525,2.9
MT4230140000000,42,30140,"Lebanon, PA MSA",2023,3,72378,70110,2268,3.1
MT4237980000000,42,37980,"Philadelphia-Camden-Wilmington, PA-NJ-DE-MD MSA",2023,3,3266990,3147235,119755,3.7
MT4238300000000,42,38300,"Pittsburgh, PA MSA",2023,3,1226231,1179420,46811,3.8
MT4239740000000,42,39740,"Reading, PA MSA",2023,3,217579,209565,8014,3.7
MT4242540000000,42,42540,"Scranton--Wilkes-Barre, PA MSA",2023,3,277666,265160,12506,4.5
MT4244300000000,42,44300,"State College, PA MSA",2023,3,77303,74986,2317,3
MT4248700000000,42,48700,"Williamsport, PA MSA",2023,3,52611,50479,2132,4.1
MT4249620000000,42,49620,"York-Hanover, PA MSA",2023,3,237733,229981,7752,3.3
MT4439300000000,44,39300,"Providence-Warwick, RI-MA MSA",2023,3,874457,845645,28812,3.3
MT4516700000000,45,16700,"Charleston-North Charleston, SC MSA",2023,3,425443,414424,11019,2.6
MT4517900000000,45,17900,"Columbia, SC MSA",2023,3,407041,395013,12028,3
MT4522500000000,45,22500,"Florence, SC MSA",2023,3,91150,88170,2980,3.3
MT4524860000000,45,24860,"Greenville-Anderson-Greer, SC MSA",2023,3,466844,454119,12725,2.7
MT4525940000000,45,25940,"Hilton Head Island-Bluffton-Port Royal, SC MSA",2023,3,95844,93291,2553,2.7
MT4534820000000,45,34820,"Myrtle Beach-Conway-North Myrtle Beach, SC MSA",2023,3,165310,159470,5840,3.5
MT4543900000000,45,43900,"Spartanburg, SC MSA",2023,3,171188,165863,5325,3.1
MT4544940000000,45,44940,"Sumter, SC MSA",2023,3,41007,39387,1620,4
MT4639660000000,46,39660,"Rapid City, SD MSA",2023,3,78163,76796,1367,1.7
MT4643620000000,46,43620,"Sioux Falls, SD-MN MSA",2023,3,170175,167313,2862,1.7
MT4716860000000,47,16860,"Chattanooga, TN-GA MSA",2023,3,283673,275038,8635,3
MT4717300000000,47,17300,"Clarksville, TN-KY MSA",2023,3,135177,130055,5122,3.8
MT4717420000000,47,17420,"Cleveland, TN MSA",2023,3,56366,54362,2004,3.6
MT4727180000000,47,27180,"Jackson, TN MSA",2023,3,77631,74832,2799,3.6
MT4727740000000,47,27740,"Johnson City, TN MSA",2023,3,95679,92498,3181,3.3
MT4728700000000,47,28700,"Kingsport-Bristol, TN-VA MSA",2023,3,131346,126930,4416,3.4
MT4728940000000,47,28940,"Knoxville, TN MSA",2023,3,443230,429948,13282,3
MT4732820000000,47,32820,"Memphis, TN-MS-AR MSA",2023,3,623993,600012,23981,3.8
MT4734100000000,47,34100,"Morristown, TN MSA",2023,3,52620,50750,1870,3.6
MT4734980000000,47,34980,"Nashville-Davidson--Murfreesboro--Franklin, TN MSA",2023,3,1136334,1106378,29956,2.6
MT4810180000000,48,10180,"Abilene, TX MSA",2023,3,84077,81033,3044,3.6
MT4811100000000,48,11100,"Amarillo, TX MSA",2023,3,133604,129325,4279,3.2
MT4812420000000,48,12420,"Austin-Round Rock-San Marcos, TX MSA",2023,3,1444324,1395226,49098,3.4
MT4813140000000,48,13140,"Beaumont-Port Arthur, TX MSA",2023,3,173969,163836,10133,5.8
MT4815180000000,48,15180,"Brownsville-Harlingen, TX MSA",2023,3,184266,174094,10172,5.5
MT4817780000000,48,17780,"College Station-Bryan, TX MSA",2023,3,144760,139596,5164,3.6
MT4818580000000,48,18580,"Corpus Christi, TX MSA",2023,3,204803,195564,9239,4.5
MT4819100000000,48,19100,"Dallas-Fort Worth-Arlington, TX MSA",2023,3,4352561,4188042,164519,3.8
MT4820580000000,48,20580,"Eagle Pass, TX MSA",2023,3,23745,21886,1859,7.8
MT4821340000000,48,21340,"El Paso, TX MSA",2023,3,395842,378874,16968,4.3
MT4826420000000,48,26420,"Houston-Pasadena-The Woodlands, TX MSA",2023,3,3708073,3549343,158730,4.3
MT4828660000000,48,28660,"Killeen-Temple, TX MSA",2023,3,196229,187379,8850,4.5
MT4829700000000,48,29700,"Laredo, TX MSA",2023,3,114482,109657,4825,4.2
MT4830980000000,48,30980,"Longview, TX MSA",2023,3,128583,123005,5578,4.3
MT4831180000000,48,31180,"Lubbock, TX MSA",2023,3,178672,172342,6330,3.5
MT4832580000000,48,32580,"McAllen-Edinburg-Mission, TX MSA",2023,3,385259,361286,23973,6.2
MT4833260000000,48,33260,"Midland, TX MSA",2023,3,98673,95783,2890,2.9
MT4836220000000,48,36220,"Odessa, TX MSA",2023,3,82847,79957,2890,3.5
MT4841660000000,48,41660,"San Angelo, TX MSA",2023,3,60259,58262,1997,3.3
MT4841700000000,48,41700,"San Antonio-New Braunfels, TX MSA",2023,3,1291805,1242643,49162,3.8
MT4843300000000,48,43300,"Sherman-Denison, TX MSA",2023,3,68985,66304,2681,3.9
MT4845500000000,48,45500,"Texarkana, TX-AR MSA",2023,3,60635,58176,2459,4.1
MT4846340000000,48,46340,"Tyler, TX MSA",2023,3,115090,110702,4388,3.8
MT4847020000000,48,47020,"Victoria, TX MSA",2023,3,44575,42749,1826,4.1
MT4847380000000,48,47380,"Waco, TX MSA",2023,3,141984,136210,5774,4.1
MT4848660000000,48,48660,"Wichita Falls, TX MSA",2023,3,66300,63780,2520,3.8
MT4930860000000,49,30860,"Logan, UT-ID MSA",2023,3,79037,77213,1824,2.3
MT4936260000000,49,36260,"Ogden, UT MSA",2023,3,343564,335355,8209,2.4
MT4939340000000,49,39340,"Provo-Orem-Lehi, UT MSA",2023,3,360825,351853,8972,2.5
MT4941100000000,49,41100,"St. George, UT MSA",2023,3,89747,87243,2504,2.8
MT4941620000000,49,41620,"Salt Lake City-Murray, UT MSA",2023,3,720479,701989,18490,2.6
MT5015540000000,50,15540,"Burlington-South Burlington, VT MSA",2023,3,128830,126703,2127,1.7
MT5113980000000,51,13980,"Blacksburg-Christiansburg-Radford, VA MSA",2023,3,92522,90011,2511,2.7
MT5116820000000,51,16820,"Charlottesville, VA MSA",2023,3,117803,114875,2928,2.5
MT5125500000000,51,25500,"Harrisonburg, VA MSA",2023,3,72552,70728,1824,2.5
MT5131340000000,51,31340,"Lynchburg, VA MSA",2023,3,128464,124553,3911,3
MT5140060000000,51,40060,"Richmond, VA MSA",2023,3,720686,700736,19950,2.8
MT5140220000000,51,40220,"Roanoke, VA MSA",2023,3,157037,152722,4315,2.7
MT5144420000000,51,44420,"Staunton-Stuarts Draft, VA MSA",2023,3,65627,64068,1559,2.4
MT5147260000000,51,47260,"Virginia Beach-Chesapeake-Norfolk, VA-NC MSA",2023,3,876229,850310,25919,3
MT5149020000000,51,49020,"Winchester, VA-WV MSA",2023,3,76490,74543,1947,2.5
MT5313380000000,53,13380,"Bellingham, WA MSA",2023,3,114252,110124,4128,3.6
MT5314740000000,53,14740,"Bremerton-Silverdale-Port Orchard, WA MSA",2023,3,121403,116948,4455,3.7
MT5328420000000,53,28420,"Kennewick-Richland, WA MSA",2023,3,144119,137739,6380,4.4
MT5331020000000,53,31020,"Longview-Kelso, WA MSA",2023,3,47329,45219,2110,4.5
MT5334580000000,53,34580,"Mount Vernon-Anacortes, WA MSA",2023,3,57692,55364,2328,4
MT5336500000000,53,36500,"Olympia-Lacey-Tumwater, WA MSA",2023,3,140670,135411,5259,3.7
MT5342660000000,53,42660,"Seattle-Tacoma-Bellevue, WA MSA",2023,3,2296114,2206722,89392,3.9
MT5344060000000,53,44060,"Spokane-Spokane Valley, WA MSA",2023,3,279664,269076,10588,3.8
MT5347460000000,53,47460,"Walla Walla, WA MSA",2023,3,29494,28441,1053,3.6
MT5348300000000,53,48300,"Wenatchee-East Wenatchee, WA MSA",2023,3,61650,59078,2572,4.2
MT5349420000000,53,49420,"Yakima, WA MSA",2023,3,125679,119132,6547,5.2
MT5413220000000,54,13220,"Beckley, WV MSA",2023,3,45549,43957,1592,3.5
MT5416620000000,54,16620,"Charleston, WV MSA",2023,3,90442,87406,3036,3.4
MT5426580000000,54,26580,"Huntington-Ashland, WV-KY-OH MSA",2023,3,155168,148535,6633,4.3
MT5434060000000,54,34060,"Morgantown, WV MSA",2023,3,71021,68813,2208,3.1
MT5437620000000,54,37620,"Parkersburg-Vienna, WV MSA",2023,3,39115,37620,1495,3.8
MT5448540000000,54,48540,"Wheeling, WV-OH MSA",2023,3,59722,57246,2476,4.1
MT5511540000000,55,11540,"Appleton, WI MSA",2023,3,135883,133135,2748,2
MT5520740000000,55,20740,"Eau Claire, WI MSA",2023,3,94805,92322,2483,2.6
MT5522540000000,55,22540,"Fond du Lac, WI MSA",2023,3,56004,54729,1275,2.3
MT5524580000000,55,24580,"Green Bay, WI MSA",2023,3,177474,173437,4037,2.3
MT5527500000000,55,27500,"Janesville-Beloit, WI MSA",2023,3,85678,83092,2586,3
MT5528450000000,55,28450,"Kenosha, WI MSA",2023,3,93701,90989,2712,2.9
MT5529100000000,55,29100,"La Crosse-Onalaska, WI-MN MSA",2023,3,89659,87639,2020,2.3
MT5531540000000,55,31540,"Madison, WI MSA",2023,3,400368,392635,7733,1.9
MT5533340000000,55,33340,"Milwaukee-Waukesha, WI MSA",2023,3,809963,787332,22631,2.8
MT5536780000000,55,36780,"Oshkosh-Neenah, WI MSA",2023,3,91813,89803,2010,2.2
MT5539540000000,55,39540,"Racine-Mount Pleasant, WI MSA",2023,3,100269,97226,3043,3
MT5543100000000,55,43100,"Sheboygan, WI MSA",2023,3,62468,61200,1268,2
MT5548140000000,55,48140,"Wausau, WI MSA",2023,3,74877,73212,1665,2.2
MT5616220000000,56,16220,"Casper, WY MSA",2023,3,42119,40799,1320,3.1
MT5616940000000,56,16940,"Cheyenne, WY MSA",2023,3,48713,47184,1529,3.1
MT7210380000000,72,10380,"Aguadilla, PR MSA",2023,3,86939,80327,6612,7.6
MT7211640000000,72,11640,"Arecibo, PR MSA",2023,3,65114,60849,4265,6.6
MT7225020000000,72,25020,"Guayama, PR MSA",2023,3,18662,16987,1675,9
MT7232420000000,72,32420,"Mayaguez, PR MSA",2023,3,65353,60498,4855,7.4
MT7238660000000,72,38660,"Ponce, PR MSA",2023,3,88184,80149,8035,9.1
MT7241980000000,72,41980,"San Juan-Bayamon-Caguas, PR MSA",2023,3,798901,759354,39547,5
MT0111500000000,1,11500,"Anniston-Oxford, AL MSA",2023,4,49247,48090,1157,2.3
MT0112220000000,1,12220,"Auburn-Opelika, AL MSA",2023,4,93806,91749,2057,2.2
MT0113820000000,1,13820,"Birmingham, AL MSA",2023,4,561565,549761,11804,2.1
MT0119300000000,1,19300,"Daphne-Fairhope-Foley, AL MSA",2023,4,112010,109747,2263,2
MT0119460000000,1,19460,"Decatur, AL MSA",2023,4,73553,72162,1391,1.9
MT0120020000000,1,20020,"Dothan, AL MSA",2023,4,66715,65200,1515,2.3
MT0122520000000,1,22520,"Florence-Muscle Shoals, AL MSA",2023,4,68176,66534,1642,2.4
MT0123460000000,1,23460,"Gadsden, AL MSA",2023,4,41233,40285,948,2.3
MT0126620000000,1,26620,"Huntsville, AL MSA",2023,4,265456,260523,4933,1.9
MT0133660000000,1,33660,"Mobile, AL MSA",2023,4,182550,177445,5105,2.8
MT0133860000000,1,33860,"Montgomery, AL MSA",2023,4,173425,169116,4309,2.5
MT0146220000000,1,46220,"Tuscaloosa, AL MSA",2023,4,124054,121086,2968,2.4
MT0211260000000,2,11260,"Anchorage, AK MSA",2023,4,199017,191856,7161,3.6
MT0221820000000,2,21820,"Fairbanks-College, AK MSA",2023,4,44859,43237,1622,3.6
MT0422380000000,4,22380,"Flagstaff, AZ MSA",2023,4,73562,70651,2911,4
MT0429420000000,4,29420,"Lake Havasu City-Kingman, AZ MSA",2023,4,86082,82142,3940,4.6
MT0438060000000,4,38060,"Phoenix-Mesa-Chandler, AZ MSA",2023,4,2648005,2562526,85479,3.2
MT0439150000000,4,39150,"Prescott Valley-Prescott, AZ MSA",2023,4,105415,101535,3880,3.7
MT0443420000000,4,43420,"Sierra Vista-Douglas, AZ MSA",2023,4,47954,45812,2142,4.5
MT0446060000000,4,46060,"Tucson, AZ MSA",2023,4,492549,474810,17739,3.6
MT0449740000000,4,49740,"Yuma, AZ MSA",2023,4,98254,86454,11800,12
MT0522220000000,5,22220,"Fayetteville-Springdale-Rogers, AR MSA",2023,4,295652,288912,6740,2.3
MT0522900000000,5,22900,"Fort Smith, AR-OK MSA",2023,4,100799,97927,2872,2.8
MT0526300000000,5,26300,"Hot Springs, AR MSA",2023,4,43622,42227,1395,3.2
MT0527860000000,5,27860,"Jonesboro, AR MSA",2023,4,64885,63211,1674,2.6
MT0530780000000,5,30780,"Little Rock-North Little Rock-Conway, AR MSA",2023,4,369522,359606,9916,2.7
MT0612540000000,6,12540,"Bakersfield-Delano, CA MSA",2023,4,399247,367340,31907,8
MT0617020000000,6,17020,"Chico, CA MSA",2023,4,90595,86032,4563,5
MT0620940000000,6,20940,"El Centro, CA MSA",2023,4,70784,58650,12134,17.1
MT0623420000000,6,23420,"Fresno, CA MSA",2023,4,523983,485985,37998,7.3
MT0625260000000,6,25260,"Hanford-Corcoran, CA MSA",2023,4,56332,51667,4665,8.3
MT0631080000000,6,31080,"Los Angeles-Long Beach-Anaheim, CA MSA",2023,4,6652539,6354064,298475,4.5
MT0632900000000,6,32900,"Merced, CA MSA",2023,4,118279,107846,10433,8.8
MT0633700000000,6,33700,"Modesto, CA MSA",2023,4,248328,233214,15114,6.1
MT0634900000000,6,34900,"Napa, CA MSA",2023,4,72790,70359,2431,3.3
MT0637100000000,6,37100,"Oxnard-Thousand Oaks-Ventura, CA MSA",2023,4,415701,399246,16455,4
MT0639820000000,6,39820,"Redding, CA MSA",2023,4,77680,74007,3673,4.7
MT0640140000000,6,40140,"Riverside-San Bernardino-Ontario, CA MSA",2023,4,2170375,2073126,97249,4.5
MT0640900000000,6,40900,"Sacramento-Roseville-Folsom, CA MSA",2023,4,1157951,1111380,46571,4
MT0641500000000,6,41500,"Salinas, CA MSA",2023,4,214161,199035,15126,7.1
MT0641740000000,6,41740,"San Diego-Chula Vista-Carlsbad, CA MSA",2023,4,1633631,1576628,57003,3.5
MT0641860000000,6,41860,"San Francisco-Oakland-Fremont, CA MSA",2023,4,2516979,2432286,84693,3.4
MT0641940000000,6,41940,"San Jose-Sunnyvale-Santa Clara, CA MSA",2023,4,1056505,1021481,35024,3.3
MT0642020000000,6,42020,"San Luis Obispo-Paso Robles, CA MSA",2023,4,132413,127866,4547,3.4
MT0642100000000,6,42100,"Santa Cruz-Watsonville, CA MSA",2023,4,134858,127593,7265,5.4
MT0642200000000,6,42200,"Santa Maria-Santa Barbara, CA MSA",2023,4,219421,210773,8648,3.9
MT0642220000000,6,42220,"Santa Rosa-Petaluma, CA MSA",2023,4,246401,237953,8448,3.4
MT0644700000000,6,44700,"Stockton-Lodi, CA MSA",2023,4,361264,340366,20898,5.8
MT0646700000000,6,46700,"Vallejo, CA MSA",2023,4,212329,203390,8939,4.2
MT0647300000000,6,47300,"Visalia, CA MSA",2023,4,215311,194583,20728,9.6
MT0649700000000,6,49700,"Yuba City, CA MSA",2023,4,79122,73436,5686,7.2
MT0814500000000,8,14500,"Boulder, CO MSA",2023,4,193216,187637,5579,2.9
MT0817820000000,8,17820,"Colorado Springs, CO MSA",2023,4,387039,374877,12162,3.1
MT0819740000000,8,19740,"Denver-Aurora-Centennial, CO MSA",2023,4,1760500,1707877,52623,3
MT0822660000000,8,22660,"Fort Collins-Loveland, CO MSA",2023,4,204236,198352,5884,2.9
MT0824300000000,8,24300,"Grand Junction, CO MSA",2023,4,78324,75718,2606,3.3
MT0824540000000,8,24540,"Greeley, CO MSA",2023,4,173326,167766,5560,3.2
MT0839380000000,8,39380,"Pueblo, CO MSA",2023,4,73773,70518,3255,4.4
MT0914860000000,9,14860,"Bridgeport-Stamford-Danbury, CT MSA",2023,4,506909,491705,15204,3
MT0925540000000,9,25540,"Hartford-West Hartford-East Hartford, CT MSA",2023,4,603975,585300,18675,3.1
MT0935300000000,9,35300,"New Haven, CT MSA",2023,4,307423,297834,9589,3.1
MT0935980000000,9,35980,"Norwich-New London-Willimantic, CT MSA",2023,4,139710,135319,4391,3.1
MT0947930000000,9,47930,"Waterbury-Shelton, CT MSA",2023,4,237172,228681,8491,3.6
MT1020100000000,10,20100,"Dover, DE MSA",2023,4,85458,81959,3499,4.1
MT1147900000000,11,47900,"Washington-Arlington-Alexandria, DC-VA-MD-WV MSA",2023,4,3508867,3424745,84122,2.4
MT1215980000000,12,15980,"Cape Coral-Fort Myers, FL MSA",2023,4,368400,356575,11825,3.2
MT1218880000000,12,18880,"Crestview-Fort Walton Beach-Destin, FL MSA",2023,4,141558,137991,3567,2.5
MT1219660000000,12,19660,"Deltona-Daytona Beach-Ormond Beach, FL MSA",2023,4,316527,306112,10415,3.3
MT1223540000000,12,23540,"Gainesville, FL MSA",2023,4,169187,163950,5237,3.1
MT1226140000000,12,26140,"Homosassa Springs, FL MSA",2023,4,53449,51255,2194,4.1
MT1227260000000,12,27260,"Jacksonville, FL MSA",2023,4,846032,820939,25093,3
MT1229460000000,12,29460,"Lakeland-Winter Haven, FL MSA",2023,4,353986,341299,12687,3.6
MT1233100000000,12,33100,"Miami-Fort Lauderdale-West Palm Beach, FL MSA",2023,4,3255805,3176737,79068,2.4
MT1234940000000,12,34940,"Naples-Marco Island, FL MSA",2023,4,179662,174274,5388,3
MT1235840000000,12,35840,"North Port-Bradenton-Sarasota, FL MSA",2023,4,389621,378084,11537,3
MT1236100000000,12,36100,"Ocala, FL MSA",2023,4,155683,150188,5495,3.5
MT1236740000000,12,36740,"Orlando-Kissimmee-Sanford, FL MSA",2023,4,1508621,1466017,42604,2.8
MT1237340000000,12,37340,"Palm Bay-Melbourne-Titusville, FL MSA",2023,4,302117,293286,8831,2.9
MT1237460000000,12,37460,"Panama City-Panama City Beach, FL MSA",2023,4,99555,96763,2792,2.8
MT1237860000000,12,37860,"Pensacola-Ferry Pass-Brent, FL MSA",2023,4,239157,232178,6979,2.9
MT1238940000000,12,38940,"Port St. Lucie, FL MSA",2023,4,236721,228990,7731,3.3
MT1239460000000,12,39460,"Punta Gorda, FL MSA",2023,4,74719,72058,2661,3.6
MT1242680000000,12,42680,"Sebastian-Vero Beach-West Vero Corridor, FL MSA",2023,4,67525,65164,2361,3.5
MT1242700000000,12,42700,"Sebring, FL MSA",2023,4,36578,35050,1528,4.2
MT1245220000000,12,45220,"Tallahassee, FL MSA",2023,4,203702,197615,6087,3
MT1245300000000,12,45300,"Tampa-St. Petersburg-Clearwater, FL MSA",2023,4,1686456,1638492,47964,2.8
MT1248680000000,12,48680,"Wildwood-The Villages, FL MSA",2023,4,33180,31579,1601,4.8
MT1310500000000,13,10500,"Albany, GA MSA",2023,4,62727,60288,2439,3.9
MT1312020000000,13,12020,"Athens-Clarke County, GA MSA",2023,4,105374,102212,3162,3
MT1312060000000,13,12060,"Atlanta-Sandy Springs-Roswell, GA MSA",2023,4,3257332,3153831,103501,3.2
MT1312260000000,13,12260,"Augusta-Richmond County, GA-SC MSA",2023,4,266406,256516,9890,3.7
MT1315260000000,13,15260,"Brunswick-St. Simons, GA MSA",2023,4,54048,52481,1567,2.9
MT1317980000000,13,17980,"Columbus, GA-AL MSA",2023,4,129797,125045,4752,3.7
MT1319140000000,13,19140,"Dalton, GA MSA",2023,4,67035,64616,2419,3.6
MT1323580000000,13,23580,"Gainesville, GA MSA",2023,4,106959,104162,2797,2.6
MT1325980000000,13,25980,"Hinesville, GA MSA",2023,4,31121,29919,1202,3.9
MT1331420000000,13,31420,"Macon-Bibb County, GA MSA",2023,4,97382,93612,3770,3.9
MT1340660000000,13,40660,"Rome, GA MSA",2023,4,47022,45468,1554,3.3
MT1342340000000,13,42340,"Savannah, GA MSA",2023,4,206670,200563,6107,3
MT1346660000000,13,46660,"Valdosta, GA MSA",2023,4,61227,59027,2200,3.6
MT1347580000000,13,47580,"Warner Robins, GA MSA",2023,4,89142,86421,2721,3.1
MT1527980000000,15,27980,"Kahului-Wailuku, HI MSA",2023,4,84125,81726,2399,2.9
MT1546520000000,15,46520,"Urban Honolulu, HI MSA",2023,4,468314,455414,12900,2.8
MT1614260000000,16,14260,"Boise City, ID MSA",2023,4,434186,421772,12414,2.9
MT1617660000000,16,17660,"Coeur d'Alene, ID MSA",2023,4,88315,85202,3113,3.5
MT1626820000000,16,26820,"Idaho Falls, ID MSA",2023,4,83050,80810,2240,2.7
MT1630300000000,16,30300,"Lewiston, ID-WA MSA",2023,4,30454,29580,874,2.9
MT1638540000000,16,38540,"Pocatello, ID MSA",2023,4,39963,38692,1271,3.2
MT1646300000000,16,46300,"Twin Falls, ID MSA",2023,4,59252,57437,1815,3.1
MT1714010000000,17,14010,"Bloomington, IL MSA",2023,4,93261,89914,3347,3.6
MT1716580000000,17,16580,"Champaign-Urbana, IL MSA",2023,4,122849,117870,4979,4.1
MT1716980000000,17,16980,"Chicago-Naperville-Elgin, IL-IN MSA",2023,4,4874085,4674293,199792,4.1
MT1719340000000,17,19340,"Davenport-Moline-Rock Island, IA-IL MSA",2023,4,189736,181910,7826,4.1
MT1719500000000,17,19500,"Decatur, IL MSA",2023,4,45170,42479,2691,6
MT1728100000000,17,28100,"Kankakee, IL MSA",2023,4,50505,47589,2916,5.8
MT1737900000000,17,37900,"Peoria, IL MSA",2023,4,174244,165865,8379,4.8
MT1740420000000,17,40420,"Rockford, IL MSA",2023,4,159493,149611,9882,6.2
MT1744100000000,17,44100,"Springfield, IL MSA",2023,4,102131,97788,4343,4.3
MT1814020000000,18,14020,"Bloomington, IN MSA",2023,4,85530,83068,2462,2.9
MT1818020000000,18,18020,"Columbus, IN MSA",2023,4,39652,38448,1204,3
MT1821140000000,18,21140,"Elkhart-Goshen, IN MSA",2023,4,102268,97875,4393,4.3
MT1821780000000,18,21780,"Evansville, IN MSA",2023,4,135170,131002,4168,3.1
MT1823060000000,18,23060,"Fort Wayne, IN MSA",2023,4,229251,222441,6810,3
MT1826900000000,18,26900,"Indianapolis-Carmel-Greenwood, IN MSA",2023,4,1115908,1081986,33922,3
MT1829020000000,18,29020,"Kokomo, IN MSA",2023,4,35415,33717,1698,4.8
MT1829200000000,18,29200,"Lafayette-West Lafayette, IN MSA",2023,4,119834,116493,3341,2.8
MT1833140000000,18,33140,"Michigan City-La Porte, IN MSA",2023,4,51518,49581,1937,3.8
MT1834620000000,18,34620,"Muncie, IN MSA",2023,4,51756,49834,1922,3.7
MT1843780000000,18,43780,"South Bend-Mishawaka, IN-MI MSA",2023,4,155488,149261,6227,4
MT1845460000000,18,45460,"Terre Haute, IN MSA",2023,4,76913,74219,2694,3.5
MT1911180000000,19,11180,"Ames, IA MSA",2023,4,69353,67730,1623,2.3
MT1916300000000,19,16300,"Cedar Rapids, IA MSA",2023,4,148947,144135,4812,3.2
MT1919780000000,19,19780,"Des Moines-West Des Moines, IA MSA",2023,4,407664,396414,11250,2.8
MT1920220000000,19,20220,"Dubuque, IA MSA",2023,4,53849,52263,1586,2.9
MT1926980000000,19,26980,"Iowa City, IA MSA",2023,4,99114,96719,2395,2.4
MT1943580000000,19,43580,"Sioux City, IA-NE-SD MSA",2023,4,76938,74861,2077,2.7
MT1947940000000,19,47940,"Waterloo-Cedar Falls, IA MSA",2023,4,88990,86315,2675,3
MT2029940000000,20,29940,"Lawrence, KS MSA",2023,4,70002,68176,1826,2.6
MT2031740000000,20,31740,"Manhattan, KS MSA",2023,4,63503,61745,1758,2.8
MT2045820000000,20,45820,"Topeka, KS MSA",2023,4,117860,114293,3567,3
MT2048620000000,20,48620,"Wichita, KS MSA",2023,4,330317,320291,10026,3
MT2114540000000,21,14540,"Bowling Green, KY MSA",2023,4,90502,86973,3529,3.9
MT2121060000000,21,21060,"Elizabethtown, KY MSA",2023,4,53902,51648,2254,4.2
MT2130460000000,21,30460,"Lexington-Fayette, KY MSA",2023,4,271005,261814,9191,3.4
MT2131140000000,21,31140,"Louisville/Jefferson County, KY-IN MSA",2023,4,688918,663469,25449,3.7
MT2136980000000,21,36980,"Owensboro, KY MSA",2023,4,51001,48864,2137,4.2
MT2137140000000,21,37140,"Paducah, KY-IL MSA",2023,4,45666,43755,1911,4.2
MT2210780000000,22,10780,"Alexandria, LA MSA",2023,4,64380,62274,2106,3.3
MT2212940000000,22,12940,"Baton Rouge, LA MSA",2023,4,419251,404924,14327,3.4
MT2225220000000,22,25220,"Hammond, LA MSA",2023,4,60238,57808,2430,4
MT2226380000000,22,26380,"Houma-Bayou Cane-Thibodaux, LA MSA",2023,4,87718,85050,2668,3
MT2229180000000,22,29180,"Lafayette, LA MSA",2023,4,196426,190540,5886,3
MT2229340000000,22,29340,"Lake Charles, LA MSA",2023,4,98441,94874,3567,3.6
MT2233740000000,22,33740,"Monroe, LA MSA",2023,4,96388,92478,3910,4.1
MT2235380000000,22,35380,"New Orleans-Metairie, LA MSA",2023,4,468184,450612,17572,3.8
MT2243340000000,22,43340,"Shreveport-Bossier City, LA MSA",2023,4,169764,163620,6144,3.6
MT2243640000000,22,43640,"Slidell-Mandeville-Covington, LA MSA",2023,4,128232,124433,3799,3
MT2312620000000,23,12620,"Bangor, ME MSA",2023,4,73438,71608,1830,2.5
MT2330340000000,23,30340,"Lewiston-Auburn, ME MSA",2023,4,54296,52887,1409,2.6
MT2338860000000,23,38860,"Portland-South Portland, ME MSA",2023,4,306065,299739,6326,2.1
MT2412580000000,24,12580,"Baltimore-Columbia-Towson, MD MSA",2023,4,1465480,1436971,28509,1.9
MT2425180000000,24,25180,"Hagerstown-Martinsburg, MD-WV MSA",2023,4,141954,138243,3711,2.6
MT2430500000000,24,30500,"Lexington Park, MD MSA",2023,4,106024,104152,1872,1.8
MT2441540000000,24,41540,"Salisbury, MD MSA",2023,4,62757,61281,1476,2.4
MT2511200000000,25,11200,"Amherst Town-Northampton, MA MSA",2023,4,83074,80486,2588,3.1
MT2512700000000,25,12700,"Barnstable Town, MA MSA",2023,4,113746,108820,4926,4.3
MT2514460000000,25,14460,"Boston-Cambridge-Newton, MA-NH MSA",2023,4,2751564,2666419,85145,3.1
MT2538340000000,25,38340,"Pittsfield, MA MSA",2023,4,63379,61084,2295,3.6
MT2544140000000,25,44140,"Springfield, MA MSA",2023,4,219988,210427,9561,4.3
MT2549340000000,25,49340,"Worcester, MA MSA",2023,4,452612,436592,16020,3.5
MT2611460000000,26,11460,"Ann Arbor, MI MSA",2023,4,204127,197698,6429,3.1
MT2612980000000,26,12980,"Battle Creek, MI MSA",2023,4,61879,59217,2662,4.3
MT2613020000000,26,13020,"Bay City, MI MSA",2023,4,49632,47170,2462,5
MT2619820000000,26,19820,"Detroit-Warren-Dearborn, MI MSA",2023,4,2156933,2085963,70970,3.3
MT2622420000000,26,22420,"Flint, MI MSA",2023,4,186473,177387,9086,4.9
MT2624340000000,26,24340,"Grand Rapids-Wyoming-Kentwood, MI MSA",2023,4,621461,601041,20420,3.3
MT2627100000000,26,27100,"Jackson, MI MSA",2023,4,74825,71788,3037,4.1
MT2628020000000,26,28020,"Kalamazoo-Portage, MI MSA",2023,4,138070,133153,4917,3.6
MT2629620000000,26,29620,"Lansing-East Lansing, MI MSA",2023,4,248540,239445,9095,3.7
MT2633220000000,26,33220,"Midland, MI MSA",2023,4,42290,40703,1587,3.8
MT2633780000000,26,33780,"Monroe, MI MSA",2023,4,76987,73733,3254,4.2
MT2634740000000,26,34740,"Muskegon-Norton Shores, MI MSA",2023,4,82955,79441,3514,4.2
MT2635660000000,26,35660,"Niles, MI MSA",2023,4,75120,72046,3074,4.1
MT2640980000000,26,40980,"Saginaw, MI MSA",2023,4,84169,79769,4400,5.2
MT2645900000000,26,45900,"Traverse City, MI MSA",2023,4,80211,77123,3088,3.8
MT2720260000000,27,20260,"Duluth, MN-WI MSA",2023,4,139874,134881,4993,3.6
MT2731860000000,27,31860,"Mankato, MN MSA",2023,4,60037,58605,1432,2.4
MT2733460000000,27,33460,"Minneapolis-St. Paul-Bloomington, MN-WI MSA",2023,4,2066658,2011200,55458,2.7
MT2740340000000,27,40340,"Rochester, MN MSA",2023,4,125632,122559,3073,2.4
MT2741060000000,27,41060,"St. Cloud, MN MSA",2023,4,109537,106178,3359,3.1
MT2825060000000,28,25060,"Gulfport-Biloxi, MS MSA",2023,4,183169,177808,5361,2.9
MT2825620000000,28,25620,"Hattiesburg, MS MSA",2023,4,69791,67767,2024,2.9
MT2827140000000,28,27140,"Jackson, MS MSA",2023,4,277078,269321,7757,2.8
MT2916020000000,29,16020,"Cape Girardeau, MO-IL MSA",2023,4,48700,47372,1328,2.7
MT2917860000000,29,17860,"Columbia, MO MSA",2023,4,113196,110334,2862,2.5
MT2927620000000,29,27620,"Jefferson City, MO MSA",2023,4,74663,72780,1883,2.5
MT2927900000000,29,27900,"Joplin, MO-KS MSA",2023,4,96884,94117,2767,2.9
MT2928140000000,29,28140,"Kansas City, MO-KS MSA",2023,4,1178687,1144518,34169,2.9
MT2941140000000,29,41140,"St. Joseph, MO-KS MSA",2023,4,53574,51961,1613,3
MT2941180000000,29,41180,"St. Louis, MO-IL MSA",2023,4,1466476,1420983,45493,3.1
MT2944180000000,29,44180,"Springfield, MO MSA",2023,4,238219,231961,6258,2.6
MT3013740000000,30,13740,"Billings, MT MSA",2023,4,98929,96710,2219,2.2
MT3014580000000,30,14580,"Bozeman, MT MSA",2023,4,75812,74331,1481,2
MT3024500000000,30,24500,"Great Falls, MT MSA",2023,4,39409,38422,987,2.5
MT3025740000000,30,25740,"Helena, MT MSA",2023,4,47179,46064,1115,2.4
MT3033540000000,30,33540,"Missoula, MT MSA",2023,4,73572,71851,1721,2.3
MT3124260000000,31,24260,"Grand Island, NE MSA",2023,4,42291,41387,904,2.1
MT3130700000000,31,30700,"Lincoln, NE MSA",2023,4,191946,188093,3853,2
MT3136540000000,31,36540,"Omaha, NE-IA MSA",2023,4,520594,508388,12206,2.3
MT3216180000000,32,16180,"Carson City, NV MSA",2023,4,28693,27436,1257,4.4
MT3229820000000,32,29820,"Las Vegas-Henderson-North Las Vegas, NV MSA",2023,4,1180935,1118375,62560,5.3
MT3239900000000,32,39900,"Reno, NV MSA",2023,4,295562,282552,13010,4.4
MT3331700000000,33,31700,"Manchester-Nashua, NH MSA",2023,4,238679,233293,5386,2.3
MT3412100000000,34,12100,"Atlantic City-Hammonton, NJ MSA",2023,4,180133,169864,10269,5.7
MT3445940000000,34,45940,"Trenton-Princeton, NJ MSA",2023,4,198521,190708,7813,3.9
MT3447220000000,34,47220,"Vineland, NJ MSA",2023,4,65819,61586,4233,6.4
MT3510740000000,35,10740,"Albuquerque, NM MSA",2023,4,456016,440982,15034,3.3
MT3522140000000,35,22140,"Farmington, NM MSA",2023,4,49435,47355,2080,4.2
MT3529740000000,35,29740,"Las Cruces, NM MSA",2023,4,100217,95903,4314,4.3
MT3542140000000,35,42140,"Santa Fe, NM MSA",2023,4,73300,71000,2300,3.1
MT3610580000000,36,10580,"Albany-Schenectady-Troy, NY MSA",2023,4,457643,444450,13193,2.9
MT3613780000000,36,13780,"Binghamton, NY MSA",2023,4,106607,103062,3545,3.3
MT3615380000000,36,15380,"Buffalo-Cheektowaga, NY MSA",2023,4,561212,542575,18637,3.3
MT3621300000000,36,21300,"Elmira, NY MSA",2023,4,35499,34291,1208,3.4
MT3624020000000,36,24020,"Glens Falls, NY MSA",2023,4,59857,58017,1840,3.1
MT3627060000000,36,27060,"Ithaca, NY MSA",2023,4,48235,46881,1354,2.8
MT3628740000000,36,28740,"Kingston, NY MSA",2023,4,87062,84393,2669,3.1
MT3628880000000,36,28880,"Kiryas Joel-Poughkeepsie-Newburgh, NY MSA",2023,4,338106,327949,10157,3
MT3635620000000,36,35620,"New York-Newark-Jersey City, NY-NJ MSA",2023,4,10091529,9669663,421866,4.2
MT3640380000000,36,40380,"Rochester, NY MSA",2023,4,514992,498832,16160,3.1
MT3645060000000,36,45060,"Syracuse, NY MSA",2023,4,310492,300526,9966,3.2
MT3646540000000,36,46540,"Utica-Rome, NY MSA",2023,4,127952,123720,4232,3.3
MT3648060000000,36,48060,"Watertown-Fort Drum, NY MSA",2023,4,45178,43458,1720,3.8
MT3711700000000,37,11700,"Asheville, NC MSA",2023,4,210838,204997,5841,2.8
MT3715500000000,37,15500,"Burlington, NC MSA",2023,4,85463,82534,2929,3.4
MT3716740000000,37,16740,"Charlotte-Concord-Gastonia, NC-SC MSA",2023,4,1465443,1417472,47971,3.3
MT3720500000000,37,20500,"Durham-Chapel Hill, NC MSA",2023,4,319830,310009,9821,3.1
MT3722180000000,37,22180,"Fayetteville, NC MSA",2023,4,154900,148025,6875,4.4
MT3724140000000,37,24140,"Goldsboro, NC MSA",2023,4,50450,48628,1822,3.6
MT3724660000000,37,24660,"Greensboro-High Point, NC MSA",2023,4,372264,358015,14249,3.8
MT3724780000000,37,24780,"Greenville, NC MSA",2023,4,82973,79633,3340,4
MT3725860000000,37,25860,"Hickory-Lenoir-Morganton, NC MSA",2023,4,172984,167416,5568,3.2
MT3727340000000,37,27340,"Jacksonville, NC MSA",2023,4,73633,70978,2655,3.6
MT3738240000000,37,38240,"Pinehurst-Southern Pines, NC MSA",2023,4,43851,42365,1486,3.4
MT3739580000000,37,39580,"Raleigh-Cary, NC MSA",2023,4,828744,804252,24492,3
MT3740580000000,37,40580,"Rocky Mount, NC MSA",2023,4,63837,60771,3066,4.8
MT3748900000000,37,48900,"Wilmington, NC MSA",2023,4,220576,212861,7715,3.5
MT3749180000000,37,49180,"Winston-Salem, NC MSA",2023,4,325537,314234,11303,3.5
MT3813900000000,38,13900,"Bismarck, ND MSA",2023,4,72408,70958,1450,2
MT3822020000000,38,22020,"Fargo, ND-MN MSA",2023,4,151810,148944,2866,1.9
MT3824220000000,38,24220,"Grand Forks, ND-MN MSA",2023,4,55060,53899,1161,2.1
MT3833500000000,38,33500,"Minot, ND MSA",2023,4,39881,39078,803,2
MT3910420000000,39,10420,"Akron, OH MSA",2023,4,357970,345360,12610,3.5
MT3915940000000,39,15940,"Canton-Massillon, OH MSA",2023,4,190251,183266,6985,3.7
MT3917140000000,39,17140,"Cincinnati, OH-KY-IN MSA",2023,4,1160958,1123001,37957,3.3
MT3917410000000,39,17410,"Cleveland, OH MSA",2023,4,1081679,1043032,38647,3.6
MT3918140000000,39,18140,"Columbus, OH MSA",2023,4,1133769,1098663,35106,3.1
MT3919430000000,39,19430,"Dayton-Kettering-Beavercreek, OH MSA",2023,4,387180,373576,13604,3.5
MT3930620000000,39,30620,"Lima, OH MSA",2023,4,47504,45711,1793,3.8
MT3931900000000,39,31900,"Mansfield, OH MSA",2023,4,52422,50257,2165,4.1
MT3941780000000,39,41780,"Sandusky, OH MSA",2023,4,56564,53876,2688,4.8
MT3944220000000,39,44220,"Springfield, OH MSA",2023,4,61719,59484,2235,3.6
MT3945780000000,39,45780,"Toledo, OH MSA",2023,4,293444,282050,11394,3.9
MT3948260000000,39,48260,"Weirton-Steubenville, WV-OH MSA",2023,4,52364,49858,2506,4.8
MT3949660000000,39,49660,"Youngstown-Warren, OH MSA",2023,4,189549,181846,7703,4.1
MT4021420000000,40,21420,"Enid, OK MSA",2023,4,28191,27402,789,2.8
MT4030020000000,40,30020,"Lawton, OK MSA",2023,4,51352,49543,1809,3.5
MT4036420000000,40,36420,"Oklahoma City, OK MSA",2023,4,754366,733335,21031,2.8
MT4046140000000,40,46140,"Tulsa, OK MSA",2023,4,511809,496563,15246,3
MT4110540000000,41,10540,"Albany, OR MSA",2023,4,61214,58855,2359,3.9
MT4113460000000,41,13460,"Bend, OR MSA",2023,4,129626,124840,4786,3.7
MT4118700000000,41,18700,"Corvallis, OR MSA",2023,4,49129,47727,1402,2.9
MT4121660000000,41,21660,"Eugene-Springfield, OR MSA",2023,4,185989,179156,6833,3.7
MT4124420000000,41,24420,"Grants Pass, OR MSA",2023,4,34728,33004,1724,5
MT4132780000000,41,32780,"Medford, OR MSA",2023,4,103782,99379,4403,4.2
MT4138900000000,41,38900,"Portland-Vancouver-Hillsboro, OR-WA MSA",2023,4,1372611,1328017,44594,3.2
MT4141420000000,41,41420,"Salem, OR MSA",2023,4,216133,208563,7570,3.5
MT4210900000000,42,10900,"Allentown-Bethlehem-Easton, PA-NJ MSA",2023,4,447609,430439,17170,3.8
MT4211020000000,42,11020,"Altoona, PA MSA",2023,4,57116,55022,2094,3.7
MT4216540000000,42,16540,"Chambersburg, PA MSA",2023,4,76494,74114,2380,3.1
MT4221500000000,42,21500,"Erie, PA MSA",2023,4,126578,121488,5090,4
MT4223900000000,42,23900,"Gettysburg, PA MSA",2023,4,52254,50695,1559,3
MT4225420000000,42,25420,"Harrisburg-Carlisle, PA MSA",2023,4,310184,300499,9685,3.1
MT4227780000000,42,27780,"Johnstown, PA MSA",2023,4,56986,54511,2475,4.3
MT4229540000000,42,29540,"Lancaster, PA MSA",2023,4,290438,282017,8421,2.9
MT4230140000000,42,30140,"Lebanon, PA MSA",2023,4,72664,70415,2249,3.1
MT4237980000000,42,37980,"Philadelphia-Camden-Wilmington, PA-NJ-DE-MD MSA",2023,4,3271705,3152700,119005,3.6
MT4238300000000,42,38300,"Pittsburgh, PA MSA",2023,4,1227420,1181727,45693,3.7
MT4239740000000,42,39740,"Reading, PA MSA",2023,4,217790,209851,7939,3.6
MT4242540000000,42,42540,"Scranton--Wilkes-Barre, PA MSA",2023,4,278096,265725,12371,4.4
MT4244300000000,42,44300,"State College, PA MSA",2023,4,77435,75185,2250,2.9
MT4248700000000,42,48700,"Williamsport, PA MSA",2023,4,52731,50637,2094,4
MT4249620000000,42,49620,"York-Hanover, PA MSA",2023,4,238142,230523,7619,3.2
MT4439300000000,44,39300,"Providence-Warwick, RI-MA MSA",2023,4,875387,846949,28438,3.2
MT4516700000000,45,16700,"Charleston-North Charleston, SC MSA",2023,4,426952,416261,10691,2.5
MT4517900000000,45,17900,"Columbia, SC MSA",2023,4,408229,396619,11610,2.8
MT4522500000000,45,22500,"Florence, SC MSA",2023,4,91183,88260,2923,3.2
MT4524860000000,45,24860,"Greenville-Anderson-Greer, SC MSA",2023,4,467149,454694,12455,2.7
MT4525940000000,45,25940,"Hilton Head Island-Bluffton-Port Royal, SC MSA",2023,4,95994,93510,2484,2.6
MT4534820000000,45,34820,"Myrtle Beach-Conway-North Myrtle Beach, SC MSA",2023,4,165268,159580,5688,3.4
MT4543900000000,45,43900,"Spartanburg, SC MSA",2023,4,171565,166353,5212,3
MT4544940000000,45,44940,"Sumter, SC MSA",2023,4,41015,39466,1549,3.8
MT4639660000000,46,39660,"Rapid City, SD MSA",2023,4,78295,76924,1371,1.8
MT4643620000000,46,43620,"Sioux Falls, SD-MN MSA",2023,4,170681,167834,2847,1.7
MT4716860000000,47,16860,"Chattanooga, TN-GA MSA",2023,4,284550,275875,8675,3
MT4717300000000,47,17300,"Clarksville, TN-KY MSA",2023,4,135378,130301,5077,3.8
MT4717420000000,47,17420,"Cleveland, TN MSA",2023,4,56605,54618,1987,3.5
MT4727180000000,47,27180,"Jackson, TN MSA",2023,4,77711,74964,2747,3.5
MT4727740000000,47,27740,"Johnson City, TN MSA",2023,4,95856,92694,3162,3.3
MT4728700000000,47,28700,"Kingsport-Bristol, TN-VA MSA",2023,4,131739,127348,4391,3.3
MT4728940000000,47,28940,"Knoxville, TN MSA",2023,4,444042,430842,13200,3
MT4732820000000,47,32820,"Memphis, TN-MS-AR MSA",2023,4,623702,600034,23668,3.8
MT4734100000000,47,34100,"Morristown, TN MSA",2023,4,52638,50792,1846,3.5
MT4734980000000,47,34980,"Nashville-Davidson--Murfreesboro--Franklin, TN MSA",2023,4,1139014,1109420,29594,2.6
MT4810180000000,48,10180,"Abilene, TX MSA",2023,4,84242,81253,2989,3.5
MT4811100000000,48,11100,"Amarillo, TX MSA",2023,4,133831,129547,4284,3.2
MT4812420000000,48,12420,"Austin-Round Rock-San Marcos, TX MSA",2023,4,1448937,1399090,49847,3.4
MT4813140000000,48,13140,"Beaumont-Port Arthur, TX MSA",2023,4,174136,164041,10095,5.8
MT4815180000000,48,15180,"Brownsville-Harlingen, TX MSA",2023,4,184533,174453,10080,5.5
MT4817780000000,48,17780,"College Station-Bryan, TX MSA",2023,4,145081,139987,5094,3.5
MT4818580000000,48,18580,"Corpus Christi, TX MSA",2023,4,205491,196420,9071,4.4
MT4819100000000,48,19100,"Dallas-Fort Worth-Arlington, TX MSA",2023,4,4362728,4197850,164878,3.8
MT4820580000000,48,20580,"Eagle Pass, TX MSA",2023,4,23747,21914,1833,7.7
MT4821340000000,48,21340,"El Paso, TX MSA",2023,4,397225,380277,16948,4.3
MT4826420000000,48,26420,"Houston-Pasadena-The Woodlands, TX MSA",2023,4,3717140,3558688,158452,4.3
MT4828660000000,48,28660,"Killeen-Temple, TX MSA",2023,4,196509,187785,8724,4.4
MT4829700000000,48,29700,"Laredo, TX MSA",2023,4,114843,110081,4762,4.1
MT4830980000000,48,30980,"Longview, TX MSA",2023,4,128628,123097,5531,4.3
MT4831180000000,48,31180,"Lubbock, TX MSA",2023,4,178865,172627,6238,3.5
MT4832580000000,48,32580,"McAllen-Edinburg-Mission, TX MSA",2023,4,385787,362025,23762,6.2
MT4833260000000,48,33260,"Midland, TX MSA",2023,4,98957,96098,2859,2.9
MT4836220000000,48,36220,"Odessa, TX MSA",2023,4,83030,80196,2834,3.4
MT4841660000000,48,41660,"San Angelo, TX MSA",2023,4,60381,58367,2014,3.3
MT4841700000000,48,41700,"San Antonio-New Braunfels, TX MSA",2023,4,1294590,1245516,49074,3.8
MT4843300000000,48,43300,"Sherman-Denison, TX MSA",2023,4,69143,66480,2663,3.9
MT4845500000000,48,45500,"Texarkana, TX-AR MSA",2023,4,60713,58258,2455,4
MT4846340000000,48,46340,"Tyler, TX MSA",2023,4,115309,110935,4374,3.8
MT4847020000000,48,47020,"Victoria, TX MSA",2023,4,44669,42861,1808,4
MT4847380000000,48,47380,"Waco, TX MSA",2023,4,142410,136754,5656,4
MT4848660000000,48,48660,"Wichita Falls, TX MSA",2023,4,66384,63882,2502,3.8
MT4930860000000,49,30860,"Logan, UT-ID MSA",2023,4,79076,77265,1811,2.3
MT4936260000000,49,36260,"Ogden, UT MSA",2023,4,344510,336216,8294,2.4
MT4939340000000,49,39340,"Provo-Orem-Lehi, UT MSA",2023,4,361442,352379,9063,2.5
MT4941100000000,49,41100,"St. George, UT MSA",2023,4,90000,87485,2515,2.8
MT4941620000000,49,41620,"Salt Lake City-Murray, UT MSA",2023,4,722106,703438,18668,2.6
MT5015540000000,50,15540,"Burlington-South Burlington, VT MSA",2023,4,129196,127128,2068,1.6
MT5113980000000,51,13980,"Blacksburg-Christiansburg-Radford, VA MSA",2023,4,92607,90123,2484,2.7
MT5116820000000,51,16820,"Charlottesville, VA MSA",2023,4,117941,115073,2868,2.4
MT5125500000000,51,25500,"Harrisonburg, VA MSA",2023,4,72581,70774,1807,2.5
MT5131340000000,51,31340,"Lynchburg, VA MSA",2023,4,128473,124601,3872,3
MT5140060000000,51,40060,"Richmond, VA MSA",2023,4,722038,702235,19803,2.7
MT5140220000000,51,40220,"Roanoke, VA MSA",2023,4,157187,152924,4263,2.7
MT5144420000000,51,44420,"Staunton-Stuarts Draft, VA MSA",2023,4,65616,64062,1554,2.4
MT5147260000000,51,47260,"Virginia Beach-Chesapeake-Norfolk, VA-NC MSA",2023,4,877300,851839,25461,2.9
MT5149020000000,51,49020,"Winchester, VA-WV MSA",2023,4,76681,74744,1937,2.5
MT5313380000000,53,13380,"Bellingham, WA MSA",2023,4,113966,109957,4009,3.5
MT5314740000000,53,14740,"Bremerton-Silverdale-Port Orchard, WA MSA",2023,4,121169,116862,4307,3.6
MT5328420000000,53,28420,"Kennewick-Richland, WA MSA",2023,4,143733,137493,6240,4.3
MT5331020000000,53,31020,"Longview-Kelso, WA MSA",2023,4,47215,45171,2044,4.3
MT5334580000000,53,34580,"Mount Vernon-Anacortes, WA MSA",2023,4,57689,55400,2289,4
MT5336500000000,53,36500,"Olympia-Lacey-Tumwater, WA MSA",2023,4,140614,135535,5079,3.6
MT5342660000000,53,42660,"Seattle-Tacoma-Bellevue, WA MSA",2023,4,2304233,2214021,90212,3.9
MT5344060000000,53,44060,"Spokane-Spokane Valley, WA MSA",2023,4,279224,268984,10240,3.7
MT5347460000000,53,47460,"Walla Walla, WA MSA",2023,4,29386,28351,1035,3.5
MT5348300000000,53,48300,"Wenatchee-East Wenatchee, WA MSA",2023,4,61456,58976,2480,4
MT5349420000000,53,49420,"Yakima, WA MSA",2023,4,125681,119390,6291,5
MT5413220000000,54,13220,"Beckley, WV MSA",2023,4,45728,44069,1659,3.6
MT5416620000000,54,16620,"Charleston, WV MSA",2023,4,90687,87569,3118,3.4
MT5426580000000,54,26580,"Huntington-Ashland, WV-KY-OH MSA",2023,4,155230,148548,6682,4.3
MT5434060000000,54,34060,"Morgantown, WV MSA",2023,4,71169,68938,2231,3.1
MT5437620000000,54,37620,"Parkersburg-Vienna, WV MSA",2023,4,39179,37670,1509,3.9
MT5448540000000,54,48540,"Wheeling, WV-OH MSA",2023,4,59748,57271,2477,4.1
MT5511540000000,55,11540,"Appleton, WI MSA",2023,4,136117,133233,2884,2.1
MT5520740000000,55,20740,"Eau Claire, WI MSA",2023,4,95065,92531,2534,2.7
MT5522540000000,55,22540,"Fond du Lac, WI MSA",2023,4,56055,54744,1311,2.3
MT5524580000000,55,24580,"Green Bay, WI MSA",2023,4,177615,173457,4158,2.3
MT5527500000000,55,27500,"Janesville-Beloit, WI MSA",2023,4,85947,83263,2684,3.1
MT5528450000000,55,28450,"Kenosha, WI MSA",2023,4,93981,91217,2764,2.9
MT5529100000000,55,29100,"La Crosse-Onalaska, WI-MN MSA",2023,4,89869,87790,2079,2.3
MT5531540000000,55,31540,"Madison, WI MSA",2023,4,401777,393687,8090,2
MT5533340000000,55,33340,"Milwaukee-Waukesha, WI MSA",2023,4,811298,788135,23163,2.9
MT5536780000000,55,36780,"Oshkosh-Neenah, WI MSA",2023,4,91943,89865,2078,2.3
MT5539540000000,55,39540,"Racine-Mount Pleasant, WI MSA",2023,4,100456,97327,3129,3.1
MT5543100000000,55,43100,"Sheboygan, WI MSA",2023,4,62663,61355,1308,2.1
MT5548140000000,55,48140,"Wausau, WI MSA",2023,4,74887,73144,1743,2.3
MT5616220000000,56,16220,"Casper, WY MSA",2023,4,42128,40856,1272,3
MT5616940000000,56,16940,"Cheyenne, WY MSA",2023,4,48746,47260,1486,3
MT7210380000000,72,10380,"Aguadilla, PR MSA",2023,4,87035,80335,6700,7.7
MT7211640000000,72,11640,"Arecibo, PR MSA",2023,4,65119,60855,4264,6.5
MT7225020000000,72,25020,"Guayama, PR MSA",2023,4,18603,16870,1733,9.3
MT7232420000000,72,32420,"Mayaguez, PR MSA",2023,4,64894,59946,4948,7.6
MT7238660000000,72,38660,"Ponce, PR MSA",2023,4,87590,79489,8101,9.2
MT7241980000000,72,41980,"San Juan-Bayamon-Caguas, PR MSA",2023,4,793135,753222,39913,5
MT0111500000000,1,11500,"Anniston-Oxford, AL MSA",2023,5,49258,48065,1193,2.4
MT0112220000000,1,12220,"Auburn-Opelika, AL MSA",2023,5,94065,91981,2084,2.2
MT0113820000000,1,13820,"Birmingham, AL MSA",2023,5,562295,550298,11997,2.1
MT0119300000000,1,19300,"Daphne-Fairhope-Foley, AL MSA",2023,5,112183,109841,2342,2.1
MT0119460000000,1,19460,"Decatur, AL MSA",2023,5,73642,72198,1444,2
MT0120020000000,1,20020,"Dothan, AL MSA",2023,5,66840,65284,1556,2.3
MT0122520000000,1,22520,"Florence-Muscle Shoals, AL MSA",2023,5,68302,66618,1684,2.5
MT0123460000000,1,23460,"Gadsden, AL MSA",2023,5,41231,40257,974,2.4
MT0126620000000,1,26620,"Huntsville, AL MSA",2023,5,266611,261571,5040,1.9
MT0133660000000,1,33660,"Mobile, AL MSA",2023,5,182558,177426,5132,2.8
MT0133860000000,1,33860,"Montgomery, AL MSA",2023,5,173517,169214,4303,2.5
MT0146220000000,1,46220,"Tuscaloosa, AL MSA",2023,5,124300,121266,3034,2.4
MT0211260000000,2,11260,"Anchorage, AK MSA",2023,5,199177,191836,7341,3.7
MT0221820000000,2,21820,"Fairbanks-College, AK MSA",2023,5,44907,43263,1644,3.7
MT0422380000000,4,22380,"Flagstaff, AZ MSA",2023,5,73725,70770,2955,4
MT0429420000000,4,29420,"Lake Havasu City-Kingman, AZ MSA",2023,5,86221,82273,3948,4.6
MT0438060000000,4,38060,"Phoenix-Mesa-Chandler, AZ MSA",2023,5,2657813,2570522,87291,3.3
MT0439150000000,4,39150,"Prescott Valley-Prescott, AZ MSA",2023,5,105522,101589,3933,3.7
MT0443420000000,4,43420,"Sierra Vista-Douglas, AZ MSA",2023,5,47964,45835,2129,4.4
MT0446060000000,4,46060,"Tucson, AZ MSA",2023,5,493704,475714,17990,3.6
MT0449740000000,4,49740,"Yuma, AZ MSA",2023,5,98179,86427,11752,12
MT0522220000000,5,22220,"Fayetteville-Springdale-Rogers, AR MSA",2023,5,296321,289422,6899,2.3
MT0522900000000,5,22900,"Fort Smith, AR-OK MSA",2023,5,100926,97863,3063,3
MT0526300000000,5,26300,"Hot Springs, AR MSA",2023,5,43648,42226,1422,3.3
MT0527860000000,5,27860,"Jonesboro, AR MSA",2023,5,64946,63226,1720,2.6
MT0530780000000,5,30780,"Little Rock-North Little Rock-Conway, AR MSA",2023,5,370065,359948,10117,2.7
MT0612540000000,6,12540,"Bakersfield-Delano, CA MSA",2023,5,399783,367564,32219,8.1
MT0617020000000,6,17020,"Chico, CA MSA",2023,5,90561,85972,4589,5.1
MT0620940000000,6,20940,"El Centro, CA MSA",2023,5,71073,58908,12165,17.1
MT0623420000000,6,23420,"Fresno, CA MSA",2023,5,525681,487059,38622,7.3
MT0625260000000,6,25260,"Hanford-Corcoran, CA MSA",2023,5,56474,51736,4738,8.4
MT0631080000000,6,31080,"Los Angeles-Long Beach-Anaheim, CA MSA",2023,5,6655101,6354814,300287,4.5
MT0632900000000,6,32900,"Merced, CA MSA",2023,5,118732,108141,10591,8.9
MT0633700000000,6,33700,"Modesto, CA MSA",2023,5,248917,233595,15322,6.2
MT0634900000000,6,34900,"Napa, CA MSA",2023,5,72963,70503,2460,3.4
MT0637100000000,6,37100,"Oxnard-Thousand Oaks-Ventura, CA MSA",2023,5,416640,399951,16689,4
MT0639820000000,6,39820,"Redding, CA MSA",2023,5,77888,74184,3704,4.8
MT0640140000000,6,40140,"Riverside-San Bernardino-Ontario, CA MSA",2023,5,2173316,2074992,98324,4.5
MT0640900000000,6,40900,"Sacramento-Roseville-Folsom, CA MSA",2023,5,1159250,1112149,47101,4.1
MT0641500000000,6,41500,"Salinas, CA MSA",2023,5,215202,199953,15249,7.1
MT0641740000000,6,41740,"San Diego-Chula Vista-Carlsbad, CA MSA",2023,5,1634868,1577126,57742,3.5
MT0641860000000,6,41860,"San Francisco-Oakland-Fremont, CA MSA",2023,5,2515199,2428902,86297,3.4
MT0641940000000,6,41940,"San Jose-Sunnyvale-Santa Clara, CA MSA",2023,5,1055924,1019708,36216,3.4
MT0642020000000,6,42020,"San Luis Obispo-Paso Robles, CA MSA",2023,5,132581,127995,4586,3.5
MT0642100000000,6,42100,"Santa Cruz-Watsonville, CA MSA",2023,5,134947,127585,7362,5.5
MT0642200000000,6,42200,"Santa Maria-Santa Barbara, CA MSA",2023,5,220206,211475,8731,4
MT0642220000000,6,42220,"Santa Rosa-Petaluma, CA MSA",2023,5,246610,238022,8588,3.5
MT0644700000000,6,44700,"Stockton-Lodi, CA MSA",2023,5,362395,341173,21222,5.9
MT0646700000000,6,46700,"Vallejo, CA MSA",2023,5,212759,203761,8998,4.2
MT0647300000000,6,47300,"Visalia, CA MSA",2023,5,215931,194954,20977,9.7
MT0649700000000,6,49700,"Yuba City, CA MSA",2023,5,79369,73652,5717,7.2
MT0814500000000,8,14500,"Boulder, CO MSA",2023,5,193385,187526,5859,3
MT0817820000000,8,17820,"Colorado Springs, CO MSA",2023,5,387967,375438,12529,3.2
MT0819740000000,8,19740,"Denver-Aurora-Centennial, CO MSA",2023,5,1761761,1707142,54619,3.1
MT0822660000000,8,22660,"Fort Collins-Loveland, CO MSA",2023,5,204803,198681,6122,3
MT0824300000000,8,24300,"Grand Junction, CO MSA",2023,5,78373,75680,2693,3.4
MT0824540000000,8,24540,"Greeley, CO MSA",2023,5,173883,168141,5742,3.3
MT0839380000000,8,39380,"Pueblo, CO MSA",2023,5,73705,70392,3313,4.5
MT0914860000000,9,14860,"Bridgeport-Stamford-Danbury, CT MSA",2023,5,507316,492241,15075,3
MT0925540000000,9,25540,"Hartford-West Hartford-East Hartford, CT MSA",2023,5,604773,586426,18347,3
MT0935300000000,9,35300,"New Haven, CT MSA",2023,5,307807,298402,9405,3.1
MT0935980000000,9,35980,"Norwich-New London-Willimantic, CT MSA",2023,5,139743,135408,4335,3.1
MT0947930000000,9,47930,"Waterbury-Shelton, CT MSA",2023,5,237209,228836,8373,3.5
MT1020100000000,10,20100,"Dover, DE MSA",2023,5,85514,82017,3497,4.1
MT1147900000000,11,47900,"Washington-Arlington-Alexandria, DC-VA-MD-WV MSA",2023,5,3512009,3428707,83302,2.4
MT1215980000000,12,15980,"Cape Coral-Fort Myers, FL MSA",2023,5,369723,357928,11795,3.2
MT1218880000000,12,18880,"Crestview-Fort Walton Beach-Destin, FL MSA",2023,5,141712,138064,3648,2.6
MT1219660000000,12,19660,"Deltona-Daytona Beach-Ormond Beach, FL MSA",2023,5,317149,306550,10599,3.3
MT1223540000000,12,23540,"Gainesville, FL MSA",2023,5,169371,164015,5356,3.2
MT1226140000000,12,26140,"Homosassa Springs, FL MSA",2023,5,53528,51280,2248,4.2
MT1227260000000,12,27260,"Jacksonville, FL MSA",2023,5,846759,821249,25510,3
MT1229460000000,12,29460,"Lakeland-Winter Haven, FL MSA",2023,5,354676,341813,12863,3.6
MT1233100000000,12,33100,"Miami-Fort Lauderdale-West Palm Beach, FL MSA",2023,5,3260945,3181710,79235,2.4
MT1234940000000,12,34940,"Naples-Marco Island, FL MSA",2023,5,180602,175215,5387,3
MT1235840000000,12,35840,"North Port-Bradenton-Sarasota, FL MSA",2023,5,390764,379047,11717,3
MT1236100000000,12,36100,"Ocala, FL MSA",2023,5,155790,150163,5627,3.6
MT1236740000000,12,36740,"Orlando-Kissimmee-Sanford, FL MSA",2023,5,1512373,1469255,43118,2.9
MT1237340000000,12,37340,"Palm Bay-Melbourne-Titusville, FL MSA",2023,5,302746,293760,8986,3
MT1237460000000,12,37460,"Panama City-Panama City Beach, FL MSA",2023,5,99815,96961,2854,2.9
MT1237860000000,12,37860,"Pensacola-Ferry Pass-Brent, FL MSA",2023,5,239575,232494,7081,3
MT1238940000000,12,38940,"Port St. Lucie, FL MSA",2023,5,237489,229655,7834,3.3
MT1239460000000,12,39460,"Punta Gorda, FL MSA",2023,5,74839,72162,2677,3.6
MT1242680000000,12,42680,"Sebastian-Vero Beach-West Vero Corridor, FL MSA",2023,5,67695,65328,2367,3.5
MT1242700000000,12,42700,"Sebring, FL MSA",2023,5,36630,35083,1547,4.2
MT1245220000000,12,45220,"Tallahassee, FL MSA",2023,5,203957,197788,6169,3
MT1245300000000,12,45300,"Tampa-St. Petersburg-Clearwater, FL MSA",2023,5,1689593,1640739,48854,2.9
MT1248680000000,12,48680,"Wildwood-The Villages, FL MSA",2023,5,33325,31705,1620,4.9
MT1310500000000,13,10500,"Albany, GA MSA",2023,5,62577,60168,2409,3.8
MT1312020000000,13,12020,"Athens-Clarke County, GA MSA",2023,5,105728,102570,3158,3
MT1312060000000,13,12060,"Atlanta-Sandy Springs-Roswell, GA MSA",2023,5,3261935,3158460,103475,3.2
MT1312260000000,13,12260,"Augusta-Richmond County, GA-SC MSA",2023,5,266401,256552,9849,3.7
MT1315260000000,13,15260,"Brunswick-St. Simons, GA MSA",2023,5,54285,52719,1566,2.9
MT1317980000000,13,17980,"Columbus, GA-AL MSA",2023,5,129882,125163,4719,3.6
MT1319140000000,13,19140,"Dalton, GA MSA",2023,5,67084,64679,2405,3.6
MT1323580000000,13,23580,"Gainesville, GA MSA",2023,5,107244,104451,2793,2.6
MT1325980000000,13,25980,"Hinesville, GA MSA",2023,5,31111,29914,1197,3.8
MT1331420000000,13,31420,"Macon-Bibb County, GA MSA",2023,5,97289,93523,3766,3.9
MT1340660000000,13,40660,"Rome, GA MSA",2023,5,45230,43669,1561,3.5
MT1342340000000,13,42340,"Savannah, GA MSA",2023,5,206728,200648,6080,2.9
MT1346660000000,13,46660,"Valdosta, GA MSA",2023,5,61437,59239,2198,3.6
MT1347580000000,13,47580,"Warner Robins, GA MSA",2023,5,89268,86565,2703,3
MT1527980000000,15,27980,"Kahului-Wailuku, HI MSA",2023,5,83857,81531,2326,2.8
MT1546520000000,15,46520,"Urban Honolulu, HI MSA",2023,5,468359,455683,12676,2.7
MT1614260000000,16,14260,"Boise City, ID MSA",2023,5,435051,422251,12800,2.9
MT1617660000000,16,17660,"Coeur d'Alene, ID MSA",2023,5,88586,85422,3164,3.6
MT1626820000000,16,26820,"Idaho Falls, ID MSA",2023,5,83271,80986,2285,2.7
MT1630300000000,16,30300,"Lewiston, ID-WA MSA",2023,5,30513,29610,903,3
MT1638540000000,16,38540,"Pocatello, ID MSA",2023,5,39991,38664,1327,3.3
MT1646300000000,16,46300,"Twin Falls, ID MSA",2023,5,59344,57498,1846,3.1
MT1714010000000,17,14010,"Bloomington, IL MSA",2023,5,93716,90267,3449,3.7
MT1716580000000,17,16580,"Champaign-Urbana, IL MSA",2023,5,123374,118252,5122,4.2
MT1716980000000,17,16980,"Chicago-Naperville-Elgin, IL-IN MSA",2023,5,4877241,4674856,202385,4.1
MT1719340000000,17,19340,"Davenport-Moline-Rock Island, IA-IL MSA",2023,5,189668,181630,8038,4.2
MT1719500000000,17,19500,"Decatur, IL MSA",2023,5,45043,42295,2748,6.1
MT1728100000000,17,28100,"Kankakee, IL MSA",2023,5,50645,47664,2981,5.9
MT1737900000000,17,37900,"Peoria, IL MSA",2023,5,174703,166125,8578,4.9
MT1740420000000,17,40420,"Rockford, IL MSA",2023,5,159997,149820,10177,6.4
MT1744100000000,17,44100,"Springfield, IL MSA",2023,5,101854,97396,4458,4.4
MT1814020000000,18,14020,"Bloomington, IN MSA",2023,5,85517,83026,2491,2.9
MT1818020000000,18,18020,"Columbus, IN MSA",2023,5,39603,38377,1226,3.1
MT1821140000000,18,21140,"Elkhart-Goshen, IN MSA",2023,5,101495,96970,4525,4.5
MT1821780000000,18,21780,"Evansville, IN MSA",2023,5,135116,130907,4209,3.1
MT1823060000000,18,23060,"Fort Wayne, IN MSA",2023,5,229379,222461,6918,3
MT1826900000000,18,26900,"Indianapolis-Carmel-Greenwood, IN MSA",2023,5,1116169,1081869,34300,3.1
MT1829020000000,18,29020,"Kokomo, IN MSA",2023,5,35387,33690,1697,4.8
MT1829200000000,18,29200,"Lafayette-West Lafayette, IN MSA",2023,5,119932,116571,3361,2.8
MT1833140000000,18,33140,"Michigan City-La Porte, IN MSA",2023,5,51460,49512,1948,3.8
MT1834620000000,18,34620,"Muncie, IN MSA",2023,5,51766,49798,1968,3.8
MT1843780000000,18,43780,"South Bend-Mishawaka, IN-MI MSA",2023,5,155372,149046,6326,4.1
MT1845460000000,18,45460,"Terre Haute, IN MSA",2023,5,76963,74255,2708,3.5
MT1911180000000,19,11180,"Ames, IA MSA",2023,5,69352,67720,1632,2.4
MT1916300000000,19,16300,"Cedar Rapids, IA MSA",2023,5,148680,143860,4820,3.2
MT1919780000000,19,19780,"Des Moines-West Des Moines, IA MSA",2023,5,408152,396974,11178,2.7
MT1920220000000,19,20220,"Dubuque, IA MSA",2023,5,53738,52146,1592,3
MT1926980000000,19,26980,"Iowa City, IA MSA",2023,5,99201,96784,2417,2.4
MT1943580000000,19,43580,"Sioux City, IA-NE-SD MSA",2023,5,76944,74841,2103,2.7
MT1947940000000,19,47940,"Waterloo-Cedar Falls, IA MSA",2023,5,89082,86414,2668,3
MT2029940000000,20,29940,"Lawrence, KS MSA",2023,5,70070,68273,1797,2.6
MT2031740000000,20,31740,"Manhattan, KS MSA",2023,5,63446,61727,1719,2.7
MT2045820000000,20,45820,"Topeka, KS MSA",2023,5,117929,114385,3544,3
MT2048620000000,20,48620,"Wichita, KS MSA",2023,5,330566,320544,10022,3
MT2114540000000,21,14540,"Bowling Green, KY MSA",2023,5,90469,86891,3578,4
MT2121060000000,21,21060,"Elizabethtown, KY MSA",2023,5,53968,51691,2277,4.2
MT2130460000000,21,30460,"Lexington-Fayette, KY MSA",2023,5,271329,261932,9397,3.5
MT2131140000000,21,31140,"Louisville/Jefferson County, KY-IN MSA",2023,5,688708,663388,25320,3.7
MT2136980000000,21,36980,"Owensboro, KY MSA",2023,5,50920,48767,2153,4.2
MT2137140000000,21,37140,"Paducah, KY-IL MSA",2023,5,45677,43706,1971,4.3
MT2210780000000,22,10780,"Alexandria, LA MSA",2023,5,64288,62246,2042,3.2
MT2212940000000,22,12940,"Baton Rouge, LA MSA",2023,5,418759,404700,14059,3.4
MT2225220000000,22,25220,"Hammond, LA MSA",2023,5,60168,57773,2395,4
MT2226380000000,22,26380,"Houma-Bayou Cane-Thibodaux, LA MSA",2023,5,87872,85267,2605,3
MT2229180000000,22,29180,"Lafayette, LA MSA",2023,5,196123,190337,5786,3
MT2229340000000,22,29340,"Lake Charles, LA MSA",2023,5,98083,94601,3482,3.6
MT2233740000000,22,33740,"Monroe, LA MSA",2023,5,96250,92373,3877,4
MT2235380000000,22,35380,"New Orleans-Metairie, LA MSA",2023,5,467429,450057,17372,3.7
MT2243340000000,22,43340,"Shreveport-Bossier City, LA MSA",2023,5,169444,163399,6045,3.6
MT2243640000000,22,43640,"Slidell-Mandeville-Covington, LA MSA",2023,5,128080,124321,3759,2.9
MT2312620000000,23,12620,"Bangor, ME MSA",2023,5,73740,71842,1898,2.6
MT2330340000000,23,30340,"Lewiston-Auburn, ME MSA",2023,5,54491,53067,1424,2.6
MT2338860000000,23,38860,"Portland-South Portland, ME MSA",2023,5,306939,300407,6532,2.1
MT2412580000000,24,12580,"Baltimore-Columbia-Towson, MD MSA",2023,5,1467729,1440045,27684,1.9
MT2425180000000,24,25180,"Hagerstown-Martinsburg, MD-WV MSA",2023,5,142223,138438,3785,2.7
MT2430500000000,24,30500,"Lexington Park, MD MSA",2023,5,106228,104424,1804,1.7
MT2441540000000,24,41540,"Salisbury, MD MSA",2023,5,63019,61558,1461,2.3
MT2511200000000,25,11200,"Amherst Town-Northampton, MA MSA",2023,5,83083,80532,2551,3.1
MT2512700000000,25,12700,"Barnstable Town, MA MSA",2023,5,113874,108986,4888,4.3
MT2514460000000,25,14460,"Boston-Cambridge-Newton, MA-NH MSA",2023,5,2752834,2668105,84729,3.1
MT2538340000000,25,38340,"Pittsfield, MA MSA",2023,5,63374,61117,2257,3.6
MT2544140000000,25,44140,"Springfield, MA MSA",2023,5,219850,210440,9410,4.3
MT2549340000000,25,49340,"Worcester, MA MSA",2023,5,452946,437251,15695,3.5
MT2611460000000,26,11460,"Ann Arbor, MI MSA",2023,5,204909,198582,6327,3.1
MT2612980000000,26,12980,"Battle Creek, MI MSA",2023,5,62001,59379,2622,4.2
MT2613020000000,26,13020,"Bay City, MI MSA",2023,5,49767,47342,2425,4.9
MT2619820000000,26,19820,"Detroit-Warren-Dearborn, MI MSA",2023,5,2165732,2093936,71796,3.3
MT2622420000000,26,22420,"Flint, MI MSA",2023,5,186872,177967,8905,4.8
MT2624340000000,26,24340,"Grand Rapids-Wyoming-Kentwood, MI MSA",2023,5,623048,602641,20407,3.3
MT2627100000000,26,27100,"Jackson, MI MSA",2023,5,75005,72014,2991,4
MT2628020000000,26,28020,"Kalamazoo-Portage, MI MSA",2023,5,138341,133465,4876,3.5
MT2629620000000,26,29620,"Lansing-East Lansing, MI MSA",2023,5,249585,240783,8802,3.5
MT2633220000000,26,33220,"Midland, MI MSA",2023,5,42326,40769,1557,3.7
MT2633780000000,26,33780,"Monroe, MI MSA",2023,5,77425,74257,3168,4.1
MT2634740000000,26,34740,"Muskegon-Norton Shores, MI MSA",2023,5,83180,79707,3473,4.2
MT2635660000000,26,35660,"Niles, MI MSA",2023,5,75314,72285,3029,4
MT2640980000000,26,40980,"Saginaw, MI MSA",2023,5,84364,80064,4300,5.1
MT2645900000000,26,45900,"Traverse City, MI MSA",2023,5,80439,77358,3081,3.8
MT2720260000000,27,20260,"Duluth, MN-WI MSA",2023,5,140148,135139,5009,3.6
MT2731860000000,27,31860,"Mankato, MN MSA",2023,5,60133,58715,1418,2.4
MT2733460000000,27,33460,"Minneapolis-St. Paul-Bloomington, MN-WI MSA",2023,5,2069720,2013997,55723,2.7
MT2740340000000,27,40340,"Rochester, MN MSA",2023,5,125766,122678,3088,2.5
MT2741060000000,27,41060,"St. Cloud, MN MSA",2023,5,109566,106188,3378,3.1
MT2825060000000,28,25060,"Gulfport-Biloxi, MS MSA",2023,5,183446,178075,5371,2.9
MT2825620000000,28,25620,"Hattiesburg, MS MSA",2023,5,69837,67842,1995,2.9
MT2827140000000,28,27140,"Jackson, MS MSA",2023,5,277237,269521,7716,2.8
MT2916020000000,29,16020,"Cape Girardeau, MO-IL MSA",2023,5,48732,47367,1365,2.8
MT2917860000000,29,17860,"Columbia, MO MSA",2023,5,112833,109908,2925,2.6
MT2927620000000,29,27620,"Jefferson City, MO MSA",2023,5,74821,72871,1950,2.6
MT2927900000000,29,27900,"Joplin, MO-KS MSA",2023,5,96998,94168,2830,2.9
MT2928140000000,29,28140,"Kansas City, MO-KS MSA",2023,5,1180869,1146485,34384,2.9
MT2941140000000,29,41140,"St. Joseph, MO-KS MSA",2023,5,53639,51977,1662,3.1
MT2941180000000,29,41180,"St. Louis, MO-IL MSA",2023,5,1469156,1422301,46855,3.2
MT2944180000000,29,44180,"Springfield, MO MSA",2023,5,238647,232179,6468,2.7
MT3013740000000,30,13740,"Billings, MT MSA",2023,5,98926,96658,2268,2.3
MT3014580000000,30,14580,"Bozeman, MT MSA",2023,5,75746,74229,1517,2
MT3024500000000,30,24500,"Great Falls, MT MSA",2023,5,39438,38425,1013,2.6
MT3025740000000,30,25740,"Helena, MT MSA",2023,5,47045,45918,1127,2.4
MT3033540000000,30,33540,"Missoula, MT MSA",2023,5,73633,71867,1766,2.4
MT3124260000000,31,24260,"Grand Island, NE MSA",2023,5,42283,41374,909,2.1
MT3130700000000,31,30700,"Lincoln, NE MSA",2023,5,192146,188186,3960,2.1
MT3136540000000,31,36540,"Omaha, NE-IA MSA",2023,5,521490,509007,12483,2.4
MT3216180000000,32,16180,"Carson City, NV MSA",2023,5,28763,27501,1262,4.4
MT3229820000000,32,29820,"Las Vegas-Henderson-North Las Vegas, NV MSA",2023,5,1182635,1119963,62672,5.3
MT3239900000000,32,39900,"Reno, NV MSA",2023,5,296039,282987,13052,4.4
MT3331700000000,33,31700,"Manchester-Nashua, NH MSA",2023,5,238709,233399,5310,2.2
MT3412100000000,34,12100,"Atlantic City-Hammonton, NJ MSA",2023,5,180469,169934,10535,5.8
MT3445940000000,34,45940,"Trenton-Princeton, NJ MSA",2023,5,198390,190385,8005,4
MT3447220000000,34,47220,"Vineland, NJ MSA",2023,5,65922,61549,4373,6.6
MT3510740000000,35,10740,"Albuquerque, NM MSA",2023,5,456823,441638,15185,3.3
MT3522140000000,35,22140,"Farmington, NM MSA",2023,5,49479,47417,2062,4.2
MT3529740000000,35,29740,"Las Cruces, NM MSA",2023,5,100492,96132,4360,4.3
MT3542140000000,35,42140,"Santa Fe, NM MSA",2023,5,73456,71123,2333,3.2
MT3610580000000,36,10580,"Albany-Schenectady-Troy, NY MSA",2023,5,458723,445341,13382,2.9
MT3613780000000,36,13780,"Binghamton, NY MSA",2023,5,106785,103161,3624,3.4
MT3615380000000,36,15380,"Buffalo-Cheektowaga, NY MSA",2023,5,562154,543260,18894,3.4
MT3621300000000,36,21300,"Elmira, NY MSA",2023,5,35541,34314,1227,3.5
MT3624020000000,36,24020,"Glens Falls, NY MSA",2023,5,59866,57962,1904,3.2
MT3627060000000,36,27060,"Ithaca, NY MSA",2023,5,48353,46996,1357,2.8
MT3628740000000,36,28740,"Kingston, NY MSA",2023,5,87257,84528,2729,3.1
MT3628880000000,36,28880,"Kiryas Joel-Poughkeepsie-Newburgh, NY MSA",2023,5,339057,328754,10303,3
MT3635620000000,36,35620,"New York-Newark-Jersey City, NY-NJ MSA",2023,5,10102768,9677848,424920,4.2
MT3640380000000,36,40380,"Rochester, NY MSA",2023,5,516222,499833,16389,3.2
MT3645060000000,36,45060,"Syracuse, NY MSA",2023,5,311341,301179,10162,3.3
MT3646540000000,36,46540,"Utica-Rome, NY MSA",2023,5,127977,123661,4316,3.4
MT3648060000000,36,48060,"Watertown-Fort Drum, NY MSA",2023,5,45243,43459,1784,3.9
MT3711700000000,37,11700,"Asheville, NC MSA",2023,5,210999,205158,5841,2.8
MT3715500000000,37,15500,"Burlington, NC MSA",2023,5,85670,82731,2939,3.4
MT3716740000000,37,16740,"Charlotte-Concord-Gastonia, NC-SC MSA",2023,5,1469095,1421209,47886,3.3
MT3720500000000,37,20500,"Durham-Chapel Hill, NC MSA",2023,5,320434,310607,9827,3.1
MT3722180000000,37,22180,"Fayetteville, NC MSA",2023,5,154951,148110,6841,4.4
MT3724140000000,37,24140,"Goldsboro, NC MSA",2023,5,50429,48606,1823,3.6
MT3724660000000,37,24660,"Greensboro-High Point, NC MSA",2023,5,371873,357630,14243,3.8
MT3724780000000,37,24780,"Greenville, NC MSA",2023,5,83118,79813,3305,4
MT3725860000000,37,25860,"Hickory-Lenoir-Morganton, NC MSA",2023,5,172872,167196,5676,3.3
MT3727340000000,37,27340,"Jacksonville, NC MSA",2023,5,73728,71076,2652,3.6
MT3738240000000,37,38240,"Pinehurst-Southern Pines, NC MSA",2023,5,43927,42439,1488,3.4
MT3739580000000,37,39580,"Raleigh-Cary, NC MSA",2023,5,831370,806812,24558,3
MT3740580000000,37,40580,"Rocky Mount, NC MSA",2023,5,63894,60864,3030,4.7
MT3748900000000,37,48900,"Wilmington, NC MSA",2023,5,220997,213263,7734,3.5
MT3749180000000,37,49180,"Winston-Salem, NC MSA",2023,5,325739,314420,11319,3.5
MT3813900000000,38,13900,"Bismarck, ND MSA",2023,5,72397,70925,1472,2
MT3822020000000,38,22020,"Fargo, ND-MN MSA",2023,5,152019,149130,2889,1.9
MT3824220000000,38,24220,"Grand Forks, ND-MN MSA",2023,5,55152,53982,1170,2.1
MT3833500000000,38,33500,"Minot, ND MSA",2023,5,39878,39072,806,2
MT3910420000000,39,10420,"Akron, OH MSA",2023,5,357512,344835,12677,3.5
MT3915940000000,39,15940,"Canton-Massillon, OH MSA",2023,5,190409,183314,7095,3.7
MT3917140000000,39,17140,"Cincinnati, OH-KY-IN MSA",2023,5,1161017,1122813,38204,3.3
MT3917410000000,39,17410,"Cleveland, OH MSA",2023,5,1082634,1044205,38429,3.5
MT3918140000000,39,18140,"Columbus, OH MSA",2023,5,1135357,1100187,35170,3.1
MT3919430000000,39,19430,"Dayton-Kettering-Beavercreek, OH MSA",2023,5,387245,373499,13746,3.5
MT3930620000000,39,30620,"Lima, OH MSA",2023,5,47458,45642,1816,3.8
MT3931900000000,39,31900,"Mansfield, OH MSA",2023,5,52520,50355,2165,4.1
MT3941780000000,39,41780,"Sandusky, OH MSA",2023,5,56859,54125,2734,4.8
MT3944220000000,39,44220,"Springfield, OH MSA",2023,5,61807,59550,2257,3.7
MT3945780000000,39,45780,"Toledo, OH MSA",2023,5,293843,282428,11415,3.9
MT3948260000000,39,48260,"Weirton-Steubenville, WV-OH MSA",2023,5,52417,49893,2524,4.8
MT3949660000000,39,49660,"Youngstown-Warren, OH MSA",2023,5,189141,181465,7676,4.1
MT4021420000000,40,21420,"Enid, OK MSA",2023,5,28253,27452,801,2.8
MT4030020000000,40,30020,"Lawton, OK MSA",2023,5,51531,49663,1868,3.6
MT4036420000000,40,36420,"Oklahoma City, OK MSA",2023,5,756272,734960,21312,2.8
MT4046140000000,40,46140,"Tulsa, OK MSA",2023,5,513764,498158,15606,3
MT4110540000000,41,10540,"Albany, OR MSA",2023,5,61289,58915,2374,3.9
MT4113460000000,41,13460,"Bend, OR MSA",2023,5,129827,124979,4848,3.7
MT4118700000000,41,18700,"Corvallis, OR MSA",2023,5,49161,47763,1398,2.8
MT4121660000000,41,21660,"Eugene-Springfield, OR MSA",2023,5,185991,179203,6788,3.6
MT4124420000000,41,24420,"Grants Pass, OR MSA",2023,5,34705,33002,1703,4.9
MT4132780000000,41,32780,"Medford, OR MSA",2023,5,104084,99716,4368,4.2
MT4138900000000,41,38900,"Portland-Vancouver-Hillsboro, OR-WA MSA",2023,5,1372517,1327707,44810,3.3
MT4141420000000,41,41420,"Salem, OR MSA",2023,5,216151,208583,7568,3.5
MT4210900000000,42,10900,"Allentown-Bethlehem-Easton, PA-NJ MSA",2023,5,447778,430603,17175,3.8
MT4211020000000,42,11020,"Altoona, PA MSA",2023,5,57171,55112,2059,3.6
MT4216540000000,42,16540,"Chambersburg, PA MSA",2023,5,76448,74108,2340,3.1
MT4221500000000,42,21500,"Erie, PA MSA",2023,5,126869,121767,5102,4
MT4223900000000,42,23900,"Gettysburg, PA MSA",2023,5,52273,50721,1552,3
MT4225420000000,42,25420,"Harrisburg-Carlisle, PA MSA",2023,5,310456,300861,9595,3.1
MT4227780000000,42,27780,"Johnstown, PA MSA",2023,5,56974,54550,2424,4.3
MT4229540000000,42,29540,"Lancaster, PA MSA",2023,5,290988,282630,8358,2.9
MT4230140000000,42,30140,"Lebanon, PA MSA",2023,5,72976,70728,2248,3.1
MT4237980000000,42,37980,"Philadelphia-Camden-Wilmington, PA-NJ-DE-MD MSA",2023,5,3275695,3156787,118908,3.6
MT4238300000000,42,38300,"Pittsburgh, PA MSA",2023,5,1228554,1183700,44854,3.7
MT4239740000000,42,39740,"Reading, PA MSA",2023,5,218071,210166,7905,3.6
MT4242540000000,42,42540,"Scranton--Wilkes-Barre, PA MSA",2023,5,278457,266206,12251,4.4
MT4244300000000,42,44300,"State College, PA MSA",2023,5,77524,75330,2194,2.8
MT4248700000000,42,48700,"Williamsport, PA MSA",2023,5,52826,50757,2069,3.9
MT4249620000000,42,49620,"York-Hanover, PA MSA",2023,5,238541,231007,7534,3.2
MT4439300000000,44,39300,"Providence-Warwick, RI-MA MSA",2023,5,876475,848345,28130,3.2
MT4516700000000,45,16700,"Charleston-North Charleston, SC MSA",2023,5,428225,417928,10297,2.4
MT4517900000000,45,17900,"Columbia, SC MSA",2023,5,409008,397916,11092,2.7
MT4522500000000,45,22500,"Florence, SC MSA",2023,5,91134,88297,2837,3.1
MT4524860000000,45,24860,"Greenville-Anderson-Greer, SC MSA",2023,5,467114,455017,12097,2.6
MT4525940000000,45,25940,"Hilton Head Island-Bluffton-Port Royal, SC MSA",2023,5,96110,93690,2420,2.5
MT4534820000000,45,34820,"Myrtle Beach-Conway-North Myrtle Beach, SC MSA",2023,5,165221,159709,5512,3.3
MT4543900000000,45,43900,"Spartanburg, SC MSA",2023,5,171835,166769,5066,2.9
MT4544940000000,45,44940,"Sumter, SC MSA",2023,5,41064,39593,1471,3.6
MT4639660000000,46,39660,"Rapid City, SD MSA",2023,5,78417,77029,1388,1.8
MT4643620000000,46,43620,"Sioux Falls, SD-MN MSA",2023,5,171073,168227,2846,1.7
MT4716860000000,47,16860,"Chattanooga, TN-GA MSA",2023,5,285251,276515,8736,3.1
MT4717300000000,47,17300,"Clarksville, TN-KY MSA",2023,5,135526,130465,5061,3.7
MT4717420000000,47,17420,"Cleveland, TN MSA",2023,5,56779,54799,1980,3.5
MT4727180000000,47,27180,"Jackson, TN MSA",2023,5,77800,75097,2703,3.5
MT4727740000000,47,27740,"Johnson City, TN MSA",2023,5,96005,92851,3154,3.3
MT4728700000000,47,28700,"Kingsport-Bristol, TN-VA MSA",2023,5,132101,127707,4394,3.3
MT4728940000000,47,28940,"Knoxville, TN MSA",2023,5,444656,431440,13216,3
MT4732820000000,47,32820,"Memphis, TN-MS-AR MSA",2023,5,623263,599852,23411,3.8
MT4734100000000,47,34100,"Morristown, TN MSA",2023,5,52646,50816,1830,3.5
MT4734980000000,47,34980,"Nashville-Davidson--Murfreesboro--Franklin, TN MSA",2023,5,1140992,1111555,29437,2.6
MT4810180000000,48,10180,"Abilene, TX MSA",2023,5,84410,81466,2944,3.5
MT4811100000000,48,11100,"Amarillo, TX MSA",2023,5,134106,129808,4298,3.2
MT4812420000000,48,12420,"Austin-Round Rock-San Marcos, TX MSA",2023,5,1452804,1402287,50517,3.5
MT4813140000000,48,13140,"Beaumont-Port Arthur, TX MSA",2023,5,174415,164413,10002,5.7
MT4815180000000,48,15180,"Brownsville-Harlingen, TX MSA",2023,5,184743,174757,9986,5.4
MT4817780000000,48,17780,"College Station-Bryan, TX MSA",2023,5,145443,140409,5034,3.5
MT4818580000000,48,18580,"Corpus Christi, TX MSA",2023,5,206087,197159,8928,4.3
MT4819100000000,48,19100,"Dallas-Fort Worth-Arlington, TX MSA",2023,5,4371376,4206071,165305,3.8
MT4820580000000,48,20580,"Eagle Pass, TX MSA",2023,5,23742,21942,1800,7.6
MT4821340000000,48,21340,"El Paso, TX MSA",2023,5,398742,381757,16985,4.3
MT4826420000000,48,26420,"Houston-Pasadena-The Woodlands, TX MSA",2023,5,3725034,3566960,158074,4.2
MT4828660000000,48,28660,"Killeen-Temple, TX MSA",2023,5,196845,188262,8583,4.4
MT4829700000000,48,29700,"Laredo, TX MSA",2023,5,115147,110453,4694,4.1
MT4830980000000,48,30980,"Longview, TX MSA",2023,5,128600,123103,5497,4.3
MT4831180000000,48,31180,"Lubbock, TX MSA",2023,5,179021,172863,6158,3.4
MT4832580000000,48,32580,"McAllen-Edinburg-Mission, TX MSA",2023,5,386202,362590,23612,6.1
MT4833260000000,48,33260,"Midland, TX MSA",2023,5,99152,96321,2831,2.9
MT4836220000000,48,36220,"Odessa, TX MSA",2023,5,83107,80323,2784,3.3
MT4841660000000,48,41660,"San Angelo, TX MSA",2023,5,60484,58458,2026,3.3
MT4841700000000,48,41700,"San Antonio-New Braunfels, TX MSA",2023,5,1296819,1247823,48996,3.8
MT4843300000000,48,43300,"Sherman-Denison, TX MSA",2023,5,69301,66651,2650,3.8
MT4845500000000,48,45500,"Texarkana, TX-AR MSA",2023,5,60797,58342,2455,4
MT4846340000000,48,46340,"Tyler, TX MSA",2023,5,115432,111079,4353,3.8
MT4847020000000,48,47020,"Victoria, TX MSA",2023,5,44735,42943,1792,4
MT4847380000000,48,47380,"Waco, TX MSA",2023,5,142819,137308,5511,3.9
MT4848660000000,48,48660,"Wichita Falls, TX MSA",2023,5,66415,63931,2484,3.7
MT4930860000000,49,30860,"Logan, UT-ID MSA",2023,5,79127,77312,1815,2.3
MT4936260000000,49,36260,"Ogden, UT MSA",2023,5,345297,336879,8418,2.4
MT4939340000000,49,39340,"Provo-Orem-Lehi, UT MSA",2023,5,362066,352836,9230,2.5
MT4941100000000,49,41100,"St. George, UT MSA",2023,5,90193,87650,2543,2.8
MT4941620000000,49,41620,"Salt Lake City-Murray, UT MSA",2023,5,723607,704670,18937,2.6
MT5015540000000,50,15540,"Burlington-South Burlington, VT MSA",2023,5,129556,127526,2030,1.6
MT5113980000000,51,13980,"Blacksburg-Christiansburg-Radford, VA MSA",2023,5,92689,90206,2483,2.7
MT5116820000000,51,16820,"Charlottesville, VA MSA",2023,5,118090,115266,2824,2.4
MT5125500000000,51,25500,"Harrisonburg, VA MSA",2023,5,72598,70795,1803,2.5
MT5131340000000,51,31340,"Lynchburg, VA MSA",2023,5,128415,124570,3845,3
MT5140060000000,51,40060,"Richmond, VA MSA",2023,5,722809,703033,19776,2.7
MT5140220000000,51,40220,"Roanoke, VA MSA",2023,5,157310,153087,4223,2.7
MT5144420000000,51,44420,"Staunton-Stuarts Draft, VA MSA",2023,5,65581,64031,1550,2.4
MT5147260000000,51,47260,"Virginia Beach-Chesapeake-Norfolk, VA-NC MSA",2023,5,878129,853011,25118,2.9
MT5149020000000,51,49020,"Winchester, VA-WV MSA",2023,5,76853,74907,1946,2.5
MT5313380000000,53,13380,"Bellingham, WA MSA",2023,5,113678,109652,4026,3.5
MT5314740000000,53,14740,"Bremerton-Silverdale-Port Orchard, WA MSA",2023,5,121079,116781,4298,3.5
MT5328420000000,53,28420,"Kennewick-Richland, WA MSA",2023,5,143551,137284,6267,4.4
MT5331020000000,53,31020,"Longview-Kelso, WA MSA",2023,5,47132,45092,2040,4.3
MT5334580000000,53,34580,"Mount Vernon-Anacortes, WA MSA",2023,5,57753,55426,2327,4
MT5336500000000,53,36500,"Olympia-Lacey-Tumwater, WA MSA",2023,5,140695,135638,5057,3.6
MT5342660000000,53,42660,"Seattle-Tacoma-Bellevue, WA MSA",2023,5,2310620,2219762,90858,3.9
MT5344060000000,53,44060,"Spokane-Spokane Valley, WA MSA",2023,5,279153,268873,10280,3.7
MT5347460000000,53,47460,"Walla Walla, WA MSA",2023,5,29312,28270,1042,3.6
MT5348300000000,53,48300,"Wenatchee-East Wenatchee, WA MSA",2023,5,61325,58863,2462,4
MT5349420000000,53,49420,"Yakima, WA MSA",2023,5,125904,119658,6246,5
MT5413220000000,54,13220,"Beckley, WV MSA",2023,5,45901,44156,1745,3.8
MT5416620000000,54,16620,"Charleston, WV MSA",2023,5,90932,87685,3247,3.6
MT5426580000000,54,26580,"Huntington-Ashland, WV-KY-OH MSA",2023,5,155365,148588,6777,4.4
MT5434060000000,54,34060,"Morgantown, WV MSA",2023,5,71324,69044,2280,3.2
MT5437620000000,54,37620,"Parkersburg-Vienna, WV MSA",2023,5,39263,37726,1537,3.9
MT5448540000000,54,48540,"Wheeling, WV-OH MSA",2023,5,59728,57207,2521,4.2
MT5511540000000,55,11540,"Appleton, WI MSA",2023,5,136367,133284,3083,2.3
MT5520740000000,55,20740,"Eau Claire, WI MSA",2023,5,95296,92685,2611,2.7
MT5522540000000,55,22540,"Fond du Lac, WI MSA",2023,5,56100,54740,1360,2.4
MT5524580000000,55,24580,"Green Bay, WI MSA",2023,5,177701,173351,4350,2.4
MT5527500000000,55,27500,"Janesville-Beloit, WI MSA",2023,5,86188,83394,2794,3.2
MT5528450000000,55,28450,"Kenosha, WI MSA",2023,5,94220,91393,2827,3
MT5529100000000,55,29100,"La Crosse-Onalaska, WI-MN MSA",2023,5,90088,87907,2181,2.4
MT5531540000000,55,31540,"Madison, WI MSA",2023,5,403281,394667,8614,2.1
MT5533340000000,55,33340,"Milwaukee-Waukesha, WI MSA",2023,5,812969,789100,23869,2.9
MT5536780000000,55,36780,"Oshkosh-Neenah, WI MSA",2023,5,92158,89970,2188,2.4
MT5539540000000,55,39540,"Racine-Mount Pleasant, WI MSA",2023,5,100663,97434,3229,3.2
MT5543100000000,55,43100,"Sheboygan, WI MSA",2023,5,62881,61502,1379,2.2
MT5548140000000,55,48140,"Wausau, WI MSA",2023,5,74815,72977,1838,2.5
MT5616220000000,56,16220,"Casper, WY MSA",2023,5,42139,40906,1233,2.9
MT5616940000000,56,16940,"Cheyenne, WY MSA",2023,5,48754,47306,1448,3
MT7210380000000,72,10380,"Aguadilla, PR MSA",2023,5,87250,80478,6772,7.8
MT7211640000000,72,11640,"Arecibo, PR MSA",2023,5,65243,60956,4287,6.6
MT7225020000000,72,25020,"Guayama, PR MSA",2023,5,18600,16813,1787,9.6
MT7232420000000,72,32420,"Mayaguez, PR MSA",2023,5,64631,59591,5040,7.8
MT7238660000000,72,38660,"Ponce, PR MSA",2023,5,87166,79014,8152,9.4
MT7241980000000,72,41980,"San Juan-Bayamon-Caguas, PR MSA",2023,5,790231,749923,40308,5.1
MT0111500000000,1,11500,"Anniston-Oxford, AL MSA",2023,6,49271,48039,1232,2.5
MT0112220000000,1,12220,"Auburn-Opelika, AL MSA",2023,6,94318,92203,2115,2.2
MT0113820000000,1,13820,"Birmingham, AL MSA",2023,6,563006,550761,12245,2.2
MT0119300000000,1,19300,"Daphne-Fairhope-Foley, AL MSA",2023,6,112484,110064,2420,2.2
MT0119460000000,1,19460,"Decatur, AL MSA",2023,6,73753,72250,1503,2
MT0120020000000,1,20020,"Dothan, AL MSA",2023,6,67001,65395,1606,2.4
MT0122520000000,1,22520,"Florence-Muscle Shoals, AL MSA",2023,6,68356,66618,1738,2.5
MT0123460000000,1,23460,"Gadsden, AL MSA",2023,6,41225,40217,1008,2.4
MT0126620000000,1,26620,"Huntsville, AL MSA",2023,6,267677,262505,5172,1.9
MT0133660000000,1,33660,"Mobile, AL MSA",2023,6,182592,177377,5215,2.9
MT0133860000000,1,33860,"Montgomery, AL MSA",2023,6,173655,169344,4311,2.5
MT0146220000000,1,46220,"Tuscaloosa, AL MSA",2023,6,124525,121413,3112,2.5
MT0211260000000,2,11260,"Anchorage, AK MSA",2023,6,199368,191804,7564,3.8
MT0221820000000,2,21820,"Fairbanks-College, AK MSA",2023,6,44968,43294,1674,3.7
MT0422380000000,4,22380,"Flagstaff, AZ MSA",2023,6,73888,70885,3003,4.1
MT0429420000000,4,29420,"Lake Havasu City-Kingman, AZ MSA",2023,6,86400,82462,3938,4.6
MT0438060000000,4,38060,"Phoenix-Mesa-Chandler, AZ MSA",2023,6,2666742,2577979,88763,3.3
MT0439150000000,4,39150,"Prescott Valley-Prescott, AZ MSA",2023,6,105605,101649,3956,3.7
MT0443420000000,4,43420,"Sierra Vista-Douglas, AZ MSA",2023,6,47967,45854,2113,4.4
MT0446060000000,4,46060,"Tucson, AZ MSA",2023,6,494753,476551,18202,3.7
MT0449740000000,4,49740,"Yuma, AZ MSA",2023,6,98234,86446,11788,12
MT0522220000000,5,22220,"Fayetteville-Springdale-Rogers, AR MSA",2023,6,297065,289947,7118,2.4
MT0522900000000,5,22900,"Fort Smith, AR-OK MSA",2023,6,101062,97781,3281,3.2
MT0526300000000,5,26300,"Hot Springs, AR MSA",2023,6,43685,42228,1457,3.3
MT0527860000000,5,27860,"Jonesboro, AR MSA",2023,6,65017,63235,1782,2.7
MT0530780000000,5,30780,"Little Rock-North Little Rock-Conway, AR MSA",2023,6,370763,360343,10420,2.8
MT0612540000000,6,12540,"Bakersfield-Delano, CA MSA",2023,6,400531,368057,32474,8.1
MT0617020000000,6,17020,"Chico, CA MSA",2023,6,90561,85937,4624,5.1
MT0620940000000,6,20940,"El Centro, CA MSA",2023,6,71373,59128,12245,17.2
MT0623420000000,6,23420,"Fresno, CA MSA",2023,6,527268,488139,39129,7.4
MT0625260000000,6,25260,"Hanford-Corcoran, CA MSA",2023,6,56641,51841,4800,8.5
MT0631080000000,6,31080,"Los Angeles-Long Beach-Anaheim, CA MSA",2023,6,6660143,6355865,304278,4.6
MT0632900000000,6,32900,"Merced, CA MSA",2023,6,119139,108419,10720,9
MT0633700000000,6,33700,"Modesto, CA MSA",2023,6,249438,233917,15521,6.2
MT0634900000000,6,34900,"Napa, CA MSA",2023,6,73141,70654,2487,3.4
MT0637100000000,6,37100,"Oxnard-Thousand Oaks-Ventura, CA MSA",2023,6,417496,400520,16976,4.1
MT0639820000000,6,39820,"Redding, CA MSA",2023,6,78067,74328,3739,4.8
MT0640140000000,6,40140,"Riverside-San Bernardino-Ontario, CA MSA",2023,6,2176554,2076788,99766,4.6
MT0640900000000,6,40900,"Sacramento-Roseville-Folsom, CA MSA",2023,6,1160972,1113165,47807,4.1
MT0641500000000,6,41500,"Salinas, CA MSA",2023,6,216516,201265,15251,7
MT0641740000000,6,41740,"San Diego-Chula Vista-Carlsbad, CA MSA",2023,6,1636135,1577283,58852,3.6
MT0641860000000,6,41860,"San Francisco-Oakland-Fremont, CA MSA",2023,6,2513191,2424923,88268,3.5
MT0641940000000,6,41940,"San Jose-Sunnyvale-Santa Clara, CA MSA",2023,6,1055543,1018065,37478,3.6
MT0642020000000,6,42020,"San Luis Obispo-Paso Robles, CA MSA",2023,6,132672,128034,4638,3.5
MT0642100000000,6,42100,"Santa Cruz-Watsonville, CA MSA",2023,6,135058,127627,7431,5.5
MT0642200000000,6,42200,"Santa Maria-Santa Barbara, CA MSA",2023,6,220844,212048,8796,4
MT0642220000000,6,42220,"Santa Rosa-Petaluma, CA MSA",2023,6,246780,238042,8738,3.5
MT0644700000000,6,44700,"Stockton-Lodi, CA MSA",2023,6,363502,341954,21548,5.9
MT0646700000000,6,46700,"Vallejo, CA MSA",2023,6,213287,204181,9106,4.3
MT0647300000000,6,47300,"Visalia, CA MSA",2023,6,216609,195485,21124,9.8
MT0649700000000,6,49700,"Yuba City, CA MSA",2023,6,79624,73885,5739,7.2
MT0814500000000,8,14500,"Boulder, CO MSA",2023,6,193542,187416,6126,3.2
MT0817820000000,8,17820,"Colorado Springs, CO MSA",2023,6,388872,375942,12930,3.3
MT0819740000000,8,19740,"Denver-Aurora-Centennial, CO MSA",2023,6,1762583,1706000,56583,3.2
MT0822660000000,8,22660,"Fort Collins-Loveland, CO MSA",2023,6,205498,199122,6376,3.1
MT0824300000000,8,24300,"Grand Junction, CO MSA",2023,6,78452,75669,2783,3.5
MT0824540000000,8,24540,"Greeley, CO MSA",2023,6,174387,168434,5953,3.4
MT0839380000000,8,39380,"Pueblo, CO MSA",2023,6,73648,70271,3377,4.6
MT0914860000000,9,14860,"Bridgeport-Stamford-Danbury, CT MSA",2023,6,507681,492605,15076,3
MT0925540000000,9,25540,"Hartford-West Hartford-East Hartford, CT MSA",2023,6,605755,587547,18208,3
MT0935300000000,9,35300,"New Haven, CT MSA",2023,6,308584,299269,9315,3
MT0935980000000,9,35980,"Norwich-New London-Willimantic, CT MSA",2023,6,139861,135548,4313,3.1
MT0947930000000,9,47930,"Waterbury-Shelton, CT MSA",2023,6,237385,229068,8317,3.5
MT1020100000000,10,20100,"Dover, DE MSA",2023,6,85528,82021,3507,4.1
MT1147900000000,11,47900,"Washington-Arlington-Alexandria, DC-VA-MD-WV MSA",2023,6,3514395,3430683,83712,2.4
MT1215980000000,12,15980,"Cape Coral-Fort Myers, FL MSA",2023,6,371065,359202,11863,3.2
MT1218880000000,12,18880,"Crestview-Fort Walton Beach-Destin, FL MSA",2023,6,141930,138185,3745,2.6
MT1219660000000,12,19660,"Deltona-Daytona Beach-Ormond Beach, FL MSA",2023,6,317821,306997,10824,3.4
MT1223540000000,12,23540,"Gainesville, FL MSA",2023,6,169450,163973,5477,3.2
MT1226140000000,12,26140,"Homosassa Springs, FL MSA",2023,6,53610,51297,2313,4.3
MT1227260000000,12,27260,"Jacksonville, FL MSA",2023,6,847472,821503,25969,3.1
MT1229460000000,12,29460,"Lakeland-Winter Haven, FL MSA",2023,6,355311,342301,13010,3.7
MT1233100000000,12,33100,"Miami-Fort Lauderdale-West Palm Beach, FL MSA",2023,6,3265573,3186009,79564,2.4
MT1234940000000,12,34940,"Naples-Marco Island, FL MSA",2023,6,181536,176147,5389,3
MT1235840000000,12,35840,"North Port-Bradenton-Sarasota, FL MSA",2023,6,391777,379830,11947,3
MT1236100000000,12,36100,"Ocala, FL MSA",2023,6,155974,150212,5762,3.7
MT1236740000000,12,36740,"Orlando-Kissimmee-Sanford, FL MSA",2023,6,1515171,1471455,43716,2.9
MT1237340000000,12,37340,"Palm Bay-Melbourne-Titusville, FL MSA",2023,6,303356,294182,9174,3
MT1237460000000,12,37460,"Panama City-Panama City Beach, FL MSA",2023,6,100140,97216,2924,2.9
MT1237860000000,12,37860,"Pensacola-Ferry Pass-Brent, FL MSA",2023,6,239955,232749,7206,3
MT1238940000000,12,38940,"Port St. Lucie, FL MSA",2023,6,238134,230184,7950,3.3
MT1239460000000,12,39460,"Punta Gorda, FL MSA",2023,6,75001,72287,2714,3.6
MT1242680000000,12,42680,"Sebastian-Vero Beach-West Vero Corridor, FL MSA",2023,6,67837,65449,2388,3.5
MT1242700000000,12,42700,"Sebring, FL MSA",2023,6,36644,35076,1568,4.3
MT1245220000000,12,45220,"Tallahassee, FL MSA",2023,6,204211,197954,6257,3.1
MT1245300000000,12,45300,"Tampa-St. Petersburg-Clearwater, FL MSA",2023,6,1692525,1642620,49905,2.9
MT1248680000000,12,48680,"Wildwood-The Villages, FL MSA",2023,6,33441,31801,1640,4.9
MT1310500000000,13,10500,"Albany, GA MSA",2023,6,62485,60097,2388,3.8
MT1312020000000,13,12020,"Athens-Clarke County, GA MSA",2023,6,106143,102982,3161,3
MT1312060000000,13,12060,"Atlanta-Sandy Springs-Roswell, GA MSA",2023,6,3266547,3162772,103775,3.2
MT1312260000000,13,12260,"Augusta-Richmond County, GA-SC MSA",2023,6,266308,256502,9806,3.7
MT1315260000000,13,15260,"Brunswick-St. Simons, GA MSA",2023,6,54527,52957,1570,2.9
MT1317980000000,13,17980,"Columbus, GA-AL MSA",2023,6,129937,125242,4695,3.6
MT1319140000000,13,19140,"Dalton, GA MSA",2023,6,67154,64769,2385,3.6
MT1323580000000,13,23580,"Gainesville, GA MSA",2023,6,107590,104784,2806,2.6
MT1325980000000,13,25980,"Hinesville, GA MSA",2023,6,31110,29918,1192,3.8
MT1331420000000,13,31420,"Macon-Bibb County, GA MSA",2023,6,97247,93497,3750,3.9
MT1340660000000,13,40660,"Rome, GA MSA",2023,6,45166,43610,1556,3.4
MT1342340000000,13,42340,"Savannah, GA MSA",2023,6,206843,200780,6063,2.9
MT1346660000000,13,46660,"Valdosta, GA MSA",2023,6,61553,59349,2204,3.6
MT1347580000000,13,47580,"Warner Robins, GA MSA",2023,6,89420,86724,2696,3
MT1527980000000,15,27980,"Kahului-Wailuku, HI MSA",2023,6,83517,81269,2248,2.7
MT1546520000000,15,46520,"Urban Honolulu, HI MSA",2023,6,468393,455994,12399,2.6
MT1614260000000,16,14260,"Boise City, ID MSA",2023,6,435971,422809,13162,3
MT1617660000000,16,17660,"Coeur d'Alene, ID MSA",2023,6,88834,85589,3245,3.7
MT1626820000000,16,26820,"Idaho Falls, ID MSA",2023,6,83429,81111,2318,2.8
MT1630300000000,16,30300,"Lewiston, ID-WA MSA",2023,6,30603,29660,943,3.1
MT1638540000000,16,38540,"Pocatello, ID MSA",2023,6,40013,38632,1381,3.5
MT1646300000000,16,46300,"Twin Falls, ID MSA",2023,6,59397,57519,1878,3.2
MT1714010000000,17,14010,"Bloomington, IL MSA",2023,6,94219,90675,3544,3.8
MT1716580000000,17,16580,"Champaign-Urbana, IL MSA",2023,6,123998,118729,5269,4.2
MT1716980000000,17,16980,"Chicago-Naperville-Elgin, IL-IN MSA",2023,6,4883968,4675833,208135,4.3
MT1719340000000,17,19340,"Davenport-Moline-Rock Island, IA-IL MSA",2023,6,189690,181398,8292,4.4
MT1719500000000,17,19500,"Decatur, IL MSA",2023,6,44904,42117,2787,6.2
MT1728100000000,17,28100,"Kankakee, IL MSA",2023,6,50803,47755,3048,6
MT1737900000000,17,37900,"Peoria, IL MSA",2023,6,175155,166418,8737,5
MT1740420000000,17,40420,"Rockford, IL MSA",2023,6,160526,150161,10365,6.5
MT1744100000000,17,44100,"Springfield, IL MSA",2023,6,101586,97021,4565,4.5
MT1814020000000,18,14020,"Bloomington, IN MSA",2023,6,85330,82805,2525,3
MT1818020000000,18,18020,"Columbus, IN MSA",2023,6,39543,38298,1245,3.1
MT1821140000000,18,21140,"Elkhart-Goshen, IN MSA",2023,6,100854,96227,4627,4.6
MT1821780000000,18,21780,"Evansville, IN MSA",2023,6,134998,130738,4260,3.2
MT1823060000000,18,23060,"Fort Wayne, IN MSA",2023,6,229529,222477,7052,3.1
MT1826900000000,18,26900,"Indianapolis-Carmel-Greenwood, IN MSA",2023,6,1116482,1081799,34683,3.1
MT1829020000000,18,29020,"Kokomo, IN MSA",2023,6,35354,33680,1674,4.7
MT1829200000000,18,29200,"Lafayette-West Lafayette, IN MSA",2023,6,119914,116524,3390,2.8
MT1833140000000,18,33140,"Michigan City-La Porte, IN MSA",2023,6,51384,49421,1963,3.8
MT1834620000000,18,34620,"Muncie, IN MSA",2023,6,51748,49739,2009,3.9
MT1843780000000,18,43780,"South Bend-Mishawaka, IN-MI MSA",2023,6,155190,148762,6428,4.1
MT1845460000000,18,45460,"Terre Haute, IN MSA",2023,6,76938,74206,2732,3.6
MT1911180000000,19,11180,"Ames, IA MSA",2023,6,69385,67743,1642,2.4
MT1916300000000,19,16300,"Cedar Rapids, IA MSA",2023,6,148356,143520,4836,3.3
MT1919780000000,19,19780,"Des Moines-West Des Moines, IA MSA",2023,6,408445,397294,11151,2.7
MT1920220000000,19,20220,"Dubuque, IA MSA",2023,6,53623,52018,1605,3
MT1926980000000,19,26980,"Iowa City, IA MSA",2023,6,99268,96819,2449,2.5
MT1943580000000,19,43580,"Sioux City, IA-NE-SD MSA",2023,6,76979,74836,2143,2.8
MT1947940000000,19,47940,"Waterloo-Cedar Falls, IA MSA",2023,6,89134,86474,2660,3
MT2029940000000,20,29940,"Lawrence, KS MSA",2023,6,70132,68346,1786,2.5
MT2031740000000,20,31740,"Manhattan, KS MSA",2023,6,63387,61685,1702,2.7
MT2045820000000,20,45820,"Topeka, KS MSA",2023,6,117990,114456,3534,3
MT2048620000000,20,48620,"Wichita, KS MSA",2023,6,330906,320851,10055,3
MT2114540000000,21,14540,"Bowling Green, KY MSA",2023,6,90491,86867,3624,4
MT2121060000000,21,21060,"Elizabethtown, KY MSA",2023,6,54051,51743,2308,4.3
MT2130460000000,21,30460,"Lexington-Fayette, KY MSA",2023,6,271681,262079,9602,3.5
MT2131140000000,21,31140,"Louisville/Jefferson County, KY-IN MSA",2023,6,688429,663090,25339,3.7
MT2136980000000,21,36980,"Owensboro, KY MSA",2023,6,50845,48669,2176,4.3
MT2137140000000,21,37140,"Paducah, KY-IL MSA",2023,6,45684,43656,2028,4.4
MT2210780000000,22,10780,"Alexandria, LA MSA",2023,6,64236,62229,2007,3.1
MT2212940000000,22,12940,"Baton Rouge, LA MSA",2023,6,418744,404815,13929,3.3
MT2225220000000,22,25220,"Hammond, LA MSA",2023,6,60082,57707,2375,4
MT2226380000000,22,26380,"Houma-Bayou Cane-Thibodaux, LA MSA",2023,6,88037,85456,2581,2.9
MT2229180000000,22,29180,"Lafayette, LA MSA",2023,6,195947,190177,5770,2.9
MT2229340000000,22,29340,"Lake Charles, LA MSA",2023,6,97750,94310,3440,3.5
MT2233740000000,22,33740,"Monroe, LA MSA",2023,6,96110,92251,3859,4
MT2235380000000,22,35380,"New Orleans-Metairie, LA MSA",2023,6,466816,449557,17259,3.7
MT2243340000000,22,43340,"Shreveport-Bossier City, LA MSA",2023,6,169046,163041,6005,3.6
MT2243640000000,22,43640,"Slidell-Mandeville-Covington, LA MSA",2023,6,128008,124235,3773,2.9
MT2312620000000,23,12620,"Bangor, ME MSA",2023,6,74061,72066,1995,2.7
MT2330340000000,23,30340,"Lewiston-Auburn, ME MSA",2023,6,54698,53249,1449,2.6
MT2338860000000,23,38860,"Portland-South Portland, ME MSA",2023,6,307802,301029,6773,2.2
MT2412580000000,24,12580,"Baltimore-Columbia-Towson, MD MSA",2023,6,1470357,1442433,27924,1.9
MT2425180000000,24,25180,"Hagerstown-Martinsburg, MD-WV MSA",2023,6,142452,138543,3909,2.7
MT2430500000000,24,30500,"Lexington Park, MD MSA",2023,6,106466,104653,1813,1.7
MT2441540000000,24,41540,"Salisbury, MD MSA",2023,6,63307,61828,1479,2.3
MT2511200000000,25,11200,"Amherst Town-Northampton, MA MSA",2023,6,83149,80599,2550,3.1
MT2512700000000,25,12700,"Barnstable Town, MA MSA",2023,6,114032,109141,4891,4.3
MT2514460000000,25,14460,"Boston-Cambridge-Newton, MA-NH MSA",2023,6,2755679,2670979,84700,3.1
MT2538340000000,25,38340,"Pittsfield, MA MSA",2023,6,63397,61144,2253,3.6
MT2544140000000,25,44140,"Springfield, MA MSA",2023,6,219895,210545,9350,4.3
MT2549340000000,25,49340,"Worcester, MA MSA",2023,6,453756,438245,15511,3.4
MT2611460000000,26,11460,"Ann Arbor, MI MSA",2023,6,205651,199332,6319,3.1
MT2612980000000,26,12980,"Battle Creek, MI MSA",2023,6,62099,59491,2608,4.2
MT2613020000000,26,13020,"Bay City, MI MSA",2023,6,49898,47486,2412,4.8
MT2619820000000,26,19820,"Detroit-Warren-Dearborn, MI MSA",2023,6,2174005,2099606,74399,3.4
MT2622420000000,26,22420,"Flint, MI MSA",2023,6,187099,178282,8817,4.7
MT2624340000000,26,24340,"Grand Rapids-Wyoming-Kentwood, MI MSA",2023,6,624678,604065,20613,3.3
MT2627100000000,26,27100,"Jackson, MI MSA",2023,6,75142,72155,2987,4
MT2628020000000,26,28020,"Kalamazoo-Portage, MI MSA",2023,6,138592,133709,4883,3.5
MT2629620000000,26,29620,"Lansing-East Lansing, MI MSA",2023,6,250546,241816,8730,3.5
MT2633220000000,26,33220,"Midland, MI MSA",2023,6,42390,40840,1550,3.7
MT2633780000000,26,33780,"Monroe, MI MSA",2023,6,77821,74696,3125,4
MT2634740000000,26,34740,"Muskegon-Norton Shores, MI MSA",2023,6,83457,79985,3472,4.2
MT2635660000000,26,35660,"Niles, MI MSA",2023,6,75565,72531,3034,4
MT2640980000000,26,40980,"Saginaw, MI MSA",2023,6,84592,80353,4239,5
MT2645900000000,26,45900,"Traverse City, MI MSA",2023,6,80637,77533,3104,3.8
MT2720260000000,27,20260,"Duluth, MN-WI MSA",2023,6,140252,135266,4986,3.6
MT2731860000000,27,31860,"Mankato, MN MSA",2023,6,60213,58805,1408,2.3
MT2733460000000,27,33460,"Minneapolis-St. Paul-Bloomington, MN-WI MSA",2023,6,2070568,2014782,55786,2.7
MT2740340000000,27,40340,"Rochester, MN MSA",2023,6,125811,122719,3092,2.5
MT2741060000000,27,41060,"St. Cloud, MN MSA",2023,6,109589,106202,3387,3.1
MT2825060000000,28,25060,"Gulfport-Biloxi, MS MSA",2023,6,183762,178365,5397,2.9
MT2825620000000,28,25620,"Hattiesburg, MS MSA",2023,6,69849,67873,1976,2.8
MT2827140000000,28,27140,"Jackson, MS MSA",2023,6,277235,269519,7716,2.8
MT2916020000000,29,16020,"Cape Girardeau, MO-IL MSA",2023,6,48775,47368,1407,2.9
MT2917860000000,29,17860,"Columbia, MO MSA",2023,6,112486,109493,2993,2.7
MT2927620000000,29,27620,"Jefferson City, MO MSA",2023,6,74980,72963,2017,2.7
MT2927900000000,29,27900,"Joplin, MO-KS MSA",2023,6,97067,94172,2895,3
MT2928140000000,29,28140,"Kansas City, MO-KS MSA",2023,6,1182722,1147964,34758,2.9
MT2941140000000,29,41140,"St. Joseph, MO-KS MSA",2023,6,53727,52017,1710,3.2
MT2941180000000,29,41180,"St. Louis, MO-IL MSA",2023,6,1471838,1423544,48294,3.3
MT2944180000000,29,44180,"Springfield, MO MSA",2023,6,239050,232368,6682,2.8
MT3013740000000,30,13740,"Billings, MT MSA",2023,6,98905,96589,2316,2.3
MT3014580000000,30,14580,"Bozeman, MT MSA",2023,6,75737,74183,1554,2.1
MT3024500000000,30,24500,"Great Falls, MT MSA",2023,6,39506,38472,1034,2.6
MT3025740000000,30,25740,"Helena, MT MSA",2023,6,46934,45788,1146,2.4
MT3033540000000,30,33540,"Missoula, MT MSA",2023,6,73670,71857,1813,2.5
MT3124260000000,31,24260,"Grand Island, NE MSA",2023,6,42272,41350,922,2.2
MT3130700000000,31,30700,"Lincoln, NE MSA",2023,6,192130,188049,4081,2.1
MT3136540000000,31,36540,"Omaha, NE-IA MSA",2023,6,522130,509275,12855,2.5
MT3216180000000,32,16180,"Carson City, NV MSA",2023,6,28821,27550,1271,4.4
MT3229820000000,32,29820,"Las Vegas-Henderson-North Las Vegas, NV MSA",2023,6,1184881,1121877,63004,5.3
MT3239900000000,32,39900,"Reno, NV MSA",2023,6,296415,283278,13137,4.4
MT3331700000000,33,31700,"Manchester-Nashua, NH MSA",2023,6,238904,233581,5323,2.2
MT3412100000000,34,12100,"Atlantic City-Hammonton, NJ MSA",2023,6,180670,169893,10777,6
MT3445940000000,34,45940,"Trenton-Princeton, NJ MSA",2023,6,198320,190111,8209,4.1
MT3447220000000,34,47220,"Vineland, NJ MSA",2023,6,65993,61495,4498,6.8
MT3510740000000,35,10740,"Albuquerque, NM MSA",2023,6,457496,442096,15400,3.4
MT3522140000000,35,22140,"Farmington, NM MSA",2023,6,49482,47439,2043,4.1
MT3529740000000,35,29740,"Las Cruces, NM MSA",2023,6,100656,96264,4392,4.4
MT3542140000000,35,42140,"Santa Fe, NM MSA",2023,6,73589,71201,2388,3.2
MT3610580000000,36,10580,"Albany-Schenectady-Troy, NY MSA",2023,6,459486,445750,13736,3
MT3613780000000,36,13780,"Binghamton, NY MSA",2023,6,106941,103196,3745,3.5
MT3615380000000,36,15380,"Buffalo-Cheektowaga, NY MSA",2023,6,562867,543475,19392,3.4
MT3621300000000,36,21300,"Elmira, NY MSA",2023,6,35598,34336,1262,3.5
MT3624020000000,36,24020,"Glens Falls, NY MSA",2023,6,59847,57868,1979,3.3
MT3627060000000,36,27060,"Ithaca, NY MSA",2023,6,48489,47099,1390,2.9
MT3628740000000,36,28740,"Kingston, NY MSA",2023,6,87440,84618,2822,3.2
MT3628880000000,36,28880,"Kiryas Joel-Poughkeepsie-Newburgh, NY MSA",2023,6,339880,329281,10599,3.1
MT3635620000000,36,35620,"New York-Newark-Jersey City, NY-NJ MSA",2023,6,10113482,9683866,429616,4.2
MT3640380000000,36,40380,"Rochester, NY MSA",2023,6,517221,500395,16826,3.3
MT3645060000000,36,45060,"Syracuse, NY MSA",2023,6,312113,301646,10467,3.4
MT3646540000000,36,46540,"Utica-Rome, NY MSA",2023,6,128019,123564,4455,3.5
MT3648060000000,36,48060,"Watertown-Fort Drum, NY MSA",2023,6,45283,43423,1860,4.1
MT3711700000000,37,11700,"Asheville, NC MSA",2023,6,211138,205252,5886,2.8
MT3715500000000,37,15500,"Burlington, NC MSA",2023,6,85800,82840,2960,3.4
MT3716740000000,37,16740,"Charlotte-Concord-Gastonia, NC-SC MSA",2023,6,1472200,1424177,48023,3.3
MT3720500000000,37,20500,"Durham-Chapel Hill, NC MSA",2023,6,320941,311076,9865,3.1
MT3722180000000,37,22180,"Fayetteville, NC MSA",2023,6,155047,148225,6822,4.4
MT3724140000000,37,24140,"Goldsboro, NC MSA",2023,6,50405,48575,1830,3.6
MT3724660000000,37,24660,"Greensboro-High Point, NC MSA",2023,6,371764,357488,14276,3.8
MT3724780000000,37,24780,"Greenville, NC MSA",2023,6,83322,80032,3290,3.9
MT3725860000000,37,25860,"Hickory-Lenoir-Morganton, NC MSA",2023,6,172826,167035,5791,3.4
MT3727340000000,37,27340,"Jacksonville, NC MSA",2023,6,73847,71187,2660,3.6
MT3738240000000,37,38240,"Pinehurst-Southern Pines, NC MSA",2023,6,44015,42519,1496,3.4
MT3739580000000,37,39580,"Raleigh-Cary, NC MSA",2023,6,833703,809008,24695,3
MT3740580000000,37,40580,"Rocky Mount, NC MSA",2023,6,63918,60911,3007,4.7
MT3748900000000,37,48900,"Wilmington, NC MSA",2023,6,221413,213636,7777,3.5
MT3749180000000,37,49180,"Winston-Salem, NC MSA",2023,6,325903,314529,11374,3.5
MT3813900000000,38,13900,"Bismarck, ND MSA",2023,6,72378,70888,1490,2.1
MT3822020000000,38,22020,"Fargo, ND-MN MSA",2023,6,152208,149304,2904,1.9
MT3824220000000,38,24220,"Grand Forks, ND-MN MSA",2023,6,55263,54077,1186,2.1
MT3833500000000,38,33500,"Minot, ND MSA",2023,6,39856,39041,815,2
MT3910420000000,39,10420,"Akron, OH MSA",2023,6,357103,344201,12902,3.6
MT3915940000000,39,15940,"Canton-Massillon, OH MSA",2023,6,190742,183442,7300,3.8
MT3917140000000,39,17140,"Cincinnati, OH-KY-IN MSA",2023,6,1161008,1122210,38798,3.3
MT3917410000000,39,17410,"Cleveland, OH MSA",2023,6,1083100,1044522,38578,3.6
MT3918140000000,39,18140,"Columbus, OH MSA",2023,6,1136762,1101075,35687,3.1
MT3919430000000,39,19430,"Dayton-Kettering-Beavercreek, OH MSA",2023,6,387334,373305,14029,3.6
MT3930620000000,39,30620,"Lima, OH MSA",2023,6,47404,45568,1836,3.9
MT3931900000000,39,31900,"Mansfield, OH MSA",2023,6,52636,50451,2185,4.2
MT3941780000000,39,41780,"Sandusky, OH MSA",2023,6,57107,54339,2768,4.8
MT3944220000000,39,44220,"Springfield, OH MSA",2023,6,61913,59611,2302,3.7
MT3945780000000,39,45780,"Toledo, OH MSA",2023,6,294176,282660,11516,3.9
MT3948260000000,39,48260,"Weirton-Steubenville, WV-OH MSA",2023,6,52412,49853,2559,4.9
MT3949660000000,39,49660,"Youngstown-Warren, OH MSA",2023,6,189033,181278,7755,4.1
MT4021420000000,40,21420,"Enid, OK MSA",2023,6,28336,27515,821,2.9
MT4030020000000,40,30020,"Lawton, OK MSA",2023,6,51727,49793,1934,3.7
MT4036420000000,40,36420,"Oklahoma City, OK MSA",2023,6,758304,736494,21810,2.9
MT4046140000000,40,46140,"Tulsa, OK MSA",2023,6,515644,499543,16101,3.1
MT4110540000000,41,10540,"Albany, OR MSA",2023,6,61326,58910,2416,3.9
MT4113460000000,41,13460,"Bend, OR MSA",2023,6,129968,124999,4969,3.8
MT4118700000000,41,18700,"Corvallis, OR MSA",2023,6,49142,47715,1427,2.9
MT4121660000000,41,21660,"Eugene-Springfield, OR MSA",2023,6,186064,179211,6853,3.7
MT4124420000000,41,24420,"Grants Pass, OR MSA",2023,6,34720,32997,1723,5
MT4132780000000,41,32780,"Medford, OR MSA",2023,6,104451,100045,4406,4.2
MT4138900000000,41,38900,"Portland-Vancouver-Hillsboro, OR-WA MSA",2023,6,1373248,1327441,45807,3.3
MT4141420000000,41,41420,"Salem, OR MSA",2023,6,216223,208561,7662,3.5
MT4210900000000,42,10900,"Allentown-Bethlehem-Easton, PA-NJ MSA",2023,6,448114,430777,17337,3.9
MT4211020000000,42,11020,"Altoona, PA MSA",2023,6,57239,55194,2045,3.6
MT4216540000000,42,16540,"Chambersburg, PA MSA",2023,6,76483,74157,2326,3
MT4221500000000,42,21500,"Erie, PA MSA",2023,6,127101,121937,5164,4.1
MT4223900000000,42,23900,"Gettysburg, PA MSA",2023,6,52337,50785,1552,3
MT4225420000000,42,25420,"Harrisburg-Carlisle, PA MSA",2023,6,310891,301267,9624,3.1
MT4227780000000,42,27780,"Johnstown, PA MSA",2023,6,56992,54595,2397,4.2
MT4229540000000,42,29540,"Lancaster, PA MSA",2023,6,291706,283368,8338,2.9
MT4230140000000,42,30140,"Lebanon, PA MSA",2023,6,73312,71049,2263,3.1
MT4237980000000,42,37980,"Philadelphia-Camden-Wilmington, PA-NJ-DE-MD MSA",2023,6,3280149,3160628,119521,3.6
MT4238300000000,42,38300,"Pittsburgh, PA MSA",2023,6,1230117,1185723,44394,3.6
MT4239740000000,42,39740,"Reading, PA MSA",2023,6,218490,210572,7918,3.6
MT4242540000000,42,42540,"Scranton--Wilkes-Barre, PA MSA",2023,6,278856,266696,12160,4.4
MT4244300000000,42,44300,"State College, PA MSA",2023,6,77599,75440,2159,2.8
MT4248700000000,42,48700,"Williamsport, PA MSA",2023,6,52922,50865,2057,3.9
MT4249620000000,42,49620,"York-Hanover, PA MSA",2023,6,239033,231521,7512,3.1
MT4439300000000,44,39300,"Providence-Warwick, RI-MA MSA",2023,6,878074,850030,28044,3.2
MT4516700000000,45,16700,"Charleston-North Charleston, SC MSA",2023,6,429462,419473,9989,2.3
MT4517900000000,45,17900,"Columbia, SC MSA",2023,6,409621,398952,10669,2.6
MT4522500000000,45,22500,"Florence, SC MSA",2023,6,91083,88324,2759,3
MT4524860000000,45,24860,"Greenville-Anderson-Greer, SC MSA",2023,6,467206,455398,11808,2.5
MT4525940000000,45,25940,"Hilton Head Island-Bluffton-Port Royal, SC MSA",2023,6,96259,93872,2387,2.5
MT4534820000000,45,34820,"Myrtle Beach-Conway-North Myrtle Beach, SC MSA",2023,6,165382,160015,5367,3.2
MT4543900000000,45,43900,"Spartanburg, SC MSA",2023,6,172111,167166,4945,2.9
MT4544940000000,45,44940,"Sumter, SC MSA",2023,6,41152,39739,1413,3.4
MT4639660000000,46,39660,"Rapid City, SD MSA",2023,6,78542,77130,1412,1.8
MT4643620000000,46,43620,"Sioux Falls, SD-MN MSA",2023,6,171382,168521,2861,1.7
MT4716860000000,47,16860,"Chattanooga, TN-GA MSA",2023,6,285860,277071,8789,3.1
MT4717300000000,47,17300,"Clarksville, TN-KY MSA",2023,6,135687,130594,5093,3.8
MT4717420000000,47,17420,"Cleveland, TN MSA",2023,6,56890,54908,1982,3.5
MT4727180000000,47,27180,"Jackson, TN MSA",2023,6,77883,75207,2676,3.4
MT4727740000000,47,27740,"Johnson City, TN MSA",2023,6,96139,92982,3157,3.3
MT4728700000000,47,28700,"Kingsport-Bristol, TN-VA MSA",2023,6,132415,127991,4424,3.3
MT4728940000000,47,28940,"Knoxville, TN MSA",2023,6,445201,431892,13309,3
MT4732820000000,47,32820,"Memphis, TN-MS-AR MSA",2023,6,623043,599795,23248,3.7
MT4734100000000,47,34100,"Morristown, TN MSA",2023,6,52680,50853,1827,3.5
MT4734980000000,47,34980,"Nashville-Davidson--Murfreesboro--Franklin, TN MSA",2023,6,1142740,1113227,29513,2.6
MT4810180000000,48,10180,"Abilene, TX MSA",2023,6,84614,81699,2915,3.4
MT4811100000000,48,11100,"Amarillo, TX MSA",2023,6,134461,130157,4304,3.2
MT4812420000000,48,12420,"Austin-Round Rock-San Marcos, TX MSA",2023,6,1456328,1405248,51080,3.5
MT4813140000000,48,13140,"Beaumont-Port Arthur, TX MSA",2023,6,174813,164949,9864,5.6
MT4815180000000,48,15180,"Brownsville-Harlingen, TX MSA",2023,6,184997,175102,9895,5.3
MT4817780000000,48,17780,"College Station-Bryan, TX MSA",2023,6,145896,140901,4995,3.4
MT4818580000000,48,18580,"Corpus Christi, TX MSA",2023,6,206584,197755,8829,4.3
MT4819100000000,48,19100,"Dallas-Fort Worth-Arlington, TX MSA",2023,6,4379367,4213525,165842,3.8
MT4820580000000,48,20580,"Eagle Pass, TX MSA",2023,6,23745,21979,1766,7.4
MT4821340000000,48,21340,"El Paso, TX MSA",2023,6,400296,383228,17068,4.3
MT4826420000000,48,26420,"Houston-Pasadena-The Woodlands, TX MSA",2023,6,3732970,3575274,157696,4.2
MT4828660000000,48,28660,"Killeen-Temple, TX MSA",2023,6,197248,188782,8466,4.3
MT4829700000000,48,29700,"Laredo, TX MSA",2023,6,115425,110793,4632,4
MT4830980000000,48,30980,"Longview, TX MSA",2023,6,128549,123067,5482,4.3
MT4831180000000,48,31180,"Lubbock, TX MSA",2023,6,179289,173191,6098,3.4
MT4832580000000,48,32580,"McAllen-Edinburg-Mission, TX MSA",2023,6,386783,363280,23503,6.1
MT4833260000000,48,33260,"Midland, TX MSA",2023,6,99355,96547,2808,2.8
MT4836220000000,48,36220,"Odessa, TX MSA",2023,6,83136,80388,2748,3.3
MT4841660000000,48,41660,"San Angelo, TX MSA",2023,6,60588,58561,2027,3.3
MT4841700000000,48,41700,"San Antonio-New Braunfels, TX MSA",2023,6,1299215,1250296,48919,3.8
MT4843300000000,48,43300,"Sherman-Denison, TX MSA",2023,6,69502,66856,2646,3.8
MT4845500000000,48,45500,"Texarkana, TX-AR MSA",2023,6,60873,58420,2453,4
MT4846340000000,48,46340,"Tyler, TX MSA",2023,6,115519,111192,4327,3.7
MT4847020000000,48,47020,"Victoria, TX MSA",2023,6,44760,42981,1779,4
MT4847380000000,48,47380,"Waco, TX MSA",2023,6,143208,137829,5379,3.8
MT4848660000000,48,48660,"Wichita Falls, TX MSA",2023,6,66408,63941,2467,3.7
MT4930860000000,49,30860,"Logan, UT-ID MSA",2023,6,79182,77340,1842,2.3
MT4936260000000,49,36260,"Ogden, UT MSA",2023,6,346098,337520,8578,2.5
MT4939340000000,49,39340,"Provo-Orem-Lehi, UT MSA",2023,6,362763,353292,9471,2.6
MT4941100000000,49,41100,"St. George, UT MSA",2023,6,90394,87802,2592,2.9
MT4941620000000,49,41620,"Salt Lake City-Murray, UT MSA",2023,6,725102,705813,19289,2.7
MT5015540000000,50,15540,"Burlington-South Burlington, VT MSA",2023,6,129931,127915,2016,1.6
MT5113980000000,51,13980,"Blacksburg-Christiansburg-Radford, VA MSA",2023,6,92912,90405,2507,2.7
MT5116820000000,51,16820,"Charlottesville, VA MSA",2023,6,118332,115523,2809,2.4
MT5125500000000,51,25500,"Harrisonburg, VA MSA",2023,6,72607,70796,1811,2.5
MT5131340000000,51,31340,"Lynchburg, VA MSA",2023,6,128382,124540,3842,3
MT5140060000000,51,40060,"Richmond, VA MSA",2023,6,723326,703415,19911,2.8
MT5140220000000,51,40220,"Roanoke, VA MSA",2023,6,157464,153254,4210,2.7
MT5144420000000,51,44420,"Staunton-Stuarts Draft, VA MSA",2023,6,65559,64007,1552,2.4
MT5147260000000,51,47260,"Virginia Beach-Chesapeake-Norfolk, VA-NC MSA",2023,6,879204,854188,25016,2.8
MT5149020000000,51,49020,"Winchester, VA-WV MSA",2023,6,77000,75028,1972,2.6
MT5313380000000,53,13380,"Bellingham, WA MSA",2023,6,113500,109326,4174,3.7
MT5314740000000,53,14740,"Bremerton-Silverdale-Port Orchard, WA MSA",2023,6,121226,116786,4440,3.7
MT5328420000000,53,28420,"Kennewick-Richland, WA MSA",2023,6,143605,137141,6464,4.5
MT5331020000000,53,31020,"Longview-Kelso, WA MSA",2023,6,47124,45029,2095,4.4
MT5334580000000,53,34580,"Mount Vernon-Anacortes, WA MSA",2023,6,57911,55479,2432,4.2
MT5336500000000,53,36500,"Olympia-Lacey-Tumwater, WA MSA",2023,6,140995,135797,5198,3.7
MT5342660000000,53,42660,"Seattle-Tacoma-Bellevue, WA MSA",2023,6,2313408,2222033,91375,3.9
MT5344060000000,53,44060,"Spokane-Spokane Valley, WA MSA",2023,6,279623,268945,10678,3.8
MT5347460000000,53,47460,"Walla Walla, WA MSA",2023,6,29274,28203,1071,3.7
MT5348300000000,53,48300,"Wenatchee-East Wenatchee, WA MSA",2023,6,61251,58731,2520,4.1
MT5349420000000,53,49420,"Yakima, WA MSA",2023,6,126087,119667,6420,5.1
MT5413220000000,54,13220,"Beckley, WV MSA",2023,6,46052,44224,1828,4
MT5416620000000,54,16620,"Charleston, WV MSA",2023,6,91202,87808,3394,3.7
MT5426580000000,54,26580,"Huntington-Ashland, WV-KY-OH MSA",2023,6,155591,148694,6897,4.4
MT5434060000000,54,34060,"Morgantown, WV MSA",2023,6,71445,69104,2341,3.3
MT5437620000000,54,37620,"Parkersburg-Vienna, WV MSA",2023,6,39385,37812,1573,4
MT5448540000000,54,48540,"Wheeling, WV-OH MSA",2023,6,59689,57095,2594,4.3
MT5511540000000,55,11540,"Appleton, WI MSA",2023,6,136622,133324,3298,2.4
MT5520740000000,55,20740,"Eau Claire, WI MSA",2023,6,95494,92791,2703,2.8
MT5522540000000,55,22540,"Fond du Lac, WI MSA",2023,6,56138,54727,1411,2.5
MT5524580000000,55,24580,"Green Bay, WI MSA",2023,6,177752,173180,4572,2.6
MT5527500000000,55,27500,"Janesville-Beloit, WI MSA",2023,6,86425,83535,2890,3.3
MT5528450000000,55,28450,"Kenosha, WI MSA",2023,6,94448,91553,2895,3.1
MT5529100000000,55,29100,"La Crosse-Onalaska, WI-MN MSA",2023,6,90309,88004,2305,2.6
MT5531540000000,55,31540,"Madison, WI MSA",2023,6,404844,395657,9187,2.3
MT5533340000000,55,33340,"Milwaukee-Waukesha, WI MSA",2023,6,815124,790488,24636,3
MT5536780000000,55,36780,"Oshkosh-Neenah, WI MSA",2023,6,92440,90126,2314,2.5
MT5539540000000,55,39540,"Racine-Mount Pleasant, WI MSA",2023,6,100903,97576,3327,3.3
MT5543100000000,55,43100,"Sheboygan, WI MSA",2023,6,63094,61630,1464,2.3
MT5548140000000,55,48140,"Wausau, WI MSA",2023,6,74728,72797,1931,2.6
MT5616220000000,56,16220,"Casper, WY MSA",2023,6,42168,40957,1211,2.9
MT5616940000000,56,16940,"Cheyenne, WY MSA",2023,6,48755,47332,1423,2.9
MT7210380000000,72,10380,"Aguadilla, PR MSA",2023,6,87572,80815,6757,7.7
MT7211640000000,72,11640,"Arecibo, PR MSA",2023,6,65494,61200,4294,6.6
MT7225020000000,72,25020,"Guayama, PR MSA",2023,6,18671,16854,1817,9.7
MT7232420000000,72,32420,"Mayaguez, PR MSA",2023,6,64707,59651,5056,7.8
MT7238660000000,72,38660,"Ponce, PR MSA",2023,6,87149,79012,8137,9.3
MT7241980000000,72,41980,"San Juan-Bayamon-Caguas, PR MSA",2023,6,792146,751565,40581,5.1
MT0111500000000,1,11500,"Anniston-Oxford, AL MSA",2023,7,49268,47997,1271,2.6
MT0112220000000,1,12220,"Auburn-Opelika, AL MSA",2023,7,94581,92433,2148,2.3
MT0113820000000,1,13820,"Birmingham, AL MSA",2023,7,563728,551165,12563,2.2
MT0119300000000,1,19300,"Daphne-Fairhope-Foley, AL MSA",2023,7,112894,110404,2490,2.2
MT0119460000000,1,19460,"Decatur, AL MSA",2023,7,73902,72339,1563,2.1
MT0120020000000,1,20020,"Dothan, AL MSA",2023,7,67166,65504,1662,2.5
MT0122520000000,1,22520,"Florence-Muscle Shoals, AL MSA",2023,7,68353,66554,1799,2.6
MT0123460000000,1,23460,"Gadsden, AL MSA",2023,7,41239,40192,1047,2.5
MT0126620000000,1,26620,"Huntsville, AL MSA",2023,7,268663,263329,5334,2
MT0133660000000,1,33660,"Mobile, AL MSA",2023,7,182681,177308,5373,2.9
MT0133860000000,1,33860,"Montgomery, AL MSA",2023,7,173891,169532,4359,2.5
MT0146220000000,1,46220,"Tuscaloosa, AL MSA",2023,7,124795,121594,3201,2.6
MT0211260000000,2,11260,"Anchorage, AK MSA",2023,7,199658,191858,7800,3.9
MT0221820000000,2,21820,"Fairbanks-College, AK MSA",2023,7,45048,43339,1709,3.8
MT0422380000000,4,22380,"Flagstaff, AZ MSA",2023,7,74036,70987,3049,4.1
MT0429420000000,4,29420,"Lake Havasu City-Kingman, AZ MSA",2023,7,86593,82673,3920,4.5
MT0438060000000,4,38060,"Phoenix-Mesa-Chandler, AZ MSA",2023,7,2674600,2584825,89775,3.4
MT0439150000000,4,39150,"Prescott Valley-Prescott, AZ MSA",2023,7,105651,101706,3945,3.7
MT0443420000000,4,43420,"Sierra Vista-Douglas, AZ MSA",2023,7,47949,45852,2097,4.4
MT0446060000000,4,46060,"Tucson, AZ MSA",2023,7,495657,477315,18342,3.7
MT0449740000000,4,49740,"Yuma, AZ MSA",2023,7,98370,86478,11892,12.1
MT0522220000000,5,22220,"Fayetteville-Springdale-Rogers, AR MSA",2023,7,297906,290535,7371,2.5
MT0522900000000,5,22900,"Fort Smith, AR-OK MSA",2023,7,101232,97738,3494,3.5
MT0526300000000,5,26300,"Hot Springs, AR MSA",2023,7,43730,42234,1496,3.4
MT0527860000000,5,27860,"Jonesboro, AR MSA",2023,7,65097,63242,1855,2.8
MT0530780000000,5,30780,"Little Rock-North Little Rock-Conway, AR MSA",2023,7,371706,360901,10805,2.9
MT0612540000000,6,12540,"Bakersfield-Delano, CA MSA",2023,7,401558,368775,32783,8.2
MT0617020000000,6,17020,"Chico, CA MSA",2023,7,90621,85941,4680,5.2
MT0620940000000,6,20940,"El Centro, CA MSA",2023,7,71695,59287,12408,17.3
MT0623420000000,6,23420,"Fresno, CA MSA",2023,7,528720,489162,39558,7.5
MT0625260000000,6,25260,"Hanford-Corcoran, CA MSA",2023,7,56853,51992,4861,8.6
MT0631080000000,6,31080,"Los Angeles-Long Beach-Anaheim, CA MSA",2023,7,6667235,6356947,310288,4.7
MT0632900000000,6,32900,"Merced, CA MSA",2023,7,119472,108643,10829,9.1
MT0633700000000,6,33700,"Modesto, CA MSA",2023,7,249910,234169,15741,6.3
MT0634900000000,6,34900,"Napa, CA MSA",2023,7,73316,70801,2515,3.4
MT0637100000000,6,37100,"Oxnard-Thousand Oaks-Ventura, CA MSA",2023,7,418202,400847,17355,4.1
MT0639820000000,6,39820,"Redding, CA MSA",2023,7,78234,74452,3782,4.8
MT0640140000000,6,40140,"Riverside-San Bernardino-Ontario, CA MSA",2023,7,2180939,2079141,101798,4.7
MT0640900000000,6,40900,"Sacramento-Roseville-Folsom, CA MSA",2023,7,1163398,1114624,48774,4.2
MT0641500000000,6,41500,"Salinas, CA MSA",2023,7,217901,202700,15201,7
MT0641740000000,6,41740,"San Diego-Chula Vista-Carlsbad, CA MSA",2023,7,1637644,1577205,60439,3.7
MT0641860000000,6,41860,"San Francisco-Oakland-Fremont, CA MSA",2023,7,2511864,2421073,90791,3.6
MT0641940000000,6,41940,"San Jose-Sunnyvale-Santa Clara, CA MSA",2023,7,1055586,1016756,38830,3.7
MT0642020000000,6,42020,"San Luis Obispo-Paso Robles, CA MSA",2023,7,132723,128007,4716,3.6
MT0642100000000,6,42100,"Santa Cruz-Watsonville, CA MSA",2023,7,135195,127700,7495,5.5
MT0642200000000,6,42200,"Santa Maria-Santa Barbara, CA MSA",2023,7,221243,212373,8870,4
MT0642220000000,6,42220,"Santa Rosa-Petaluma, CA MSA",2023,7,246939,238038,8901,3.6
MT0644700000000,6,44700,"Stockton-Lodi, CA MSA",2023,7,364553,342641,21912,6
MT0646700000000,6,46700,"Vallejo, CA MSA",2023,7,213968,204683,9285,4.3
MT0647300000000,6,47300,"Visalia, CA MSA",2023,7,217334,196075,21259,9.8
MT0649700000000,6,49700,"Yuba City, CA MSA",2023,7,79885,74121,5764,7.2
MT0814500000000,8,14500,"Boulder, CO MSA",2023,7,193701,187345,6356,3.3
MT0817820000000,8,17820,"Colorado Springs, CO MSA",2023,7,389768,376438,13330,3.4
MT0819740000000,8,19740,"Denver-Aurora-Centennial, CO MSA",2023,7,1763270,1704882,58388,3.3
MT0822660000000,8,22660,"Fort Collins-Loveland, CO MSA",2023,7,206302,199685,6617,3.2
MT0824300000000,8,24300,"Grand Junction, CO MSA",2023,7,78575,75708,2867,3.6
MT0824540000000,8,24540,"Greeley, CO MSA",2023,7,174831,168666,6165,3.5
MT0839380000000,8,39380,"Pueblo, CO MSA",2023,7,73616,70166,3450,4.7
MT0914860000000,9,14860,"Bridgeport-Stamford-Danbury, CT MSA",2023,7,508141,492902,15239,3
MT0925540000000,9,25540,"Hartford-West Hartford-East Hartford, CT MSA",2023,7,606761,588447,18314,3
MT0935300000000,9,35300,"New Haven, CT MSA",2023,7,309606,300250,9356,3
MT0935980000000,9,35980,"Norwich-New London-Willimantic, CT MSA",2023,7,140063,135724,4339,3.1
MT0947930000000,9,47930,"Waterbury-Shelton, CT MSA",2023,7,237665,229310,8355,3.5
MT1020100000000,10,20100,"Dover, DE MSA",2023,7,85575,82049,3526,4.1
MT1147900000000,11,47900,"Washington-Arlington-Alexandria, DC-VA-MD-WV MSA",2023,7,3516901,3431456,85445,2.4
MT1215980000000,12,15980,"Cape Coral-Fort Myers, FL MSA",2023,7,372303,360305,11998,3.2
MT1218880000000,12,18880,"Crestview-Fort Walton Beach-Destin, FL MSA",2023,7,142214,138362,3852,2.7
MT1219660000000,12,19660,"Deltona-Daytona Beach-Ormond Beach, FL MSA",2023,7,318619,307544,11075,3.5
MT1223540000000,12,23540,"Gainesville, FL MSA",2023,7,169464,163862,5602,3.3
MT1226140000000,12,26140,"Homosassa Springs, FL MSA",2023,7,53712,51329,2383,4.4
MT1227260000000,12,27260,"Jacksonville, FL MSA",2023,7,848516,822035,26481,3.1
MT1229460000000,12,29460,"Lakeland-Winter Haven, FL MSA",2023,7,355966,342804,13162,3.7
MT1233100000000,12,33100,"Miami-Fort Lauderdale-West Palm Beach, FL MSA",2023,7,3271205,3190947,80258,2.5
MT1234940000000,12,34940,"Naples-Marco Island, FL MSA",2023,7,182368,176958,5410,3
MT1235840000000,12,35840,"North Port-Bradenton-Sarasota, FL MSA",2023,7,392754,380538,12216,3.1
MT1236100000000,12,36100,"Ocala, FL MSA",2023,7,156300,150413,5887,3.8
MT1236740000000,12,36740,"Orlando-Kissimmee-Sanford, FL MSA",2023,7,1517342,1472886,44456,2.9
MT1237340000000,12,37340,"Palm Bay-Melbourne-Titusville, FL MSA",2023,7,304000,294613,9387,3.1
MT1237460000000,12,37460,"Panama City-Panama City Beach, FL MSA",2023,7,100497,97503,2994,3
MT1237860000000,12,37860,"Pensacola-Ferry Pass-Brent, FL MSA",2023,7,240317,232961,7356,3.1
MT1238940000000,12,38940,"Port St. Lucie, FL MSA",2023,7,238638,230549,8089,3.4
MT1239460000000,12,39460,"Punta Gorda, FL MSA",2023,7,75212,72449,2763,3.7
MT1242680000000,12,42680,"Sebastian-Vero Beach-West Vero Corridor, FL MSA",2023,7,67951,65523,2428,3.6
MT1242700000000,12,42700,"Sebring, FL MSA",2023,7,36634,35043,1591,4.3
MT1245220000000,12,45220,"Tallahassee, FL MSA",2023,7,204556,198198,6358,3.1
MT1245300000000,12,45300,"Tampa-St. Petersburg-Clearwater, FL MSA",2023,7,1695429,1644331,51098,3
MT1248680000000,12,48680,"Wildwood-The Villages, FL MSA",2023,7,33528,31872,1656,4.9
MT1310500000000,13,10500,"Albany, GA MSA",2023,7,62441,60058,2383,3.8
MT1312020000000,13,12020,"Athens-Clarke County, GA MSA",2023,7,106649,103484,3165,3
MT1312060000000,13,12060,"Atlanta-Sandy Springs-Roswell, GA MSA",2023,7,3271428,3166766,104662,3.2
MT1312260000000,13,12260,"Augusta-Richmond County, GA-SC MSA",2023,7,266189,256392,9797,3.7
MT1315260000000,13,15260,"Brunswick-St. Simons, GA MSA",2023,7,54744,53165,1579,2.9
MT1317980000000,13,17980,"Columbus, GA-AL MSA",2023,7,129995,125305,4690,3.6
MT1319140000000,13,19140,"Dalton, GA MSA",2023,7,67275,64914,2361,3.5
MT1323580000000,13,23580,"Gainesville, GA MSA",2023,7,107990,105160,2830,2.6
MT1325980000000,13,25980,"Hinesville, GA MSA",2023,7,31121,29930,1191,3.8
MT1331420000000,13,31420,"Macon-Bibb County, GA MSA",2023,7,97280,93550,3730,3.8
MT1340660000000,13,40660,"Rome, GA MSA",2023,7,45174,43634,1540,3.4
MT1342340000000,13,42340,"Savannah, GA MSA",2023,7,207123,201066,6057,2.9
MT1346660000000,13,46660,"Valdosta, GA MSA",2023,7,61592,59378,2214,3.6
MT1347580000000,13,47580,"Warner Robins, GA MSA",2023,7,89586,86895,2691,3
MT1527980000000,15,27980,"Kahului-Wailuku, HI MSA",2023,7,83194,81021,2173,2.6
MT1546520000000,15,46520,"Urban Honolulu, HI MSA",2023,7,468426,456366,12060,2.6
MT1614260000000,16,14260,"Boise City, ID MSA",2023,7,437232,423730,13502,3.1
MT1617660000000,16,17660,"Coeur d'Alene, ID MSA",2023,7,89079,85739,3340,3.7
MT1626820000000,16,26820,"Idaho Falls, ID MSA",2023,7,83578,81244,2334,2.8
MT1630300000000,16,30300,"Lewiston, ID-WA MSA",2023,7,30714,29731,983,3.2
MT1638540000000,16,38540,"Pocatello, ID MSA",2023,7,40052,38627,1425,3.6
MT1646300000000,16,46300,"Twin Falls, ID MSA",2023,7,59455,57543,1912,3.2
MT1714010000000,17,14010,"Bloomington, IL MSA",2023,7,94747,91130,3617,3.8
MT1716580000000,17,16580,"Champaign-Urbana, IL MSA",2023,7,124609,119214,5395,4.3
MT1716980000000,17,16980,"Chicago-Naperville-Elgin, IL-IN MSA",2023,7,4894720,4679051,215669,4.4
MT1719340000000,17,19340,"Davenport-Moline-Rock Island, IA-IL MSA",2023,7,189869,181364,8505,4.5
MT1719500000000,17,19500,"Decatur, IL MSA",2023,7,44795,41986,2809,6.3
MT1728100000000,17,28100,"Kankakee, IL MSA",2023,7,50962,47862,3100,6.1
MT1737900000000,17,37900,"Peoria, IL MSA",2023,7,175658,166836,8822,5
MT1740420000000,17,40420,"Rockford, IL MSA",2023,7,160967,150531,10436,6.5
MT1744100000000,17,44100,"Springfield, IL MSA",2023,7,101481,96847,4634,4.6
MT1814020000000,18,14020,"Bloomington, IN MSA",2023,7,85025,82456,2569,3
MT1818020000000,18,18020,"Columbus, IN MSA",2023,7,39499,38233,1266,3.2
MT1821140000000,18,21140,"Elkhart-Goshen, IN MSA",2023,7,100365,95693,4672,4.7
MT1821780000000,18,21780,"Evansville, IN MSA",2023,7,134872,130551,4321,3.2
MT1823060000000,18,23060,"Fort Wayne, IN MSA",2023,7,229696,222499,7197,3.1
MT1826900000000,18,26900,"Indianapolis-Carmel-Greenwood, IN MSA",2023,7,1117521,1082401,35120,3.1
MT1829020000000,18,29020,"Kokomo, IN MSA",2023,7,35287,33649,1638,4.6
MT1829200000000,18,29200,"Lafayette-West Lafayette, IN MSA",2023,7,119849,116416,3433,2.9
MT1833140000000,18,33140,"Michigan City-La Porte, IN MSA",2023,7,51348,49369,1979,3.9
MT1834620000000,18,34620,"Muncie, IN MSA",2023,7,51725,49683,2042,3.9
MT1843780000000,18,43780,"South Bend-Mishawaka, IN-MI MSA",2023,7,154968,148458,6510,4.2
MT1845460000000,18,45460,"Terre Haute, IN MSA",2023,7,76847,74084,2763,3.6
MT1911180000000,19,11180,"Ames, IA MSA",2023,7,69458,67812,1646,2.4
MT1916300000000,19,16300,"Cedar Rapids, IA MSA",2023,7,148068,143223,4845,3.3
MT1919780000000,19,19780,"Des Moines-West Des Moines, IA MSA",2023,7,408808,397648,11160,2.7
MT1920220000000,19,20220,"Dubuque, IA MSA",2023,7,53569,51947,1622,3
MT1926980000000,19,26980,"Iowa City, IA MSA",2023,7,99323,96853,2470,2.5
MT1943580000000,19,43580,"Sioux City, IA-NE-SD MSA",2023,7,77033,74852,2181,2.8
MT1947940000000,19,47940,"Waterloo-Cedar Falls, IA MSA",2023,7,89113,86468,2645,3
MT2029940000000,20,29940,"Lawrence, KS MSA",2023,7,70200,68408,1792,2.6
MT2031740000000,20,31740,"Manhattan, KS MSA",2023,7,63369,61667,1702,2.7
MT2045820000000,20,45820,"Topeka, KS MSA",2023,7,118045,114512,3533,3
MT2048620000000,20,48620,"Wichita, KS MSA",2023,7,331437,321322,10115,3.1
MT2114540000000,21,14540,"Bowling Green, KY MSA",2023,7,90603,86932,3671,4.1
MT2121060000000,21,21060,"Elizabethtown, KY MSA",2023,7,54215,51868,2347,4.3
MT2130460000000,21,30460,"Lexington-Fayette, KY MSA",2023,7,272101,262309,9792,3.6
MT2131140000000,21,31140,"Louisville/Jefferson County, KY-IN MSA",2023,7,688476,662788,25688,3.7
MT2136980000000,21,36980,"Owensboro, KY MSA",2023,7,50807,48602,2205,4.3
MT2137140000000,21,37140,"Paducah, KY-IL MSA",2023,7,45713,43639,2074,4.5
MT2210780000000,22,10780,"Alexandria, LA MSA",2023,7,64228,62197,2031,3.2
MT2212940000000,22,12940,"Baton Rouge, LA MSA",2023,7,419399,405328,14071,3.4
MT2225220000000,22,25220,"Hammond, LA MSA",2023,7,60016,57625,2391,4
MT2226380000000,22,26380,"Houma-Bayou Cane-Thibodaux, LA MSA",2023,7,88223,85604,2619,3
MT2229180000000,22,29180,"Lafayette, LA MSA",2023,7,195990,190110,5880,3
MT2229340000000,22,29340,"Lake Charles, LA MSA",2023,7,97540,94059,3481,3.6
MT2233740000000,22,33740,"Monroe, LA MSA",2023,7,96005,92112,3893,4.1
MT2235380000000,22,35380,"New Orleans-Metairie, LA MSA",2023,7,466533,449174,17359,3.7
MT2243340000000,22,43340,"Shreveport-Bossier City, LA MSA",2023,7,168718,162642,6076,3.6
MT2243640000000,22,43640,"Slidell-Mandeville-Covington, LA MSA",2023,7,128116,124245,3871,3
MT2312620000000,23,12620,"Bangor, ME MSA",2023,7,74347,72236,2111,2.8
MT2330340000000,23,30340,"Lewiston-Auburn, ME MSA",2023,7,54887,53404,1483,2.7
MT2338860000000,23,38860,"Portland-South Portland, ME MSA",2023,7,308644,301623,7021,2.3
MT2412580000000,24,12580,"Baltimore-Columbia-Towson, MD MSA",2023,7,1473150,1443850,29300,2
MT2425180000000,24,25180,"Hagerstown-Martinsburg, MD-WV MSA",2023,7,142592,138524,4068,2.9
MT2430500000000,24,30500,"Lexington Park, MD MSA",2023,7,106764,104866,1898,1.8
MT2441540000000,24,41540,"Salisbury, MD MSA",2023,7,63587,62059,1528,2.4
MT2511200000000,25,11200,"Amherst Town-Northampton, MA MSA",2023,7,83292,80702,2590,3.1
MT2512700000000,25,12700,"Barnstable Town, MA MSA",2023,7,114227,109291,4936,4.3
MT2514460000000,25,14460,"Boston-Cambridge-Newton, MA-NH MSA",2023,7,2761279,2675921,85358,3.1
MT2538340000000,25,38340,"Pittsfield, MA MSA",2023,7,63471,61194,2277,3.6
MT2544140000000,25,44140,"Springfield, MA MSA",2023,7,220166,210747,9419,4.3
MT2549340000000,25,49340,"Worcester, MA MSA",2023,7,455114,439538,15576,3.4
MT2611460000000,26,11460,"Ann Arbor, MI MSA",2023,7,206262,199864,6398,3.1
MT2612980000000,26,12980,"Battle Creek, MI MSA",2023,7,62205,59580,2625,4.2
MT2613020000000,26,13020,"Bay City, MI MSA",2023,7,50028,47603,2425,4.8
MT2619820000000,26,19820,"Detroit-Warren-Dearborn, MI MSA",2023,7,2181001,2102856,78145,3.6
MT2622420000000,26,22420,"Flint, MI MSA",2023,7,187230,178378,8852,4.7
MT2624340000000,26,24340,"Grand Rapids-Wyoming-Kentwood, MI MSA",2023,7,626296,605293,21003,3.4
MT2627100000000,26,27100,"Jackson, MI MSA",2023,7,75244,72217,3027,4
MT2628020000000,26,28020,"Kalamazoo-Portage, MI MSA",2023,7,138874,133935,4939,3.6
MT2629620000000,26,29620,"Lansing-East Lansing, MI MSA",2023,7,251391,242494,8897,3.5
MT2633220000000,26,33220,"Midland, MI MSA",2023,7,42495,40928,1567,3.7
MT2633780000000,26,33780,"Monroe, MI MSA",2023,7,78155,75009,3146,4
MT2634740000000,26,34740,"Muskegon-Norton Shores, MI MSA",2023,7,83758,80245,3513,4.2
MT2635660000000,26,35660,"Niles, MI MSA",2023,7,75865,72782,3083,4.1
MT2640980000000,26,40980,"Saginaw, MI MSA",2023,7,84847,80609,4238,5
MT2645900000000,26,45900,"Traverse City, MI MSA",2023,7,80794,77644,3150,3.9
MT2720260000000,27,20260,"Duluth, MN-WI MSA",2023,7,140158,135244,4914,3.5
MT2731860000000,27,31860,"Mankato, MN MSA",2023,7,60246,58849,1397,2.3
MT2733460000000,27,33460,"Minneapolis-St. Paul-Bloomington, MN-WI MSA",2023,7,2069228,2013768,55460,2.7
MT2740340000000,27,40340,"Rochester, MN MSA",2023,7,125791,122724,3067,2.4
MT2741060000000,27,41060,"St. Cloud, MN MSA",2023,7,109603,106238,3365,3.1
MT2825060000000,28,25060,"Gulfport-Biloxi, MS MSA",2023,7,184078,178684,5394,2.9
MT2825620000000,28,25620,"Hattiesburg, MS MSA",2023,7,69837,67877,1960,2.8
MT2827140000000,28,27140,"Jackson, MS MSA",2023,7,277120,269414,7706,2.8
MT2916020000000,29,16020,"Cape Girardeau, MO-IL MSA",2023,7,48847,47400,1447,3
MT2917860000000,29,17860,"Columbia, MO MSA",2023,7,112268,109207,3061,2.7
MT2927620000000,29,27620,"Jefferson City, MO MSA",2023,7,75147,73072,2075,2.8
MT2927900000000,29,27900,"Joplin, MO-KS MSA",2023,7,97107,94147,2960,3
MT2928140000000,29,28140,"Kansas City, MO-KS MSA",2023,7,1184366,1149050,35316,3
MT2941140000000,29,41140,"St. Joseph, MO-KS MSA",2023,7,53819,52071,1748,3.2
MT2941180000000,29,41180,"St. Louis, MO-IL MSA",2023,7,1474445,1424801,49644,3.4
MT2944180000000,29,44180,"Springfield, MO MSA",2023,7,239430,232558,6872,2.9
MT3013740000000,30,13740,"Billings, MT MSA",2023,7,98943,96569,2374,2.4
MT3014580000000,30,14580,"Bozeman, MT MSA",2023,7,75819,74220,1599,2.1
MT3024500000000,30,24500,"Great Falls, MT MSA",2023,7,39623,38571,1052,2.7
MT3025740000000,30,25740,"Helena, MT MSA",2023,7,46904,45728,1176,2.5
MT3033540000000,30,33540,"Missoula, MT MSA",2023,7,73741,71873,1868,2.5
MT3124260000000,31,24260,"Grand Island, NE MSA",2023,7,42281,41341,940,2.2
MT3130700000000,31,30700,"Lincoln, NE MSA",2023,7,191998,187803,4195,2.2
MT3136540000000,31,36540,"Omaha, NE-IA MSA",2023,7,522565,509314,13251,2.5
MT3216180000000,32,16180,"Carson City, NV MSA",2023,7,28868,27585,1283,4.4
MT3229820000000,32,29820,"Las Vegas-Henderson-North Las Vegas, NV MSA",2023,7,1187852,1124302,63550,5.3
MT3239900000000,32,39900,"Reno, NV MSA",2023,7,296784,283518,13266,4.5
MT3331700000000,33,31700,"Manchester-Nashua, NH MSA",2023,7,239224,233795,5429,2.3
MT3412100000000,34,12100,"Atlantic City-Hammonton, NJ MSA",2023,7,180697,169718,10979,6.1
MT3445940000000,34,45940,"Trenton-Princeton, NJ MSA",2023,7,198390,189987,8403,4.2
MT3447220000000,34,47220,"Vineland, NJ MSA",2023,7,66039,61445,4594,7
MT3510740000000,35,10740,"Albuquerque, NM MSA",2023,7,458122,442418,15704,3.4
MT3522140000000,35,22140,"Farmington, NM MSA",2023,7,49470,47437,2033,4.1
MT3529740000000,35,29740,"Las Cruces, NM MSA",2023,7,100775,96360,4415,4.4
MT3542140000000,35,42140,"Santa Fe, NM MSA",2023,7,73696,71235,2461,3.3
MT3610580000000,36,10580,"Albany-Schenectady-Troy, NY MSA",2023,7,459980,445745,14235,3.1
MT3613780000000,36,13780,"Binghamton, NY MSA",2023,7,107125,103232,3893,3.6
MT3615380000000,36,15380,"Buffalo-Cheektowaga, NY MSA",2023,7,563507,543410,20097,3.6
MT3621300000000,36,21300,"Elmira, NY MSA",2023,7,35681,34372,1309,3.7
MT3624020000000,36,24020,"Glens Falls, NY MSA",2023,7,59838,57783,2055,3.4
MT3627060000000,36,27060,"Ithaca, NY MSA",2023,7,48610,47160,1450,3
MT3628740000000,36,28740,"Kingston, NY MSA",2023,7,87643,84700,2943,3.4
MT3628880000000,36,28880,"Kiryas Joel-Poughkeepsie-Newburgh, NY MSA",2023,7,340645,329623,11022,3.2
MT3635620000000,36,35620,"New York-Newark-Jersey City, NY-NJ MSA",2023,7,10125589,9689904,435685,4.3
MT3640380000000,36,40380,"Rochester, NY MSA",2023,7,517927,500493,17434,3.4
MT3645060000000,36,45060,"Syracuse, NY MSA",2023,7,312688,301845,10843,3.5
MT3646540000000,36,46540,"Utica-Rome, NY MSA",2023,7,128109,123485,4624,3.6
MT3648060000000,36,48060,"Watertown-Fort Drum, NY MSA",2023,7,45316,43385,1931,4.3
MT3711700000000,37,11700,"Asheville, NC MSA",2023,7,211331,205355,5976,2.8
MT3715500000000,37,15500,"Burlington, NC MSA",2023,7,85904,82916,2988,3.5
MT3716740000000,37,16740,"Charlotte-Concord-Gastonia, NC-SC MSA",2023,7,1474845,1426384,48461,3.3
MT3720500000000,37,20500,"Durham-Chapel Hill, NC MSA",2023,7,321378,311427,9951,3.1
MT3722180000000,37,22180,"Fayetteville, NC MSA",2023,7,155280,148459,6821,4.4
MT3724140000000,37,24140,"Goldsboro, NC MSA",2023,7,50418,48573,1845,3.7
MT3724660000000,37,24660,"Greensboro-High Point, NC MSA",2023,7,371972,357627,14345,3.9
MT3724780000000,37,24780,"Greenville, NC MSA",2023,7,83577,80272,3305,4
MT3725860000000,37,25860,"Hickory-Lenoir-Morganton, NC MSA",2023,7,172854,166958,5896,3.4
MT3727340000000,37,27340,"Jacksonville, NC MSA",2023,7,74031,71351,2680,3.6
MT3738240000000,37,38240,"Pinehurst-Southern Pines, NC MSA",2023,7,44126,42613,1513,3.4
MT3739580000000,37,39580,"Raleigh-Cary, NC MSA",2023,7,835823,810879,24944,3
MT3740580000000,37,40580,"Rocky Mount, NC MSA",2023,7,63915,60915,3000,4.7
MT3748900000000,37,48900,"Wilmington, NC MSA",2023,7,221884,214038,7846,3.5
MT3749180000000,37,49180,"Winston-Salem, NC MSA",2023,7,326031,314562,11469,3.5
MT3813900000000,38,13900,"Bismarck, ND MSA",2023,7,72373,70872,1501,2.1
MT3822020000000,38,22020,"Fargo, ND-MN MSA",2023,7,152378,149469,2909,1.9
MT3824220000000,38,24220,"Grand Forks, ND-MN MSA",2023,7,55387,54183,1204,2.2
MT3833500000000,38,33500,"Minot, ND MSA",2023,7,39842,39012,830,2.1
MT3910420000000,39,10420,"Akron, OH MSA",2023,7,356910,343660,13250,3.7
MT3915940000000,39,15940,"Canton-Massillon, OH MSA",2023,7,191246,183695,7551,3.9
MT3917140000000,39,17140,"Cincinnati, OH-KY-IN MSA",2023,7,1161519,1121811,39708,3.4
MT3917410000000,39,17410,"Cleveland, OH MSA",2023,7,1084729,1045704,39025,3.6
MT3918140000000,39,18140,"Columbus, OH MSA",2023,7,1138375,1101793,36582,3.2
MT3919430000000,39,19430,"Dayton-Kettering-Beavercreek, OH MSA",2023,7,387709,373293,14416,3.7
MT3930620000000,39,30620,"Lima, OH MSA",2023,7,47341,45491,1850,3.9
MT3931900000000,39,31900,"Mansfield, OH MSA",2023,7,52755,50534,2221,4.2
MT3941780000000,39,41780,"Sandusky, OH MSA",2023,7,57253,54465,2788,4.9
MT3944220000000,39,44220,"Springfield, OH MSA",2023,7,62036,59667,2369,3.8
MT3945780000000,39,45780,"Toledo, OH MSA",2023,7,294454,282770,11684,4
MT3948260000000,39,48260,"Weirton-Steubenville, WV-OH MSA",2023,7,52343,49732,2611,5
MT3949660000000,39,49660,"Youngstown-Warren, OH MSA",2023,7,189296,181362,7934,4.2
MT4021420000000,40,21420,"Enid, OK MSA",2023,7,28427,27577,850,3
MT4030020000000,40,30020,"Lawton, OK MSA",2023,7,51909,49910,1999,3.9
MT4036420000000,40,36420,"Oklahoma City, OK MSA",2023,7,760658,738138,22520,3
MT4046140000000,40,46140,"Tulsa, OK MSA",2023,7,517392,500728,16664,3.2
MT4110540000000,41,10540,"Albany, OR MSA",2023,7,61356,58886,2470,4
MT4113460000000,41,13460,"Bend, OR MSA",2023,7,130135,125033,5102,3.9
MT4118700000000,41,18700,"Corvallis, OR MSA",2023,7,49113,47632,1481,3
MT4121660000000,41,21660,"Eugene-Springfield, OR MSA",2023,7,186282,179282,7000,3.8
MT4124420000000,41,24420,"Grants Pass, OR MSA",2023,7,34777,33008,1769,5.1
MT4132780000000,41,32780,"Medford, OR MSA",2023,7,104838,100340,4498,4.3
MT4138900000000,41,38900,"Portland-Vancouver-Hillsboro, OR-WA MSA",2023,7,1375423,1328095,47328,3.4
MT4141420000000,41,41420,"Salem, OR MSA",2023,7,216562,208734,7828,3.6
MT4210900000000,42,10900,"Allentown-Bethlehem-Easton, PA-NJ MSA",2023,7,448828,431182,17646,3.9
MT4211020000000,42,11020,"Altoona, PA MSA",2023,7,57346,55295,2051,3.6
MT4216540000000,42,16540,"Chambersburg, PA MSA",2023,7,76584,74247,2337,3.1
MT4221500000000,42,21500,"Erie, PA MSA",2023,7,127291,122047,5244,4.1
MT4223900000000,42,23900,"Gettysburg, PA MSA",2023,7,52451,50893,1558,3
MT4225420000000,42,25420,"Harrisburg-Carlisle, PA MSA",2023,7,311647,301879,9768,3.1
MT4227780000000,42,27780,"Johnstown, PA MSA",2023,7,57057,54656,2401,4.2
MT4229540000000,42,29540,"Lancaster, PA MSA",2023,7,292613,284245,8368,2.9
MT4230140000000,42,30140,"Lebanon, PA MSA",2023,7,73658,71371,2287,3.1
MT4237980000000,42,37980,"Philadelphia-Camden-Wilmington, PA-NJ-DE-MD MSA",2023,7,3286071,3165194,120877,3.7
MT4238300000000,42,38300,"Pittsburgh, PA MSA",2023,7,1232416,1188065,44351,3.6
MT4239740000000,42,39740,"Reading, PA MSA",2023,7,219083,211101,7982,3.6
MT4242540000000,42,42540,"Scranton--Wilkes-Barre, PA MSA",2023,7,279392,267276,12116,4.3
MT4244300000000,42,44300,"State College, PA MSA",2023,7,77680,75531,2149,2.8
MT4248700000000,42,48700,"Williamsport, PA MSA",2023,7,53048,50987,2061,3.9
MT4249620000000,42,49620,"York-Hanover, PA MSA",2023,7,239710,232152,7558,3.2
MT4439300000000,44,39300,"Providence-Warwick, RI-MA MSA",2023,7,880396,851979,28417,3.2
MT4516700000000,45,16700,"Charleston-North Charleston, SC MSA",2023,7,430893,420959,9934,2.3
MT4517900000000,45,17900,"Columbia, SC MSA",2023,7,410317,399778,10539,2.6
MT4522500000000,45,22500,"Florence, SC MSA",2023,7,91116,88383,2733,3
MT4524860000000,45,24860,"Greenville-Anderson-Greer, SC MSA",2023,7,467821,456052,11769,2.5
MT4525940000000,45,25940,"Hilton Head Island-Bluffton-Port Royal, SC MSA",2023,7,96496,94090,2406,2.5
MT4534820000000,45,34820,"Myrtle Beach-Conway-North Myrtle Beach, SC MSA",2023,7,165909,160582,5327,3.2
MT4543900000000,45,43900,"Spartanburg, SC MSA",2023,7,172495,167580,4915,2.8
MT4544940000000,45,44940,"Sumter, SC MSA",2023,7,41259,39859,1400,3.4
MT4639660000000,46,39660,"Rapid City, SD MSA",2023,7,78679,77249,1430,1.8
MT4643620000000,46,43620,"Sioux Falls, SD-MN MSA",2023,7,171663,168780,2883,1.7
MT4716860000000,47,16860,"Chattanooga, TN-GA MSA",2023,7,286493,277671,8822,3.1
MT4717300000000,47,17300,"Clarksville, TN-KY MSA",2023,7,135872,130702,5170,3.8
MT4717420000000,47,17420,"Cleveland, TN MSA",2023,7,56947,54956,1991,3.5
MT4727180000000,47,27180,"Jackson, TN MSA",2023,7,77982,75303,2679,3.4
MT4727740000000,47,27740,"Johnson City, TN MSA",2023,7,96297,93120,3177,3.3
MT4728700000000,47,28700,"Kingsport-Bristol, TN-VA MSA",2023,7,132665,128187,4478,3.4
MT4728940000000,47,28940,"Knoxville, TN MSA",2023,7,445855,432406,13449,3
MT4732820000000,47,32820,"Memphis, TN-MS-AR MSA",2023,7,623210,599947,23263,3.7
MT4734100000000,47,34100,"Morristown, TN MSA",2023,7,52749,50911,1838,3.5
MT4734980000000,47,34980,"Nashville-Davidson--Murfreesboro--Franklin, TN MSA",2023,7,1144700,1114877,29823,2.6
MT4810180000000,48,10180,"Abilene, TX MSA",2023,7,84825,81924,2901,3.4
MT4811100000000,48,11100,"Amarillo, TX MSA",2023,7,134884,130594,4290,3.2
MT4812420000000,48,12420,"Austin-Round Rock-San Marcos, TX MSA",2023,7,1459805,1408287,51518,3.5
MT4813140000000,48,13140,"Beaumont-Port Arthur, TX MSA",2023,7,175236,165532,9704,5.5
MT4815180000000,48,15180,"Brownsville-Harlingen, TX MSA",2023,7,185364,175552,9812,5.3
MT4817780000000,48,17780,"College Station-Bryan, TX MSA",2023,7,146411,141436,4975,3.4
MT4818580000000,48,18580,"Corpus Christi, TX MSA",2023,7,206993,198211,8782,4.2
MT4819100000000,48,19100,"Dallas-Fort Worth-Arlington, TX MSA",2023,7,4387366,4220849,166517,3.8
MT4820580000000,48,20580,"Eagle Pass, TX MSA",2023,7,23761,22023,1738,7.3
MT4821340000000,48,21340,"El Paso, TX MSA",2023,7,401734,384559,17175,4.3
MT4826420000000,48,26420,"Houston-Pasadena-The Woodlands, TX MSA",2023,7,3741649,3584178,157471,4.2
MT4828660000000,48,28660,"Killeen-Temple, TX MSA",2023,7,197694,189291,8403,4.3
MT4829700000000,48,29700,"Laredo, TX MSA",2023,7,115674,111084,4590,4
MT4830980000000,48,30980,"Longview, TX MSA",2023,7,128520,123023,5497,4.3
MT4831180000000,48,31180,"Lubbock, TX MSA",2023,7,179724,173660,6064,3.4
MT4832580000000,48,32580,"McAllen-Edinburg-Mission, TX MSA",2023,7,387652,364233,23419,6
MT4833260000000,48,33260,"Midland, TX MSA",2023,7,99617,96826,2791,2.8
MT4836220000000,48,36220,"Odessa, TX MSA",2023,7,83199,80468,2731,3.3
MT4841660000000,48,41660,"San Angelo, TX MSA",2023,7,60684,58670,2014,3.3
MT4841700000000,48,41700,"San Antonio-New Braunfels, TX MSA",2023,7,1302147,1253320,48827,3.7
MT4843300000000,48,43300,"Sherman-Denison, TX MSA",2023,7,69759,67109,2650,3.8
MT4845500000000,48,45500,"Texarkana, TX-AR MSA",2023,7,60917,58469,2448,4
MT4846340000000,48,46340,"Tyler, TX MSA",2023,7,115605,111310,4295,3.7
MT4847020000000,48,47020,"Victoria, TX MSA",2023,7,44741,42971,1770,4
MT4847380000000,48,47380,"Waco, TX MSA",2023,7,143586,138298,5288,3.7
MT4848660000000,48,48660,"Wichita Falls, TX MSA",2023,7,66383,63931,2452,3.7
MT4930860000000,49,30860,"Logan, UT-ID MSA",2023,7,79225,77339,1886,2.4
MT4936260000000,49,36260,"Ogden, UT MSA",2023,7,347000,338237,8763,2.5
MT4939340000000,49,39340,"Provo-Orem-Lehi, UT MSA",2023,7,363562,353802,9760,2.7
MT4941100000000,49,41100,"St. George, UT MSA",2023,7,90667,88008,2659,2.9
MT4941620000000,49,41620,"Salt Lake City-Murray, UT MSA",2023,7,726615,706890,19725,2.7
MT5015540000000,50,15540,"Burlington-South Burlington, VT MSA",2023,7,130294,128270,2024,1.6
MT5113980000000,51,13980,"Blacksburg-Christiansburg-Radford, VA MSA",2023,7,93343,90791,2552,2.7
MT5116820000000,51,16820,"Charlottesville, VA MSA",2023,7,118676,115850,2826,2.4
MT5125500000000,51,25500,"Harrisonburg, VA MSA",2023,7,72615,70781,1834,2.5
MT5131340000000,51,31340,"Lynchburg, VA MSA",2023,7,128415,124545,3870,3
MT5140060000000,51,40060,"Richmond, VA MSA",2023,7,723784,703583,20201,2.8
MT5140220000000,51,40220,"Roanoke, VA MSA",2023,7,157666,153432,4234,2.7
MT5144420000000,51,44420,"Staunton-Stuarts Draft, VA MSA",2023,7,65560,64000,1560,2.4
MT5147260000000,51,47260,"Virginia Beach-Chesapeake-Norfolk, VA-NC MSA",2023,7,880580,855392,25188,2.9
MT5149020000000,51,49020,"Winchester, VA-WV MSA",2023,7,77130,75117,2013,2.6
MT5313380000000,53,13380,"Bellingham, WA MSA",2023,7,113524,109097,4427,3.9
MT5314740000000,53,14740,"Bremerton-Silverdale-Port Orchard, WA MSA",2023,7,121595,116882,4713,3.9
MT5328420000000,53,28420,"Kennewick-Richland, WA MSA",2023,7,143852,137059,6793,4.7
MT5331020000000,53,31020,"Longview-Kelso, WA MSA",2023,7,47196,44996,2200,4.7
MT5334580000000,53,34580,"Mount Vernon-Anacortes, WA MSA",2023,7,58154,55570,2584,4.4
MT5336500000000,53,36500,"Olympia-Lacey-Tumwater, WA MSA",2023,7,141484,136004,5480,3.9
MT5342660000000,53,42660,"Seattle-Tacoma-Bellevue, WA MSA",2023,7,2314423,2222294,92129,4
MT5344060000000,53,44060,"Spokane-Spokane Valley, WA MSA",2023,7,280525,269207,11318,4
MT5347460000000,53,47460,"Walla Walla, WA MSA",2023,7,29254,28138,1116,3.8
MT5348300000000,53,48300,"Wenatchee-East Wenatchee, WA MSA",2023,7,61230,58596,2634,4.3
MT5349420000000,53,49420,"Yakima, WA MSA",2023,7,126117,119350,6767,5.4
MT5413220000000,54,13220,"Beckley, WV MSA",2023,7,46159,44266,1893,4.1
MT5416620000000,54,16620,"Charleston, WV MSA",2023,7,91479,87951,3528,3.9
MT5426580000000,54,26580,"Huntington-Ashland, WV-KY-OH MSA",2023,7,155876,148852,7024,4.5
MT5434060000000,54,34060,"Morgantown, WV MSA",2023,7,71499,69095,2404,3.4
MT5437620000000,54,37620,"Parkersburg-Vienna, WV MSA",2023,7,39539,37926,1613,4.1
MT5448540000000,54,48540,"Wheeling, WV-OH MSA",2023,7,59643,56962,2681,4.5
MT5511540000000,55,11540,"Appleton, WI MSA",2023,7,136845,133367,3478,2.5
MT5520740000000,55,20740,"Eau Claire, WI MSA",2023,7,95636,92844,2792,2.9
MT5522540000000,55,22540,"Fond du Lac, WI MSA",2023,7,56161,54704,1457,2.6
MT5524580000000,55,24580,"Green Bay, WI MSA",2023,7,177836,173052,4784,2.7
MT5527500000000,55,27500,"Janesville-Beloit, WI MSA",2023,7,86667,83708,2959,3.4
MT5528450000000,55,28450,"Kenosha, WI MSA",2023,7,94676,91713,2963,3.1
MT5529100000000,55,29100,"La Crosse-Onalaska, WI-MN MSA",2023,7,90513,88091,2422,2.7
MT5531540000000,55,31540,"Madison, WI MSA",2023,7,406400,396715,9685,2.4
MT5533340000000,55,33340,"Milwaukee-Waukesha, WI MSA",2023,7,817666,792274,25392,3.1
MT5536780000000,55,36780,"Oshkosh-Neenah, WI MSA",2023,7,92735,90309,2426,2.6
MT5539540000000,55,39540,"Racine-Mount Pleasant, WI MSA",2023,7,101167,97752,3415,3.4
MT5543100000000,55,43100,"Sheboygan, WI MSA",2023,7,63269,61726,1543,2.4
MT5548140000000,55,48140,"Wausau, WI MSA",2023,7,74672,72669,2003,2.7
MT5616220000000,56,16220,"Casper, WY MSA",2023,7,42205,40997,1208,2.9
MT5616940000000,56,16940,"Cheyenne, WY MSA",2023,7,48754,47343,1411,2.9
MT7210380000000,72,10380,"Aguadilla, PR MSA",2023,7,87927,81291,6636,7.5
MT7211640000000,72,11640,"Arecibo, PR MSA",2023,7,65815,61562,4253,6.5
MT7225020000000,72,25020,"Guayama, PR MSA",2023,7,18794,16979,1815,9.7
MT7232420000000,72,32420,"Mayaguez, PR MSA",2023,7,65092,60097,4995,7.7
MT7238660000000,72,38660,"Ponce, PR MSA",2023,7,87569,79510,8059,9.2
MT7241980000000,72,41980,"San Juan-Bayamon-Caguas, PR MSA",2023,7,798359,757685,40674,5.1
MT0111500000000,1,11500,"Anniston-Oxford, AL MSA",2023,8,49250,47941,1309,2.7
MT0112220000000,1,12220,"Auburn-Opelika, AL MSA",2023,8,94836,92649,2187,2.3
MT0113820000000,1,13820,"Birmingham, AL MSA",2023,8,564372,551432,12940,2.3
MT0119300000000,1,19300,"Daphne-Fairhope-Foley, AL MSA",2023,8,113380,110829,2551,2.2
MT0119460000000,1,19460,"Decatur, AL MSA",2023,8,74094,72474,1620,2.2
MT0120020000000,1,20020,"Dothan, AL MSA",2023,8,67315,65597,1718,2.6
MT0122520000000,1,22520,"Florence-Muscle Shoals, AL MSA",2023,8,68304,66441,1863,2.7
MT0123460000000,1,23460,"Gadsden, AL MSA",2023,8,41285,40195,1090,2.6
MT0126620000000,1,26620,"Huntsville, AL MSA",2023,8,269537,264015,5522,2
MT0133660000000,1,33660,"Mobile, AL MSA",2023,8,182864,177250,5614,3.1
MT0133860000000,1,33860,"Montgomery, AL MSA",2023,8,174262,169811,4451,2.6
MT0146220000000,1,46220,"Tuscaloosa, AL MSA",2023,8,125111,121817,3294,2.6
MT0211260000000,2,11260,"Anchorage, AK MSA",2023,8,199990,191989,8001,4
MT0221820000000,2,21820,"Fairbanks-College, AK MSA",2023,8,45136,43393,1743,3.9
MT0422380000000,4,22380,"Flagstaff, AZ MSA",2023,8,74180,71100,3080,4.2
MT0429420000000,4,29420,"Lake Havasu City-Kingman, AZ MSA",2023,8,86768,82866,3902,4.5
MT0438060000000,4,38060,"Phoenix-Mesa-Chandler, AZ MSA",2023,8,2680609,2590489,90120,3.4
MT0439150000000,4,39150,"Prescott Valley-Prescott, AZ MSA",2023,8,105665,101766,3899,3.7
MT0443420000000,4,43420,"Sierra Vista-Douglas, AZ MSA",2023,8,47932,45850,2082,4.3
MT0446060000000,4,46060,"Tucson, AZ MSA",2023,8,496331,477961,18370,3.7
MT0449740000000,4,49740,"Yuma, AZ MSA",2023,8,98555,86511,12044,12.2
MT0522220000000,5,22220,"Fayetteville-Springdale-Rogers, AR MSA",2023,8,298792,291176,7616,2.5
MT0522900000000,5,22900,"Fort Smith, AR-OK MSA",2023,8,101420,97749,3671,3.6
MT0526300000000,5,26300,"Hot Springs, AR MSA",2023,8,43772,42239,1533,3.5
MT0527860000000,5,27860,"Jonesboro, AR MSA",2023,8,65167,63239,1928,3
MT0530780000000,5,30780,"Little Rock-North Little Rock-Conway, AR MSA",2023,8,372855,361629,11226,3
MT0612540000000,6,12540,"Bakersfield-Delano, CA MSA",2023,8,402752,369550,33202,8.2
MT0617020000000,6,17020,"Chico, CA MSA",2023,8,90724,85963,4761,5.2
MT0620940000000,6,20940,"El Centro, CA MSA",2023,8,71993,59349,12644,17.6
MT0623420000000,6,23420,"Fresno, CA MSA",2023,8,530053,490107,39946,7.5
MT0625260000000,6,25260,"Hanford-Corcoran, CA MSA",2023,8,57118,52195,4923,8.6
MT0631080000000,6,31080,"Los Angeles-Long Beach-Anaheim, CA MSA",2023,8,6675108,6357499,317609,4.8
MT0632900000000,6,32900,"Merced, CA MSA",2023,8,119701,108772,10929,9.1
MT0633700000000,6,33700,"Modesto, CA MSA",2023,8,250334,234345,15989,6.4
MT0634900000000,6,34900,"Napa, CA MSA",2023,8,73447,70904,2543,3.5
MT0637100000000,6,37100,"Oxnard-Thousand Oaks-Ventura, CA MSA",2023,8,418661,400850,17811,4.3
MT0639820000000,6,39820,"Redding, CA MSA",2023,8,78381,74549,3832,4.9
MT0640140000000,6,40140,"Riverside-San Bernardino-Ontario, CA MSA",2023,8,2186227,2081857,104370,4.8
MT0640900000000,6,40900,"Sacramento-Roseville-Folsom, CA MSA",2023,8,1166341,1116391,49950,4.3
MT0641500000000,6,41500,"Salinas, CA MSA",2023,8,218986,203785,15201,6.9
MT0641740000000,6,41740,"San Diego-Chula Vista-Carlsbad, CA MSA",2023,8,1639279,1576875,62404,3.8
MT0641860000000,6,41860,"San Francisco-Oakland-Fremont, CA MSA",2023,8,2511447,2417639,93808,3.7
MT0641940000000,6,41940,"San Jose-Sunnyvale-Santa Clara, CA MSA",2023,8,1055997,1015768,40229,3.8
MT0642020000000,6,42020,"San Luis Obispo-Paso Robles, CA MSA",2023,8,132747,127931,4816,3.6
MT0642100000000,6,42100,"Santa Cruz-Watsonville, CA MSA",2023,8,135334,127754,7580,5.6
MT0642200000000,6,42200,"Santa Maria-Santa Barbara, CA MSA",2023,8,221364,212381,8983,4.1
MT0642220000000,6,42220,"Santa Rosa-Petaluma, CA MSA",2023,8,247084,238003,9081,3.7
MT0644700000000,6,44700,"Stockton-Lodi, CA MSA",2023,8,365447,343140,22307,6.1
MT0646700000000,6,46700,"Vallejo, CA MSA",2023,8,214743,205217,9526,4.4
MT0647300000000,6,47300,"Visalia, CA MSA",2023,8,218101,196631,21470,9.8
MT0649700000000,6,49700,"Yuba City, CA MSA",2023,8,80116,74310,5806,7.2
MT0814500000000,8,14500,"Boulder, CO MSA",2023,8,193862,187318,6544,3.4
MT0817820000000,8,17820,"Colorado Springs, CO MSA",2023,8,390628,376915,13713,3.5
MT0819740000000,8,19740,"Denver-Aurora-Centennial, CO MSA",2023,8,1763949,1703893,60056,3.4
MT0822660000000,8,22660,"Fort Collins-Loveland, CO MSA",2023,8,207137,200307,6830,3.3
MT0824300000000,8,24300,"Grand Junction, CO MSA",2023,8,78723,75781,2942,3.7
MT0824540000000,8,24540,"Greeley, CO MSA",2023,8,175151,168790,6361,3.6
MT0839380000000,8,39380,"Pueblo, CO MSA",2023,8,73609,70073,3536,4.8
MT0914860000000,9,14860,"Bridgeport-Stamford-Danbury, CT MSA",2023,8,508606,493072,15534,3.1
MT0925540000000,9,25540,"Hartford-West Hartford-East Hartford, CT MSA",2023,8,607526,588875,18651,3.1
MT0935300000000,9,35300,"New Haven, CT MSA",2023,8,310648,301124,9524,3.1
MT0935980000000,9,35980,"Norwich-New London-Willimantic, CT MSA",2023,8,140325,135914,4411,3.1
MT0947930000000,9,47930,"Waterbury-Shelton, CT MSA",2023,8,237954,229457,8497,3.6
MT1020100000000,10,20100,"Dover, DE MSA",2023,8,85661,82111,3550,4.1
MT1147900000000,11,47900,"Washington-Arlington-Alexandria, DC-VA-MD-WV MSA",2023,8,3519762,3431591,88171,2.5
MT1215980000000,12,15980,"Cape Coral-Fort Myers, FL MSA",2023,8,373330,361155,12175,3.3
MT1218880000000,12,18880,"Crestview-Fort Walton Beach-Destin, FL MSA",2023,8,142474,138518,3956,2.8
MT1219660000000,12,19660,"Deltona-Daytona Beach-Ormond Beach, FL MSA",2023,8,319453,308129,11324,3.5
MT1223540000000,12,23540,"Gainesville, FL MSA",2023,8,169445,163712,5733,3.4
MT1226140000000,12,26140,"Homosassa Springs, FL MSA",2023,8,53824,51375,2449,4.6
MT1227260000000,12,27260,"Jacksonville, FL MSA",2023,8,849838,822820,27018,3.2
MT1229460000000,12,29460,"Lakeland-Winter Haven, FL MSA",2023,8,356624,343271,13353,3.7
MT1233100000000,12,33100,"Miami-Fort Lauderdale-West Palm Beach, FL MSA",2023,8,3278054,3196697,81357,2.5
MT1234940000000,12,34940,"Naples-Marco Island, FL MSA",2023,8,182985,177522,5463,3
MT1235840000000,12,35840,"North Port-Bradenton-Sarasota, FL MSA",2023,8,393618,381119,12499,3.2
MT1236100000000,12,36100,"Ocala, FL MSA",2023,8,156752,150756,5996,3.8
MT1236740000000,12,36740,"Orlando-Kissimmee-Sanford, FL MSA",2023,8,1519034,1473695,45339,3
MT1237340000000,12,37340,"Palm Bay-Melbourne-Titusville, FL MSA",2023,8,304575,294970,9605,3.2
MT1237460000000,12,37460,"Panama City-Panama City Beach, FL MSA",2023,8,100819,97755,3064,3
MT1237860000000,12,37860,"Pensacola-Ferry Pass-Brent, FL MSA",2023,8,240635,233115,7520,3.1
MT1238940000000,12,38940,"Port St. Lucie, FL MSA",2023,8,238956,230711,8245,3.5
MT1239460000000,12,39460,"Punta Gorda, FL MSA",2023,8,75451,72642,2809,3.7
MT1242680000000,12,42680,"Sebastian-Vero Beach-West Vero Corridor, FL MSA",2023,8,68025,65539,2486,3.7
MT1242700000000,12,42700,"Sebring, FL MSA",2023,8,36609,34997,1612,4.4
MT1245220000000,12,45220,"Tallahassee, FL MSA",2023,8,205002,198531,6471,3.2
MT1245300000000,12,45300,"Tampa-St. Petersburg-Clearwater, FL MSA",2023,8,1698088,1645731,52357,3.1
MT1248680000000,12,48680,"Wildwood-The Villages, FL MSA",2023,8,33831,31916,1915,5.7
MT1310500000000,13,10500,"Albany, GA MSA",2023,8,62428,60038,2390,3.8
MT1312020000000,13,12020,"Athens-Clarke County, GA MSA",2023,8,107209,104031,3178,3
MT1312060000000,13,12060,"Atlanta-Sandy Springs-Roswell, GA MSA",2023,8,3276202,3170274,105928,3.2
MT1312260000000,13,12260,"Augusta-Richmond County, GA-SC MSA",2023,8,266043,256217,9826,3.7
MT1315260000000,13,15260,"Brunswick-St. Simons, GA MSA",2023,8,54898,53312,1586,2.9
MT1317980000000,13,17980,"Columbus, GA-AL MSA",2023,8,130038,125332,4706,3.6
MT1319140000000,13,19140,"Dalton, GA MSA",2023,8,67443,65111,2332,3.5
MT1323580000000,13,23580,"Gainesville, GA MSA",2023,8,108378,105527,2851,2.6
MT1325980000000,13,25980,"Hinesville, GA MSA",2023,8,31128,29938,1190,3.8
MT1331420000000,13,31420,"Macon-Bibb County, GA MSA",2023,8,97352,93641,3711,3.8
MT1340660000000,13,40660,"Rome, GA MSA",2023,8,47953,46435,1518,3.2
MT1342340000000,13,42340,"Savannah, GA MSA",2023,8,207566,201510,6056,2.9
MT1346660000000,13,46660,"Valdosta, GA MSA",2023,8,61573,59350,2223,3.6
MT1347580000000,13,47580,"Warner Robins, GA MSA",2023,8,89722,87041,2681,3
MT1527980000000,15,27980,"Kahului-Wailuku, HI MSA",2023,8,82766,78649,4117,5
MT1546520000000,15,46520,"Urban Honolulu, HI MSA",2023,8,468430,456697,11733,2.5
MT1614260000000,16,14260,"Boise City, ID MSA",2023,8,438789,424997,13792,3.1
MT1617660000000,16,17660,"Coeur d'Alene, ID MSA",2023,8,89290,85861,3429,3.8
MT1626820000000,16,26820,"Idaho Falls, ID MSA",2023,8,83722,81392,2330,2.8
MT1630300000000,16,30300,"Lewiston, ID-WA MSA",2023,8,30827,29812,1015,3.3
MT1638540000000,16,38540,"Pocatello, ID MSA",2023,8,40122,38664,1458,3.6
MT1646300000000,16,46300,"Twin Falls, ID MSA",2023,8,59504,57566,1938,3.3
MT1714010000000,17,14010,"Bloomington, IL MSA",2023,8,95268,91607,3661,3.8
MT1716580000000,17,16580,"Champaign-Urbana, IL MSA",2023,8,125046,119569,5477,4.4
MT1716980000000,17,16980,"Chicago-Naperville-Elgin, IL-IN MSA",2023,8,4907920,4684810,223110,4.5
MT1719340000000,17,19340,"Davenport-Moline-Rock Island, IA-IL MSA",2023,8,190124,181508,8616,4.5
MT1719500000000,17,19500,"Decatur, IL MSA",2023,8,44735,41914,2821,6.3
MT1728100000000,17,28100,"Kankakee, IL MSA",2023,8,51101,47966,3135,6.1
MT1737900000000,17,37900,"Peoria, IL MSA",2023,8,176196,167360,8836,5
MT1740420000000,17,40420,"Rockford, IL MSA",2023,8,161239,150816,10423,6.5
MT1744100000000,17,44100,"Springfield, IL MSA",2023,8,101630,96979,4651,4.6
MT1814020000000,18,14020,"Bloomington, IN MSA",2023,8,84748,82127,2621,3.1
MT1818020000000,18,18020,"Columbus, IN MSA",2023,8,39477,38188,1289,3.3
MT1821140000000,18,21140,"Elkhart-Goshen, IN MSA",2023,8,99991,95345,4646,4.6
MT1821780000000,18,21780,"Evansville, IN MSA",2023,8,134761,130375,4386,3.3
MT1823060000000,18,23060,"Fort Wayne, IN MSA",2023,8,229850,222517,7333,3.2
MT1826900000000,18,26900,"Indianapolis-Carmel-Greenwood, IN MSA",2023,8,1119322,1083700,35622,3.2
MT1829020000000,18,29020,"Kokomo, IN MSA",2023,8,35198,33589,1609,4.6
MT1829200000000,18,29200,"Lafayette-West Lafayette, IN MSA",2023,8,119826,116341,3485,2.9
MT1833140000000,18,33140,"Michigan City-La Porte, IN MSA",2023,8,51368,49369,1999,3.9
MT1834620000000,18,34620,"Muncie, IN MSA",2023,8,51715,49650,2065,4
MT1843780000000,18,43780,"South Bend-Mishawaka, IN-MI MSA",2023,8,154704,148163,6541,4.2
MT1845460000000,18,45460,"Terre Haute, IN MSA",2023,8,76711,73915,2796,3.6
MT1911180000000,19,11180,"Ames, IA MSA",2023,8,69539,67890,1649,2.4
MT1916300000000,19,16300,"Cedar Rapids, IA MSA",2023,8,147782,142946,4836,3.3
MT1919780000000,19,19780,"Des Moines-West Des Moines, IA MSA",2023,8,409209,398028,11181,2.7
MT1920220000000,19,20220,"Dubuque, IA MSA",2023,8,53563,51931,1632,3
MT1926980000000,19,26980,"Iowa City, IA MSA",2023,8,99355,96884,2471,2.5
MT1943580000000,19,43580,"Sioux City, IA-NE-SD MSA",2023,8,77058,74852,2206,2.9
MT1947940000000,19,47940,"Waterloo-Cedar Falls, IA MSA",2023,8,88981,86355,2626,3
MT2029940000000,20,29940,"Lawrence, KS MSA",2023,8,70253,68446,1807,2.6
MT2031740000000,20,31740,"Manhattan, KS MSA",2023,8,63385,61673,1712,2.7
MT2045820000000,20,45820,"Topeka, KS MSA",2023,8,118081,114543,3538,3
MT2048620000000,20,48620,"Wichita, KS MSA",2023,8,332084,321892,10192,3.1
MT2114540000000,21,14540,"Bowling Green, KY MSA",2023,8,90758,87036,3722,4.1
MT2121060000000,21,21060,"Elizabethtown, KY MSA",2023,8,54475,52089,2386,4.4
MT2130460000000,21,30460,"Lexington-Fayette, KY MSA",2023,8,272516,262561,9955,3.7
MT2131140000000,21,31140,"Louisville/Jefferson County, KY-IN MSA",2023,8,689015,662733,26282,3.8
MT2136980000000,21,36980,"Owensboro, KY MSA",2023,8,50816,48575,2241,4.4
MT2137140000000,21,37140,"Paducah, KY-IL MSA",2023,8,45763,43657,2106,4.6
MT2210780000000,22,10780,"Alexandria, LA MSA",2023,8,64268,62150,2118,3.3
MT2212940000000,22,12940,"Baton Rouge, LA MSA",2023,8,420637,406127,14510,3.4
MT2225220000000,22,25220,"Hammond, LA MSA",2023,8,60005,57557,2448,4.1
MT2226380000000,22,26380,"Houma-Bayou Cane-Thibodaux, LA MSA",2023,8,88420,85705,2715,3.1
MT2229180000000,22,29180,"Lafayette, LA MSA",2023,8,196275,190164,6111,3.1
MT2229340000000,22,29340,"Lake Charles, LA MSA",2023,8,97464,93862,3602,3.7
MT2233740000000,22,33740,"Monroe, LA MSA",2023,8,95943,91953,3990,4.2
MT2235380000000,22,35380,"New Orleans-Metairie, LA MSA",2023,8,466618,448897,17721,3.8
MT2243340000000,22,43340,"Shreveport-Bossier City, LA MSA",2023,8,168520,162258,6262,3.7
MT2243640000000,22,43640,"Slidell-Mandeville-Covington, LA MSA",2023,8,128385,124342,4043,3.1
MT2312620000000,23,12620,"Bangor, ME MSA",2023,8,74556,72331,2225,3
MT2330340000000,23,30340,"Lewiston-Auburn, ME MSA",2023,8,55026,53504,1522,2.8
MT2338860000000,23,38860,"Portland-South Portland, ME MSA",2023,8,309406,302165,7241,2.3
MT2412580000000,24,12580,"Baltimore-Columbia-Towson, MD MSA",2023,8,1475893,1444313,31580,2.1
MT2425180000000,24,25180,"Hagerstown-Martinsburg, MD-WV MSA",2023,8,142659,138420,4239,3
MT2430500000000,24,30500,"Lexington Park, MD MSA",2023,8,107101,105061,2040,1.9
MT2441540000000,24,41540,"Salisbury, MD MSA",2023,8,63835,62236,1599,2.5
MT2511200000000,25,11200,"Amherst Town-Northampton, MA MSA",2023,8,83523,80865,2658,3.2
MT2512700000000,25,12700,"Barnstable Town, MA MSA",2023,8,114451,109434,5017,4.4
MT2514460000000,25,14460,"Boston-Cambridge-Newton, MA-NH MSA",2023,8,2769180,2682476,86704,3.1
MT2538340000000,25,38340,"Pittsfield, MA MSA",2023,8,63600,61283,2317,3.6
MT2544140000000,25,44140,"Springfield, MA MSA",2023,8,220634,211019,9615,4.4
MT2549340000000,25,49340,"Worcester, MA MSA",2023,8,456841,440943,15898,3.5
MT2611460000000,26,11460,"Ann Arbor, MI MSA",2023,8,206648,200127,6521,3.2
MT2612980000000,26,12980,"Battle Creek, MI MSA",2023,8,62312,59649,2663,4.3
MT2613020000000,26,13020,"Bay City, MI MSA",2023,8,50134,47682,2452,4.9
MT2619820000000,26,19820,"Detroit-Warren-Dearborn, MI MSA",2023,8,2185834,2104148,81686,3.7
MT2622420000000,26,22420,"Flint, MI MSA",2023,8,187250,178283,8967,4.8
MT2624340000000,26,24340,"Grand Rapids-Wyoming-Kentwood, MI MSA",2023,8,627608,606213,21395,3.4
MT2627100000000,26,27100,"Jackson, MI MSA",2023,8,75279,72194,3085,4.1
MT2628020000000,26,28020,"Kalamazoo-Portage, MI MSA",2023,8,139140,134131,5009,3.6
MT2629620000000,26,29620,"Lansing-East Lansing, MI MSA",2023,8,251975,242803,9172,3.6
MT2633220000000,26,33220,"Midland, MI MSA",2023,8,42608,41014,1594,3.7
MT2633780000000,26,33780,"Monroe, MI MSA",2023,8,78397,75180,3217,4.1
MT2634740000000,26,34740,"Muskegon-Norton Shores, MI MSA",2023,8,84019,80443,3576,4.3
MT2635660000000,26,35660,"Niles, MI MSA",2023,8,76143,72997,3146,4.1
MT2640980000000,26,40980,"Saginaw, MI MSA",2023,8,85066,80785,4281,5
MT2645900000000,26,45900,"Traverse City, MI MSA",2023,8,80898,77704,3194,3.9
MT2720260000000,27,20260,"Duluth, MN-WI MSA",2023,8,139921,135115,4806,3.4
MT2731860000000,27,31860,"Mankato, MN MSA",2023,8,60216,58831,1385,2.3
MT2733460000000,27,33460,"Minneapolis-St. Paul-Bloomington, MN-WI MSA",2023,8,2066287,2011485,54802,2.7
MT2740340000000,27,40340,"Rochester, MN MSA",2023,8,125743,122732,3011,2.4
MT2741060000000,27,41060,"St. Cloud, MN MSA",2023,8,109582,106272,3310,3
MT2825060000000,28,25060,"Gulfport-Biloxi, MS MSA",2023,8,184354,179000,5354,2.9
MT2825620000000,28,25620,"Hattiesburg, MS MSA",2023,8,69828,67881,1947,2.8
MT2827140000000,28,27140,"Jackson, MS MSA",2023,8,276945,269267,7678,2.8
MT2916020000000,29,16020,"Cape Girardeau, MO-IL MSA",2023,8,48940,47461,1479,3
MT2917860000000,29,17860,"Columbia, MO MSA",2023,8,112197,109074,3123,2.8
MT2927620000000,29,27620,"Jefferson City, MO MSA",2023,8,75300,73180,2120,2.8
MT2927900000000,29,27900,"Joplin, MO-KS MSA",2023,8,97124,94104,3020,3.1
MT2928140000000,29,28140,"Kansas City, MO-KS MSA",2023,8,1185748,1149708,36040,3
MT2941140000000,29,41140,"St. Joseph, MO-KS MSA",2023,8,53883,52106,1777,3.3
MT2941180000000,29,41180,"St. Louis, MO-IL MSA",2023,8,1476719,1426010,50709,3.4
MT2944180000000,29,44180,"Springfield, MO MSA",2023,8,239785,232769,7016,2.9
MT3013740000000,30,13740,"Billings, MT MSA",2023,8,99047,96596,2451,2.5
MT3014580000000,30,14580,"Bozeman, MT MSA",2023,8,75982,74336,1646,2.2
MT3024500000000,30,24500,"Great Falls, MT MSA",2023,8,39771,38696,1075,2.7
MT3025740000000,30,25740,"Helena, MT MSA",2023,8,46960,45741,1219,2.6
MT3033540000000,30,33540,"Missoula, MT MSA",2023,8,73848,71914,1934,2.6
MT3124260000000,31,24260,"Grand Island, NE MSA",2023,8,42318,41356,962,2.3
MT3130700000000,31,30700,"Lincoln, NE MSA",2023,8,191844,187550,4294,2.2
MT3136540000000,31,36540,"Omaha, NE-IA MSA",2023,8,522793,509185,13608,2.6
MT3216180000000,32,16180,"Carson City, NV MSA",2023,8,28893,27604,1289,4.5
MT3229820000000,32,29820,"Las Vegas-Henderson-North Las Vegas, NV MSA",2023,8,1191245,1127061,64184,5.4
MT3239900000000,32,39900,"Reno, NV MSA",2023,8,297111,283732,13379,4.5
MT3331700000000,33,31700,"Manchester-Nashua, NH MSA",2023,8,239506,233926,5580,2.3
MT3412100000000,34,12100,"Atlantic City-Hammonton, NJ MSA",2023,8,180570,169461,11109,6.2
MT3445940000000,34,45940,"Trenton-Princeton, NJ MSA",2023,8,198572,190013,8559,4.3
MT3447220000000,34,47220,"Vineland, NJ MSA",2023,8,66038,61391,4647,7
MT3510740000000,35,10740,"Albuquerque, NM MSA",2023,8,458657,442628,16029,3.5
MT3522140000000,35,22140,"Farmington, NM MSA",2023,8,49452,47416,2036,4.1
MT3529740000000,35,29740,"Las Cruces, NM MSA",2023,8,100873,96447,4426,4.4
MT3542140000000,35,42140,"Santa Fe, NM MSA",2023,8,73749,71215,2534,3.4
MT3610580000000,36,10580,"Albany-Schenectady-Troy, NY MSA",2023,8,460162,445361,14801,3.2
MT3613780000000,36,13780,"Binghamton, NY MSA",2023,8,107318,103272,4046,3.8
MT3615380000000,36,15380,"Buffalo-Cheektowaga, NY MSA",2023,8,563842,542958,20884,3.7
MT3621300000000,36,21300,"Elmira, NY MSA",2023,8,35773,34415,1358,3.8
MT3624020000000,36,24020,"Glens Falls, NY MSA",2023,8,59841,57722,2119,3.5
MT3627060000000,36,27060,"Ithaca, NY MSA",2023,8,48676,47148,1528,3.1
MT3628740000000,36,28740,"Kingston, NY MSA",2023,8,87842,84769,3073,3.5
MT3628880000000,36,28880,"Kiryas Joel-Poughkeepsie-Newburgh, NY MSA",2023,8,341298,329801,11497,3.4
MT3635620000000,36,35620,"New York-Newark-Jersey City, NY-NJ MSA",2023,8,10137302,9695568,441734,4.4
MT3640380000000,36,40380,"Rochester, NY MSA",2023,8,518198,500087,18111,3.5
MT3645060000000,36,45060,"Syracuse, NY MSA",2023,8,312996,301764,11232,3.6
MT3646540000000,36,46540,"Utica-Rome, NY MSA",2023,8,128208,123421,4787,3.7
MT3648060000000,36,48060,"Watertown-Fort Drum, NY MSA",2023,8,45330,43342,1988,4.4
MT3711700000000,37,11700,"Asheville, NC MSA",2023,8,211545,205461,6084,2.9
MT3715500000000,37,15500,"Burlington, NC MSA",2023,8,86016,82999,3017,3.5
MT3716740000000,37,16740,"Charlotte-Concord-Gastonia, NC-SC MSA",2023,8,1476791,1427657,49134,3.3
MT3720500000000,37,20500,"Durham-Chapel Hill, NC MSA",2023,8,321718,311647,10071,3.1
MT3722180000000,37,22180,"Fayetteville, NC MSA",2023,8,155623,148787,6836,4.4
MT3724140000000,37,24140,"Goldsboro, NC MSA",2023,8,50462,48596,1866,3.7
MT3724660000000,37,24660,"Greensboro-High Point, NC MSA",2023,8,372394,357958,14436,3.9
MT3724780000000,37,24780,"Greenville, NC MSA",2023,8,83839,80491,3348,4
MT3725860000000,37,25860,"Hickory-Lenoir-Morganton, NC MSA",2023,8,172891,166923,5968,3.5
MT3727340000000,37,27340,"Jacksonville, NC MSA",2023,8,74258,71553,2705,3.6
MT3738240000000,37,38240,"Pinehurst-Southern Pines, NC MSA",2023,8,44248,42715,1533,3.5
MT3739580000000,37,39580,"Raleigh-Cary, NC MSA",2023,8,837753,812448,25305,3
MT3740580000000,37,40580,"Rocky Mount, NC MSA",2023,8,63877,60872,3005,4.7
MT3748900000000,37,48900,"Wilmington, NC MSA",2023,8,222339,214418,7921,3.6
MT3749180000000,37,49180,"Winston-Salem, NC MSA",2023,8,326064,314487,11577,3.6
MT3813900000000,38,13900,"Bismarck, ND MSA",2023,8,72397,70895,1502,2.1
MT3822020000000,38,22020,"Fargo, ND-MN MSA",2023,8,152557,149646,2911,1.9
MT3824220000000,38,24220,"Grand Forks, ND-MN MSA",2023,8,55514,54295,1219,2.2
MT3833500000000,38,33500,"Minot, ND MSA",2023,8,39857,39010,847,2.1
MT3910420000000,39,10420,"Akron, OH MSA",2023,8,356924,343294,13630,3.8
MT3915940000000,39,15940,"Canton-Massillon, OH MSA",2023,8,191794,184017,7777,4.1
MT3917140000000,39,17140,"Cincinnati, OH-KY-IN MSA",2023,8,1162485,1121699,40786,3.5
MT3917410000000,39,17410,"Cleveland, OH MSA",2023,8,1086973,1047298,39675,3.7
MT3918140000000,39,18140,"Columbus, OH MSA",2023,8,1139989,1102363,37626,3.3
MT3919430000000,39,19430,"Dayton-Kettering-Beavercreek, OH MSA",2023,8,388368,373569,14799,3.8
MT3930620000000,39,30620,"Lima, OH MSA",2023,8,47272,45419,1853,3.9
MT3931900000000,39,31900,"Mansfield, OH MSA",2023,8,52853,50592,2261,4.3
MT3941780000000,39,41780,"Sandusky, OH MSA",2023,8,57261,54468,2793,4.9
MT3944220000000,39,44220,"Springfield, OH MSA",2023,8,62130,59690,2440,3.9
MT3945780000000,39,45780,"Toledo, OH MSA",2023,8,294656,282720,11936,4.1
MT3948260000000,39,48260,"Weirton-Steubenville, WV-OH MSA",2023,8,52221,49552,2669,5.1
MT3949660000000,39,49660,"Youngstown-Warren, OH MSA",2023,8,189845,181675,8170,4.3
MT4021420000000,40,21420,"Enid, OK MSA",2023,8,28494,27612,882,3.1
MT4030020000000,40,30020,"Lawton, OK MSA",2023,8,52063,50010,2053,3.9
MT4036420000000,40,36420,"Oklahoma City, OK MSA",2023,8,763146,739830,23316,3.1
MT4046140000000,40,46140,"Tulsa, OK MSA",2023,8,518901,501689,17212,3.3
MT4110540000000,41,10540,"Albany, OR MSA",2023,8,61374,58847,2527,4.1
MT4113460000000,41,13460,"Bend, OR MSA",2023,8,130342,125132,5210,4
MT4118700000000,41,18700,"Corvallis, OR MSA",2023,8,49086,47538,1548,3.2
MT4121660000000,41,21660,"Eugene-Springfield, OR MSA",2023,8,186552,179353,7199,3.9
MT4124420000000,41,24420,"Grants Pass, OR MSA",2023,8,34849,33027,1822,5.2
MT4132780000000,41,32780,"Medford, OR MSA",2023,8,105177,100555,4622,4.4
MT4138900000000,41,38900,"Portland-Vancouver-Hillsboro, OR-WA MSA",2023,8,1378234,1329130,49104,3.6
MT4141420000000,41,41420,"Salem, OR MSA",2023,8,217155,209111,8044,3.7
MT4210900000000,42,10900,"Allentown-Bethlehem-Easton, PA-NJ MSA",2023,8,449847,431814,18033,4
MT4211020000000,42,11020,"Altoona, PA MSA",2023,8,57475,55407,2068,3.6
MT4216540000000,42,16540,"Chambersburg, PA MSA",2023,8,76698,74335,2363,3.1
MT4221500000000,42,21500,"Erie, PA MSA",2023,8,127425,122125,5300,4.2
MT4223900000000,42,23900,"Gettysburg, PA MSA",2023,8,52567,51001,1566,3
MT4225420000000,42,25420,"Harrisburg-Carlisle, PA MSA",2023,8,312676,302706,9970,3.2
MT4227780000000,42,27780,"Johnstown, PA MSA",2023,8,57150,54722,2428,4.2
MT4229540000000,42,29540,"Lancaster, PA MSA",2023,8,293544,285109,8435,2.9
MT4230140000000,42,30140,"Lebanon, PA MSA",2023,8,73959,71645,2314,3.1
MT4237980000000,42,37980,"Philadelphia-Camden-Wilmington, PA-NJ-DE-MD MSA",2023,8,3292768,3170074,122694,3.7
MT4238300000000,42,38300,"Pittsburgh, PA MSA",2023,8,1235176,1190580,44596,3.6
MT4239740000000,42,39740,"Reading, PA MSA",2023,8,219748,211663,8085,3.7
MT4242540000000,42,42540,"Scranton--Wilkes-Barre, PA MSA",2023,8,280012,267897,12115,4.3
MT4244300000000,42,44300,"State College, PA MSA",2023,8,77749,75590,2159,2.8
MT4248700000000,42,48700,"Williamsport, PA MSA",2023,8,53193,51117,2076,3.9
MT4249620000000,42,49620,"York-Hanover, PA MSA",2023,8,240519,232869,7650,3.2
MT4439300000000,44,39300,"Providence-Warwick, RI-MA MSA",2023,8,883233,853867,29366,3.3
MT4516700000000,45,16700,"Charleston-North Charleston, SC MSA",2023,8,432518,422356,10162,2.3
MT4517900000000,45,17900,"Columbia, SC MSA",2023,8,411112,400353,10759,2.6
MT4522500000000,45,22500,"Florence, SC MSA",2023,8,91231,88452,2779,3
MT4524860000000,45,24860,"Greenville-Anderson-Greer, SC MSA",2023,8,469067,457028,12039,2.6
MT4525940000000,45,25940,"Hilton Head Island-Bluffton-Port Royal, SC MSA",2023,8,96759,94284,2475,2.6
MT4534820000000,45,34820,"Myrtle Beach-Conway-North Myrtle Beach, SC MSA",2023,8,166741,161314,5427,3.3
MT4543900000000,45,43900,"Spartanburg, SC MSA",2023,8,172996,167995,5001,2.9
MT4544940000000,45,44940,"Sumter, SC MSA",2023,8,41340,39908,1432,3.5
MT4639660000000,46,39660,"Rapid City, SD MSA",2023,8,78822,77381,1441,1.8
MT4643620000000,46,43620,"Sioux Falls, SD-MN MSA",2023,8,171937,169031,2906,1.7
MT4716860000000,47,16860,"Chattanooga, TN-GA MSA",2023,8,287088,278264,8824,3.1
MT4717300000000,47,17300,"Clarksville, TN-KY MSA",2023,8,136036,130767,5269,3.9
MT4717420000000,47,17420,"Cleveland, TN MSA",2023,8,56948,54943,2005,3.5
MT4727180000000,47,27180,"Jackson, TN MSA",2023,8,78096,75386,2710,3.5
MT4727740000000,47,27740,"Johnson City, TN MSA",2023,8,96454,93247,3207,3.3
MT4728700000000,47,28700,"Kingsport-Bristol, TN-VA MSA",2023,8,132813,128271,4542,3.4
MT4728940000000,47,28940,"Knoxville, TN MSA",2023,8,446561,432963,13598,3
MT4732820000000,47,32820,"Memphis, TN-MS-AR MSA",2023,8,623609,600136,23473,3.8
MT4734100000000,47,34100,"Morristown, TN MSA",2023,8,52818,50964,1854,3.5
MT4734980000000,47,34980,"Nashville-Davidson--Murfreesboro--Franklin, TN MSA",2023,8,1146656,1116384,30272,2.6
MT4810180000000,48,10180,"Abilene, TX MSA",2023,8,84992,82106,2886,3.4
MT4811100000000,48,11100,"Amarillo, TX MSA",2023,8,135299,131048,4251,3.1
MT4812420000000,48,12420,"Austin-Round Rock-San Marcos, TX MSA",2023,8,1463181,1411434,51747,3.5
MT4813140000000,48,13140,"Beaumont-Port Arthur, TX MSA",2023,8,175612,166080,9532,5.4
MT4815180000000,48,15180,"Brownsville-Harlingen, TX MSA",2023,8,185798,176072,9726,5.2
MT4817780000000,48,17780,"College Station-Bryan, TX MSA",2023,8,146906,141947,4959,3.4
MT4818580000000,48,18580,"Corpus Christi, TX MSA",2023,8,207284,198517,8767,4.2
MT4819100000000,48,19100,"Dallas-Fort Worth-Arlington, TX MSA",2023,8,4395233,4228148,167085,3.8
MT4820580000000,48,20580,"Eagle Pass, TX MSA",2023,8,23775,22055,1720,7.2
MT4821340000000,48,21340,"El Paso, TX MSA",2023,8,402913,385658,17255,4.3
MT4826420000000,48,26420,"Houston-Pasadena-The Woodlands, TX MSA",2023,8,3750541,3593220,157321,4.2
MT4828660000000,48,28660,"Killeen-Temple, TX MSA",2023,8,198141,189760,8381,4.2
MT4829700000000,48,29700,"Laredo, TX MSA",2023,8,115874,111303,4571,3.9
MT4830980000000,48,30980,"Longview, TX MSA",2023,8,128482,122946,5536,4.3
MT4831180000000,48,31180,"Lubbock, TX MSA",2023,8,180276,174225,6051,3.4
MT4832580000000,48,32580,"McAllen-Edinburg-Mission, TX MSA",2023,8,388678,365348,23330,6
MT4833260000000,48,33260,"Midland, TX MSA",2023,8,99929,97154,2775,2.8
MT4836220000000,48,36220,"Odessa, TX MSA",2023,8,83344,80612,2732,3.3
MT4841660000000,48,41660,"San Angelo, TX MSA",2023,8,60760,58776,1984,3.3
MT4841700000000,48,41700,"San Antonio-New Braunfels, TX MSA",2023,8,1305434,1256803,48631,3.7
MT4843300000000,48,43300,"Sherman-Denison, TX MSA",2023,8,70039,67388,2651,3.8
MT4845500000000,48,45500,"Texarkana, TX-AR MSA",2023,8,60927,58489,2438,4
MT4846340000000,48,46340,"Tyler, TX MSA",2023,8,115691,111438,4253,3.7
MT4847020000000,48,47020,"Victoria, TX MSA",2023,8,44684,42920,1764,3.9
MT4847380000000,48,47380,"Waco, TX MSA",2023,8,143930,138696,5234,3.6
MT4848660000000,48,48660,"Wichita Falls, TX MSA",2023,8,66355,63919,2436,3.7
MT4930860000000,49,30860,"Logan, UT-ID MSA",2023,8,79238,77300,1938,2.4
MT4936260000000,49,36260,"Ogden, UT MSA",2023,8,347880,338931,8949,2.6
MT4939340000000,49,39340,"Provo-Orem-Lehi, UT MSA",2023,8,364386,354337,10049,2.8
MT4941100000000,49,41100,"St. George, UT MSA",2023,8,90993,88265,2728,3
MT4941620000000,49,41620,"Salt Lake City-Murray, UT MSA",2023,8,728002,707833,20169,2.8
MT5015540000000,50,15540,"Burlington-South Burlington, VT MSA",2023,8,130579,128527,2052,1.6
MT5113980000000,51,13980,"Blacksburg-Christiansburg-Radford, VA MSA",2023,8,93883,91278,2605,2.8
MT5116820000000,51,16820,"Charlottesville, VA MSA",2023,8,119063,116200,2863,2.4
MT5125500000000,51,25500,"Harrisonburg, VA MSA",2023,8,72623,70758,1865,2.6
MT5131340000000,51,31340,"Lynchburg, VA MSA",2023,8,128505,124583,3922,3.1
MT5140060000000,51,40060,"Richmond, VA MSA",2023,8,724133,703563,20570,2.8
MT5140220000000,51,40220,"Roanoke, VA MSA",2023,8,157888,153602,4286,2.7
MT5144420000000,51,44420,"Staunton-Stuarts Draft, VA MSA",2023,8,65574,64003,1571,2.4
MT5147260000000,51,47260,"Virginia Beach-Chesapeake-Norfolk, VA-NC MSA",2023,8,882028,856466,25562,2.9
MT5149020000000,51,49020,"Winchester, VA-WV MSA",2023,8,77240,75185,2055,2.7
MT5313380000000,53,13380,"Bellingham, WA MSA",2023,8,113731,108994,4737,4.2
MT5314740000000,53,14740,"Bremerton-Silverdale-Port Orchard, WA MSA",2023,8,122068,116998,5070,4.2
MT5328420000000,53,28420,"Kennewick-Richland, WA MSA",2023,8,144217,137059,7158,5
MT5331020000000,53,31020,"Longview-Kelso, WA MSA",2023,8,47306,44974,2332,4.9
MT5334580000000,53,34580,"Mount Vernon-Anacortes, WA MSA",2023,8,58437,55678,2759,4.7
MT5336500000000,53,36500,"Olympia-Lacey-Tumwater, WA MSA",2023,8,142071,136215,5856,4.1
MT5342660000000,53,42660,"Seattle-Tacoma-Bellevue, WA MSA",2023,8,2314450,2221126,93324,4
MT5344060000000,53,44060,"Spokane-Spokane Valley, WA MSA",2023,8,281549,269499,12050,4.3
MT5347460000000,53,47460,"Walla Walla, WA MSA",2023,8,29244,28076,1168,4
MT5348300000000,53,48300,"Wenatchee-East Wenatchee, WA MSA",2023,8,61285,58513,2772,4.5
MT5349420000000,53,49420,"Yakima, WA MSA",2023,8,126047,118871,7176,5.7
MT5413220000000,54,13220,"Beckley, WV MSA",2023,8,46217,44287,1930,4.2
MT5416620000000,54,16620,"Charleston, WV MSA",2023,8,91680,88048,3632,4
MT5426580000000,54,26580,"Huntington-Ashland, WV-KY-OH MSA",2023,8,156153,149004,7149,4.6
MT5434060000000,54,34060,"Morgantown, WV MSA",2023,8,71476,69013,2463,3.4
MT5437620000000,54,37620,"Parkersburg-Vienna, WV MSA",2023,8,39687,38032,1655,4.2
MT5448540000000,54,48540,"Wheeling, WV-OH MSA",2023,8,59596,56833,2763,4.6
MT5511540000000,55,11540,"Appleton, WI MSA",2023,8,136989,133415,3574,2.6
MT5520740000000,55,20740,"Eau Claire, WI MSA",2023,8,95721,92869,2852,3
MT5522540000000,55,22540,"Fond du Lac, WI MSA",2023,8,56150,54662,1488,2.7
MT5524580000000,55,24580,"Green Bay, WI MSA",2023,8,177958,173030,4928,2.8
MT5527500000000,55,27500,"Janesville-Beloit, WI MSA",2023,8,86873,83885,2988,3.4
MT5528450000000,55,28450,"Kenosha, WI MSA",2023,8,94907,91887,3020,3.2
MT5529100000000,55,29100,"La Crosse-Onalaska, WI-MN MSA",2023,8,90657,88159,2498,2.8
MT5531540000000,55,31540,"Madison, WI MSA",2023,8,407734,397770,9964,2.4
MT5533340000000,55,33340,"Milwaukee-Waukesha, WI MSA",2023,8,820117,794156,25961,3.2
MT5536780000000,55,36780,"Oshkosh-Neenah, WI MSA",2023,8,92977,90484,2493,2.7
MT5539540000000,55,39540,"Racine-Mount Pleasant, WI MSA",2023,8,101421,97947,3474,3.4
MT5543100000000,55,43100,"Sheboygan, WI MSA",2023,8,63379,61785,1594,2.5
MT5548140000000,55,48140,"Wausau, WI MSA",2023,8,74673,72634,2039,2.7
MT5616220000000,56,16220,"Casper, WY MSA",2023,8,42222,41006,1216,2.9
MT5616940000000,56,16940,"Cheyenne, WY MSA",2023,8,48752,47342,1410,2.9
MT7210380000000,72,10380,"Aguadilla, PR MSA",2023,8,88269,81826,6443,7.3
MT7211640000000,72,11640,"Arecibo, PR MSA",2023,8,66153,61988,4165,6.3
MT7225020000000,72,25020,"Guayama, PR MSA",2023,8,18931,17142,1789,9.5
MT7232420000000,72,32420,"Mayaguez, PR MSA",2023,8,65654,60770,4884,7.4
MT7238660000000,72,38660,"Ponce, PR MSA",2023,8,88246,80299,7947,9
MT7241980000000,72,41980,"San Juan-Bayamon-Caguas, PR MSA",2023,8,806642,766033,40609,5
MT0111500000000,1,11500,"Anniston-Oxford, AL MSA",2023,9,49232,47884,1348,2.7
MT0112220000000,1,12220,"Auburn-Opelika, AL MSA",2023,9,95073,92838,2235,2.4
MT0113820000000,1,13820,"Birmingham, AL MSA",2023,9,565009,551643,13366,2.4
MT0119300000000,1,19300,"Daphne-Fairhope-Foley, AL MSA",2023,9,113921,111319,2602,2.3
MT0119460000000,1,19460,"Decatur, AL MSA",2023,9,74319,72651,1668,2.2
MT0120020000000,1,20020,"Dothan, AL MSA",2023,9,67448,65676,1772,2.6
MT0122520000000,1,22520,"Florence-Muscle Shoals, AL MSA",2023,9,68231,66307,1924,2.8
MT0123460000000,1,23460,"Gadsden, AL MSA",2023,9,41355,40223,1132,2.7
MT0126620000000,1,26620,"Huntsville, AL MSA",2023,9,270302,264579,5723,2.1
MT0133660000000,1,33660,"Mobile, AL MSA",2023,9,183159,177226,5933,3.2
MT0133860000000,1,33860,"Montgomery, AL MSA",2023,9,174787,170205,4582,2.6
MT0146220000000,1,46220,"Tuscaloosa, AL MSA",2023,9,125438,122050,3388,2.7
MT0211260000000,2,11260,"Anchorage, AK MSA",2023,9,200272,192142,8130,4.1
MT0221820000000,2,21820,"Fairbanks-College, AK MSA",2023,9,45215,43448,1767,3.9
MT0422380000000,4,22380,"Flagstaff, AZ MSA",2023,9,74359,71278,3081,4.1
MT0429420000000,4,29420,"Lake Havasu City-Kingman, AZ MSA",2023,9,86934,83059,3875,4.5
MT0438060000000,4,38060,"Phoenix-Mesa-Chandler, AZ MSA",2023,9,2684471,2594846,89625,3.3
MT0439150000000,4,39150,"Prescott Valley-Prescott, AZ MSA",2023,9,105687,101855,3832,3.6
MT0443420000000,4,43420,"Sierra Vista-Douglas, AZ MSA",2023,9,47939,45872,2067,4.3
MT0446060000000,4,46060,"Tucson, AZ MSA",2023,9,496632,478369,18263,3.7
MT0449740000000,4,49740,"Yuma, AZ MSA",2023,9,98728,86577,12151,12.3
MT0522220000000,5,22220,"Fayetteville-Springdale-Rogers, AR MSA",2023,9,299657,291850,7807,2.6
MT0522900000000,5,22900,"Fort Smith, AR-OK MSA",2023,9,101588,97804,3784,3.7
MT0526300000000,5,26300,"Hot Springs, AR MSA",2023,9,43812,42251,1561,3.6
MT0527860000000,5,27860,"Jonesboro, AR MSA",2023,9,65228,63241,1987,3
MT0530780000000,5,30780,"Little Rock-North Little Rock-Conway, AR MSA",2023,9,374064,362459,11605,3.1
MT0612540000000,6,12540,"Bakersfield-Delano, CA MSA",2023,9,403860,370185,33675,8.3
MT0617020000000,6,17020,"Chico, CA MSA",2023,9,90829,85973,4856,5.3
MT0620940000000,6,20940,"El Centro, CA MSA",2023,9,72224,59325,12899,17.9
MT0623420000000,6,23420,"Fresno, CA MSA",2023,9,531287,490992,40295,7.6
MT0625260000000,6,25260,"Hanford-Corcoran, CA MSA",2023,9,57404,52425,4979,8.7
MT0631080000000,6,31080,"Los Angeles-Long Beach-Anaheim, CA MSA",2023,9,6682519,6358052,324467,4.9
MT0632900000000,6,32900,"Merced, CA MSA",2023,9,119792,108766,11026,9.2
MT0633700000000,6,33700,"Modesto, CA MSA",2023,9,250668,234432,16236,6.5
MT0634900000000,6,34900,"Napa, CA MSA",2023,9,73506,70937,2569,3.5
MT0637100000000,6,37100,"Oxnard-Thousand Oaks-Ventura, CA MSA",2023,9,418840,400581,18259,4.4
MT0639820000000,6,39820,"Redding, CA MSA",2023,9,78488,74604,3884,4.9
MT0640140000000,6,40140,"Riverside-San Bernardino-Ontario, CA MSA",2023,9,2191544,2084517,107027,4.9
MT0640900000000,6,40900,"Sacramento-Roseville-Folsom, CA MSA",2023,9,1169250,1118127,51123,4.4
MT0641500000000,6,41500,"Salinas, CA MSA",2023,9,219525,204219,15306,7
MT0641740000000,6,41740,"San Diego-Chula Vista-Carlsbad, CA MSA",2023,9,1640943,1576504,64439,3.9
MT0641860000000,6,41860,"San Francisco-Oakland-Fremont, CA MSA",2023,9,2511530,2414667,96863,3.9
MT0641940000000,6,41940,"San Jose-Sunnyvale-Santa Clara, CA MSA",2023,9,1056530,1015010,41520,3.9
MT0642020000000,6,42020,"San Luis Obispo-Paso Robles, CA MSA",2023,9,132726,127803,4923,3.7
MT0642100000000,6,42100,"Santa Cruz-Watsonville, CA MSA",2023,9,135448,127764,7684,5.7
MT0642200000000,6,42200,"Santa Maria-Santa Barbara, CA MSA",2023,9,221228,212092,9136,4.1
MT0642220000000,6,42220,"Santa Rosa-Petaluma, CA MSA",2023,9,247196,237933,9263,3.7
MT0644700000000,6,44700,"Stockton-Lodi, CA MSA",2023,9,366105,343430,22675,6.2
MT0646700000000,6,46700,"Vallejo, CA MSA",2023,9,215457,205674,9783,4.5
MT0647300000000,6,47300,"Visalia, CA MSA",2023,9,218940,197165,21775,9.9
MT0649700000000,6,49700,"Yuba City, CA MSA",2023,9,80293,74428,5865,7.3
MT0814500000000,8,14500,"Boulder, CO MSA",2023,9,193980,187297,6683,3.4
MT0817820000000,8,17820,"Colorado Springs, CO MSA",2023,9,391371,377320,14051,3.6
MT0819740000000,8,19740,"Denver-Aurora-Centennial, CO MSA",2023,9,1764478,1702901,61577,3.5
MT0822660000000,8,22660,"Fort Collins-Loveland, CO MSA",2023,9,207889,200889,7000,3.4
MT0824300000000,8,24300,"Grand Junction, CO MSA",2023,9,78877,75875,3002,3.8
MT0824540000000,8,24540,"Greeley, CO MSA",2023,9,175336,168808,6528,3.7
MT0839380000000,8,39380,"Pueblo, CO MSA",2023,9,73616,69985,3631,4.9
MT0914860000000,9,14860,"Bridgeport-Stamford-Danbury, CT MSA",2023,9,509025,493154,15871,3.1
MT0925540000000,9,25540,"Hartford-West Hartford-East Hartford, CT MSA",2023,9,607894,588798,19096,3.1
MT0935300000000,9,35300,"New Haven, CT MSA",2023,9,311595,301828,9767,3.1
MT0935980000000,9,35980,"Norwich-New London-Willimantic, CT MSA",2023,9,140613,136111,4502,3.2
MT0947930000000,9,47930,"Waterbury-Shelton, CT MSA",2023,9,238201,229494,8707,3.7
MT1020100000000,10,20100,"Dover, DE MSA",2023,9,85744,82176,3568,4.2
MT1147900000000,11,47900,"Washington-Arlington-Alexandria, DC-VA-MD-WV MSA",2023,9,3522751,3431458,91293,2.6
MT1215980000000,12,15980,"Cape Coral-Fort Myers, FL MSA",2023,9,374138,361773,12365,3.3
MT1218880000000,12,18880,"Crestview-Fort Walton Beach-Destin, FL MSA",2023,9,142603,138566,4037,2.8
MT1219660000000,12,19660,"Deltona-Daytona Beach-Ormond Beach, FL MSA",2023,9,320258,308732,11526,3.6
MT1223540000000,12,23540,"Gainesville, FL MSA",2023,9,169421,163580,5841,3.4
MT1226140000000,12,26140,"Homosassa Springs, FL MSA",2023,9,53912,51411,2501,4.6
MT1227260000000,12,27260,"Jacksonville, FL MSA",2023,9,851215,823720,27495,3.2
MT1229460000000,12,29460,"Lakeland-Winter Haven, FL MSA",2023,9,357166,343602,13564,3.8
MT1233100000000,12,33100,"Miami-Fort Lauderdale-West Palm Beach, FL MSA",2023,9,3285732,3203035,82697,2.5
MT1234940000000,12,34940,"Naples-Marco Island, FL MSA",2023,9,183364,177817,5547,3
MT1235840000000,12,35840,"North Port-Bradenton-Sarasota, FL MSA",2023,9,394291,381530,12761,3.2
MT1236100000000,12,36100,"Ocala, FL MSA",2023,9,157240,151159,6081,3.9
MT1236740000000,12,36740,"Orlando-Kissimmee-Sanford, FL MSA",2023,9,1520471,1474265,46206,3
MT1237340000000,12,37340,"Palm Bay-Melbourne-Titusville, FL MSA",2023,9,305004,295207,9797,3.2
MT1237460000000,12,37460,"Panama City-Panama City Beach, FL MSA",2023,9,101032,97908,3124,3.1
MT1237860000000,12,37860,"Pensacola-Ferry Pass-Brent, FL MSA",2023,9,240859,233182,7677,3.2
MT1238940000000,12,38940,"Port St. Lucie, FL MSA",2023,9,239039,230643,8396,3.5
MT1239460000000,12,39460,"Punta Gorda, FL MSA",2023,9,75704,72855,2849,3.8
MT1242680000000,12,42680,"Sebastian-Vero Beach-West Vero Corridor, FL MSA",2023,9,68069,65514,2555,3.8
MT1242700000000,12,42700,"Sebring, FL MSA",2023,9,36570,34939,1631,4.5
MT1245220000000,12,45220,"Tallahassee, FL MSA",2023,9,205472,198908,6564,3.2
MT1245300000000,12,45300,"Tampa-St. Petersburg-Clearwater, FL MSA",2023,9,1700243,1646739,53504,3.1
MT1248680000000,12,48680,"Wildwood-The Villages, FL MSA",2023,9,33851,31935,1916,5.7
MT1310500000000,13,10500,"Albany, GA MSA",2023,9,62405,60006,2399,3.8
MT1312020000000,13,12020,"Athens-Clarke County, GA MSA",2023,9,107742,104544,3198,3
MT1312060000000,13,12060,"Atlanta-Sandy Springs-Roswell, GA MSA",2023,9,3280281,3173305,106976,3.3
MT1312260000000,13,12260,"Augusta-Richmond County, GA-SC MSA",2023,9,265892,256014,9878,3.7
MT1315260000000,13,15260,"Brunswick-St. Simons, GA MSA",2023,9,54987,53402,1585,2.9
MT1317980000000,13,17980,"Columbus, GA-AL MSA",2023,9,130006,125280,4726,3.6
MT1319140000000,13,19140,"Dalton, GA MSA",2023,9,67630,65326,2304,3.4
MT1323580000000,13,23580,"Gainesville, GA MSA",2023,9,108699,105845,2854,2.6
MT1325980000000,13,25980,"Hinesville, GA MSA",2023,9,31112,29927,1185,3.8
MT1331420000000,13,31420,"Macon-Bibb County, GA MSA",2023,9,97397,93702,3695,3.8
MT1340660000000,13,40660,"Rome, GA MSA",2023,9,48106,46609,1497,3.1
MT1342340000000,13,42340,"Savannah, GA MSA",2023,9,208110,202062,6048,2.9
MT1346660000000,13,46660,"Valdosta, GA MSA",2023,9,61543,59320,2223,3.6
MT1347580000000,13,47580,"Warner Robins, GA MSA",2023,9,89802,87141,2661,3
MT1527980000000,15,27980,"Kahului-Wailuku, HI MSA",2023,9,81294,74254,7040,8.7
MT1546520000000,15,46520,"Urban Honolulu, HI MSA",2023,9,468417,456937,11480,2.5
MT1614260000000,16,14260,"Boise City, ID MSA",2023,9,440311,426319,13992,3.2
MT1617660000000,16,17660,"Coeur d'Alene, ID MSA",2023,9,89411,85910,3501,3.9
MT1626820000000,16,26820,"Idaho Falls, ID MSA",2023,9,83843,81530,2313,2.8
MT1630300000000,16,30300,"Lewiston, ID-WA MSA",2023,9,30921,29889,1032,3.3
MT1638540000000,16,38540,"Pocatello, ID MSA",2023,9,40214,38740,1474,3.7
MT1646300000000,16,46300,"Twin Falls, ID MSA",2023,9,59523,57578,1945,3.3
MT1714010000000,17,14010,"Bloomington, IL MSA",2023,9,95757,92094,3663,3.8
MT1716580000000,17,16580,"Champaign-Urbana, IL MSA",2023,9,125225,119725,5500,4.4
MT1716980000000,17,16980,"Chicago-Naperville-Elgin, IL-IN MSA",2023,9,4920813,4691856,228957,4.7
MT1719340000000,17,19340,"Davenport-Moline-Rock Island, IA-IL MSA",2023,9,190370,181782,8588,4.5
MT1719500000000,17,19500,"Decatur, IL MSA",2023,9,44726,41904,2822,6.3
MT1728100000000,17,28100,"Kankakee, IL MSA",2023,9,51207,48058,3149,6.1
MT1737900000000,17,37900,"Peoria, IL MSA",2023,9,176699,167907,8792,5
MT1740420000000,17,40420,"Rockford, IL MSA",2023,9,161330,150965,10365,6.4
MT1744100000000,17,44100,"Springfield, IL MSA",2023,9,102038,97426,4612,4.5
MT1814020000000,18,14020,"Bloomington, IN MSA",2023,9,84535,81859,2676,3.2
MT1818020000000,18,18020,"Columbus, IN MSA",2023,9,39477,38162,1315,3.3
MT1821140000000,18,21140,"Elkhart-Goshen, IN MSA",2023,9,99669,95124,4545,4.6
MT1821780000000,18,21780,"Evansville, IN MSA",2023,9,134666,130215,4451,3.3
MT1823060000000,18,23060,"Fort Wayne, IN MSA",2023,9,229974,222530,7444,3.2
MT1826900000000,18,26900,"Indianapolis-Carmel-Greenwood, IN MSA",2023,9,1121569,1085410,36159,3.2
MT1829020000000,18,29020,"Kokomo, IN MSA",2023,9,35119,33515,1604,4.6
MT1829200000000,18,29200,"Lafayette-West Lafayette, IN MSA",2023,9,119855,116319,3536,3
MT1833140000000,18,33140,"Michigan City-La Porte, IN MSA",2023,9,51432,49408,2024,3.9
MT1834620000000,18,34620,"Muncie, IN MSA",2023,9,51726,49645,2081,4
MT1843780000000,18,43780,"South Bend-Mishawaka, IN-MI MSA",2023,9,154369,147857,6512,4.2
MT1845460000000,18,45460,"Terre Haute, IN MSA",2023,9,76582,73752,2830,3.7
MT1911180000000,19,11180,"Ames, IA MSA",2023,9,69595,67944,1651,2.4
MT1916300000000,19,16300,"Cedar Rapids, IA MSA",2023,9,147498,142693,4805,3.3
MT1919780000000,19,19780,"Des Moines-West Des Moines, IA MSA",2023,9,409588,398395,11193,2.7
MT1920220000000,19,20220,"Dubuque, IA MSA",2023,9,53581,51948,1633,3
MT1926980000000,19,26980,"Iowa City, IA MSA",2023,9,99371,96920,2451,2.5
MT1943580000000,19,43580,"Sioux City, IA-NE-SD MSA",2023,9,77033,74815,2218,2.9
MT1947940000000,19,47940,"Waterloo-Cedar Falls, IA MSA",2023,9,88760,86153,2607,2.9
MT2029940000000,20,29940,"Lawrence, KS MSA",2023,9,70283,68454,1829,2.6
MT2031740000000,20,31740,"Manhattan, KS MSA",2023,9,63423,61691,1732,2.7
MT2045820000000,20,45820,"Topeka, KS MSA",2023,9,118080,114529,3551,3
MT2048620000000,20,48620,"Wichita, KS MSA",2023,9,332719,322424,10295,3.1
MT2114540000000,21,14540,"Bowling Green, KY MSA",2023,9,90916,87140,3776,4.2
MT2121060000000,21,21060,"Elizabethtown, KY MSA",2023,9,54801,52386,2415,4.4
MT2130460000000,21,30460,"Lexington-Fayette, KY MSA",2023,9,272909,262821,10088,3.7
MT2131140000000,21,31140,"Louisville/Jefferson County, KY-IN MSA",2023,9,689995,663117,26878,3.9
MT2136980000000,21,36980,"Owensboro, KY MSA",2023,9,50882,48600,2282,4.5
MT2137140000000,21,37140,"Paducah, KY-IL MSA",2023,9,45820,43696,2124,4.6
MT2210780000000,22,10780,"Alexandria, LA MSA",2023,9,64346,62094,2252,3.5
MT2212940000000,22,12940,"Baton Rouge, LA MSA",2023,9,422238,407072,15166,3.6
MT2225220000000,22,25220,"Hammond, LA MSA",2023,9,60063,57529,2534,4.2
MT2226380000000,22,26380,"Houma-Bayou Cane-Thibodaux, LA MSA",2023,9,88598,85745,2853,3.2
MT2229180000000,22,29180,"Lafayette, LA MSA",2023,9,196745,190320,6425,3.3
MT2229340000000,22,29340,"Lake Charles, LA MSA",2023,9,97513,93733,3780,3.9
MT2233740000000,22,33740,"Monroe, LA MSA",2023,9,95933,91796,4137,4.3
MT2235380000000,22,35380,"New Orleans-Metairie, LA MSA",2023,9,466970,448664,18306,3.9
MT2243340000000,22,43340,"Shreveport-Bossier City, LA MSA",2023,9,168459,161927,6532,3.9
MT2243640000000,22,43640,"Slidell-Mandeville-Covington, LA MSA",2023,9,128734,124471,4263,3.3
MT2312620000000,23,12620,"Bangor, ME MSA",2023,9,74707,72391,2316,3.1
MT2330340000000,23,30340,"Lewiston-Auburn, ME MSA",2023,9,55103,53545,1558,2.8
MT2338860000000,23,38860,"Portland-South Portland, ME MSA",2023,9,310043,302648,7395,2.4
MT2412580000000,24,12580,"Baltimore-Columbia-Towson, MD MSA",2023,9,1478829,1444545,34284,2.3
MT2425180000000,24,25180,"Hagerstown-Martinsburg, MD-WV MSA",2023,9,142726,138327,4399,3.1
MT2430500000000,24,30500,"Lexington Park, MD MSA",2023,9,107453,105248,2205,2.1
MT2441540000000,24,41540,"Salisbury, MD MSA",2023,9,64043,62366,1677,2.6
MT2511200000000,25,11200,"Amherst Town-Northampton, MA MSA",2023,9,83794,81064,2730,3.3
MT2512700000000,25,12700,"Barnstable Town, MA MSA",2023,9,114672,109563,5109,4.5
MT2514460000000,25,14460,"Boston-Cambridge-Newton, MA-NH MSA",2023,9,2777968,2689507,88461,3.2
MT2538340000000,25,38340,"Pittsfield, MA MSA",2023,9,63764,61407,2357,3.7
MT2544140000000,25,44140,"Springfield, MA MSA",2023,9,221193,211308,9885,4.5
MT2549340000000,25,49340,"Worcester, MA MSA",2023,9,458608,442236,16372,3.6
MT2611460000000,26,11460,"Ann Arbor, MI MSA",2023,9,206775,200149,6626,3.2
MT2612980000000,26,12980,"Battle Creek, MI MSA",2023,9,62398,59697,2701,4.3
MT2613020000000,26,13020,"Bay City, MI MSA",2023,9,50196,47724,2472,4.9
MT2619820000000,26,19820,"Detroit-Warren-Dearborn, MI MSA",2023,9,2188180,2104361,83819,3.8
MT2622420000000,26,22420,"Flint, MI MSA",2023,9,187168,178075,9093,4.9
MT2624340000000,26,24340,"Grand Rapids-Wyoming-Kentwood, MI MSA",2023,9,628410,606816,21594,3.4
MT2627100000000,26,27100,"Jackson, MI MSA",2023,9,75233,72102,3131,4.2
MT2628020000000,26,28020,"Kalamazoo-Portage, MI MSA",2023,9,139340,134288,5052,3.6
MT2629620000000,26,29620,"Lansing-East Lansing, MI MSA",2023,9,252241,242823,9418,3.7
MT2633220000000,26,33220,"Midland, MI MSA",2023,9,42694,41077,1617,3.8
MT2633780000000,26,33780,"Monroe, MI MSA",2023,9,78542,75233,3309,4.2
MT2634740000000,26,34740,"Muskegon-Norton Shores, MI MSA",2023,9,84197,80564,3633,4.3
MT2635660000000,26,35660,"Niles, MI MSA",2023,9,76310,73115,3195,4.2
MT2640980000000,26,40980,"Saginaw, MI MSA",2023,9,85182,80849,4333,5.1
MT2645900000000,26,45900,"Traverse City, MI MSA",2023,9,80955,77749,3206,4
MT2720260000000,27,20260,"Duluth, MN-WI MSA",2023,9,139628,134937,4691,3.4
MT2731860000000,27,31860,"Mankato, MN MSA",2023,9,60141,58761,1380,2.3
MT2733460000000,27,33460,"Minneapolis-St. Paul-Bloomington, MN-WI MSA",2023,9,2062825,2008668,54157,2.6
MT2740340000000,27,40340,"Rochester, MN MSA",2023,9,125686,122741,2945,2.3
MT2741060000000,27,41060,"St. Cloud, MN MSA",2023,9,109539,106303,3236,3
MT2825060000000,28,25060,"Gulfport-Biloxi, MS MSA",2023,9,184562,179285,5277,2.9
MT2825620000000,28,25620,"Hattiesburg, MS MSA",2023,9,69824,67892,1932,2.8
MT2827140000000,28,27140,"Jackson, MS MSA",2023,9,276794,269180,7614,2.8
MT2916020000000,29,16020,"Cape Girardeau, MO-IL MSA",2023,9,49038,47536,1502,3.1
MT2917860000000,29,17860,"Columbia, MO MSA",2023,9,112261,109088,3173,2.8
MT2927620000000,29,27620,"Jefferson City, MO MSA",2023,9,75433,73280,2153,2.9
MT2927900000000,29,27900,"Joplin, MO-KS MSA",2023,9,97152,94074,3078,3.2
MT2928140000000,29,28140,"Kansas City, MO-KS MSA",2023,9,1186976,1150108,36868,3.1
MT2941140000000,29,41140,"St. Joseph, MO-KS MSA",2023,9,53905,52103,1802,3.3
MT2941180000000,29,41180,"St. Louis, MO-IL MSA",2023,9,1478593,1427138,51455,3.5
MT2944180000000,29,44180,"Springfield, MO MSA",2023,9,240147,233024,7123,3
MT3013740000000,30,13740,"Billings, MT MSA",2023,9,99171,96621,2550,2.6
MT3014580000000,30,14580,"Bozeman, MT MSA",2023,9,76219,74531,1688,2.2
MT3024500000000,30,24500,"Great Falls, MT MSA",2023,9,39917,38805,1112,2.8
MT3025740000000,30,25740,"Helena, MT MSA",2023,9,47063,45796,1267,2.7
MT3033540000000,30,33540,"Missoula, MT MSA",2023,9,73959,71945,2014,2.7
MT3124260000000,31,24260,"Grand Island, NE MSA",2023,9,42384,41395,989,2.3
MT3130700000000,31,30700,"Lincoln, NE MSA",2023,9,191761,187387,4374,2.3
MT3136540000000,31,36540,"Omaha, NE-IA MSA",2023,9,522929,509020,13909,2.7
MT3216180000000,32,16180,"Carson City, NV MSA",2023,9,28890,27609,1281,4.4
MT3229820000000,32,29820,"Las Vegas-Henderson-North Las Vegas, NV MSA",2023,9,1194737,1130019,64718,5.4
MT3239900000000,32,39900,"Reno, NV MSA",2023,9,297265,283872,13393,4.5
MT3331700000000,33,31700,"Manchester-Nashua, NH MSA",2023,9,239659,233940,5719,2.4
MT3412100000000,34,12100,"Atlantic City-Hammonton, NJ MSA",2023,9,180356,169212,11144,6.2
MT3445940000000,34,45940,"Trenton-Princeton, NJ MSA",2023,9,198752,190107,8645,4.3
MT3447220000000,34,47220,"Vineland, NJ MSA",2023,9,65971,61317,4654,7.1
MT3510740000000,35,10740,"Albuquerque, NM MSA",2023,9,459038,442775,16263,3.5
MT3522140000000,35,22140,"Farmington, NM MSA",2023,9,49431,47384,2047,4.1
MT3529740000000,35,29740,"Las Cruces, NM MSA",2023,9,100965,96550,4415,4.4
MT3542140000000,35,42140,"Santa Fe, NM MSA",2023,9,73749,71169,2580,3.5
MT3610580000000,36,10580,"Albany-Schenectady-Troy, NY MSA",2023,9,460034,444735,15299,3.3
MT3613780000000,36,13780,"Binghamton, NY MSA",2023,9,107480,103309,4171,3.9
MT3615380000000,36,15380,"Buffalo-Cheektowaga, NY MSA",2023,9,563637,542054,21583,3.8
MT3621300000000,36,21300,"Elmira, NY MSA",2023,9,35848,34453,1395,3.9
MT3624020000000,36,24020,"Glens Falls, NY MSA",2023,9,59854,57690,2164,3.6
MT3627060000000,36,27060,"Ithaca, NY MSA",2023,9,48673,47073,1600,3.3
MT3628740000000,36,28740,"Kingston, NY MSA",2023,9,87989,84803,3186,3.6
MT3628880000000,36,28880,"Kiryas Joel-Poughkeepsie-Newburgh, NY MSA",2023,9,341762,329846,11916,3.5
MT3635620000000,36,35620,"New York-Newark-Jersey City, NY-NJ MSA",2023,9,10145688,9700074,445614,4.4
MT3640380000000,36,40380,"Rochester, NY MSA",2023,9,517996,499279,18717,3.6
MT3645060000000,36,45060,"Syracuse, NY MSA",2023,9,312980,301433,11547,3.7
MT3646540000000,36,46540,"Utica-Rome, NY MSA",2023,9,128291,123388,4903,3.8
MT3648060000000,36,48060,"Watertown-Fort Drum, NY MSA",2023,9,45307,43283,2024,4.5
MT3711700000000,37,11700,"Asheville, NC MSA",2023,9,211709,205547,6162,2.9
MT3715500000000,37,15500,"Burlington, NC MSA",2023,9,86097,83062,3035,3.5
MT3716740000000,37,16740,"Charlotte-Concord-Gastonia, NC-SC MSA",2023,9,1477782,1427935,49847,3.4
MT3720500000000,37,20500,"Durham-Chapel Hill, NC MSA",2023,9,321906,311732,10174,3.2
MT3722180000000,37,22180,"Fayetteville, NC MSA",2023,9,155966,149112,6854,4.4
MT3724140000000,37,24140,"Goldsboro, NC MSA",2023,9,50503,48622,1881,3.7
MT3724660000000,37,24660,"Greensboro-High Point, NC MSA",2023,9,372896,358383,14513,3.9
MT3724780000000,37,24780,"Greenville, NC MSA",2023,9,84042,80643,3399,4
MT3725860000000,37,25860,"Hickory-Lenoir-Morganton, NC MSA",2023,9,172838,166853,5985,3.5
MT3727340000000,37,27340,"Jacksonville, NC MSA",2023,9,74468,71741,2727,3.7
MT3738240000000,37,38240,"Pinehurst-Southern Pines, NC MSA",2023,9,44371,42820,1551,3.5
MT3739580000000,37,39580,"Raleigh-Cary, NC MSA",2023,9,839346,813660,25686,3.1
MT3740580000000,37,40580,"Rocky Mount, NC MSA",2023,9,63801,60786,3015,4.7
MT3748900000000,37,48900,"Wilmington, NC MSA",2023,9,222652,214677,7975,3.6
MT3749180000000,37,49180,"Winston-Salem, NC MSA",2023,9,325927,314282,11645,3.6
MT3813900000000,38,13900,"Bismarck, ND MSA",2023,9,72440,70940,1500,2.1
MT3822020000000,38,22020,"Fargo, ND-MN MSA",2023,9,152714,149790,2924,1.9
MT3824220000000,38,24220,"Grand Forks, ND-MN MSA",2023,9,55627,54401,1226,2.2
MT3833500000000,38,33500,"Minot, ND MSA",2023,9,39908,39043,865,2.2
MT3910420000000,39,10420,"Akron, OH MSA",2023,9,357109,343164,13945,3.9
MT3915940000000,39,15940,"Canton-Massillon, OH MSA",2023,9,192296,184368,7928,4.1
MT3917140000000,39,17140,"Cincinnati, OH-KY-IN MSA",2023,9,1163483,1121683,41800,3.6
MT3917410000000,39,17410,"Cleveland, OH MSA",2023,9,1088917,1048615,40302,3.7
MT3918140000000,39,18140,"Columbus, OH MSA",2023,9,1141287,1102709,38578,3.4
MT3919430000000,39,19430,"Dayton-Kettering-Beavercreek, OH MSA",2023,9,389208,374129,15079,3.9
MT3930620000000,39,30620,"Lima, OH MSA",2023,9,47226,45381,1845,3.9
MT3931900000000,39,31900,"Mansfield, OH MSA",2023,9,52919,50625,2294,4.3
MT3941780000000,39,41780,"Sandusky, OH MSA",2023,9,57150,54365,2785,4.9
MT3944220000000,39,44220,"Springfield, OH MSA",2023,9,62170,59673,2497,4
MT3945780000000,39,45780,"Toledo, OH MSA",2023,9,294796,282512,12284,4.2
MT3948260000000,39,48260,"Weirton-Steubenville, WV-OH MSA",2023,9,52082,49363,2719,5.2
MT3949660000000,39,49660,"Youngstown-Warren, OH MSA",2023,9,190535,182116,8419,4.4
MT4021420000000,40,21420,"Enid, OK MSA",2023,9,28525,27611,914,3.2
MT4030020000000,40,30020,"Lawton, OK MSA",2023,9,52185,50100,2085,4
MT4036420000000,40,36420,"Oklahoma City, OK MSA",2023,9,765501,741485,24016,3.1
MT4046140000000,40,46140,"Tulsa, OK MSA",2023,9,520168,502484,17684,3.4
MT4110540000000,41,10540,"Albany, OR MSA",2023,9,61365,58784,2581,4.2
MT4113460000000,41,13460,"Bend, OR MSA",2023,9,130605,125316,5289,4
MT4118700000000,41,18700,"Corvallis, OR MSA",2023,9,49076,47454,1622,3.3
MT4121660000000,41,21660,"Eugene-Springfield, OR MSA",2023,9,186767,179346,7421,4
MT4124420000000,41,24420,"Grants Pass, OR MSA",2023,9,34912,33041,1871,5.4
MT4132780000000,41,32780,"Medford, OR MSA",2023,9,105443,100688,4755,4.5
MT4138900000000,41,38900,"Portland-Vancouver-Hillsboro, OR-WA MSA",2023,9,1380368,1329505,50863,3.7
MT4141420000000,41,41420,"Salem, OR MSA",2023,9,217865,209583,8282,3.8
MT4210900000000,42,10900,"Allentown-Bethlehem-Easton, PA-NJ MSA",2023,9,451008,432609,18399,4.1
MT4211020000000,42,11020,"Altoona, PA MSA",2023,9,57592,55511,2081,3.6
MT4216540000000,42,16540,"Chambersburg, PA MSA",2023,9,76770,74382,2388,3.1
MT4221500000000,42,21500,"Erie, PA MSA",2023,9,127473,122181,5292,4.2
MT4223900000000,42,23900,"Gettysburg, PA MSA",2023,9,52625,51054,1571,3
MT4225420000000,42,25420,"Harrisburg-Carlisle, PA MSA",2023,9,313788,303647,10141,3.2
MT4227780000000,42,27780,"Johnstown, PA MSA",2023,9,57248,54788,2460,4.3
MT4229540000000,42,29540,"Lancaster, PA MSA",2023,9,294282,285782,8500,2.9
MT4230140000000,42,30140,"Lebanon, PA MSA",2023,9,74148,71815,2333,3.1
MT4237980000000,42,37980,"Philadelphia-Camden-Wilmington, PA-NJ-DE-MD MSA",2023,9,3299060,3174629,124431,3.8
MT4238300000000,42,38300,"Pittsburgh, PA MSA",2023,9,1238029,1193168,44861,3.6
MT4239740000000,42,39740,"Reading, PA MSA",2023,9,220347,212151,8196,3.7
MT4242540000000,42,42540,"Scranton--Wilkes-Barre, PA MSA",2023,9,280606,268461,12145,4.3
MT4244300000000,42,44300,"State College, PA MSA",2023,9,77783,75612,2171,2.8
MT4248700000000,42,48700,"Williamsport, PA MSA",2023,9,53315,51222,2093,3.9
MT4249620000000,42,49620,"York-Hanover, PA MSA",2023,9,241314,233558,7756,3.2
MT4439300000000,44,39300,"Providence-Warwick, RI-MA MSA",2023,9,886153,855380,30773,3.5
MT4516700000000,45,16700,"Charleston-North Charleston, SC MSA",2023,9,434206,423591,10615,2.4
MT4517900000000,45,17900,"Columbia, SC MSA",2023,9,411938,400662,11276,2.7
MT4522500000000,45,22500,"Florence, SC MSA",2023,9,91371,88485,2886,3.2
MT4524860000000,45,24860,"Greenville-Anderson-Greer, SC MSA",2023,9,470699,458123,12576,2.7
MT4525940000000,45,25940,"Hilton Head Island-Bluffton-Port Royal, SC MSA",2023,9,96954,94371,2583,2.7
MT4534820000000,45,34820,"Myrtle Beach-Conway-North Myrtle Beach, SC MSA",2023,9,167661,162005,5656,3.4
MT4543900000000,45,43900,"Spartanburg, SC MSA",2023,9,173551,168362,5189,3
MT4544940000000,45,44940,"Sumter, SC MSA",2023,9,41381,39882,1499,3.6
MT4639660000000,46,39660,"Rapid City, SD MSA",2023,9,78955,77512,1443,1.8
MT4643620000000,46,43620,"Sioux Falls, SD-MN MSA",2023,9,172236,169308,2928,1.7
MT4716860000000,47,16860,"Chattanooga, TN-GA MSA",2023,9,287508,278735,8773,3.1
MT4717300000000,47,17300,"Clarksville, TN-KY MSA",2023,9,136139,130789,5350,3.9
MT4717420000000,47,17420,"Cleveland, TN MSA",2023,9,56880,54874,2006,3.5
MT4727180000000,47,27180,"Jackson, TN MSA",2023,9,78187,75445,2742,3.5
MT4727740000000,47,27740,"Johnson City, TN MSA",2023,9,96536,93311,3225,3.3
MT4728700000000,47,28700,"Kingsport-Bristol, TN-VA MSA",2023,9,132807,128221,4586,3.5
MT4728940000000,47,28940,"Knoxville, TN MSA",2023,9,447089,433416,13673,3.1
MT4732820000000,47,32820,"Memphis, TN-MS-AR MSA",2023,9,623922,600197,23725,3.8
MT4734100000000,47,34100,"Morristown, TN MSA",2023,9,52853,50996,1857,3.5
MT4734980000000,47,34980,"Nashville-Davidson--Murfreesboro--Franklin, TN MSA",2023,9,1147900,1117277,30623,2.7
MT4810180000000,48,10180,"Abilene, TX MSA",2023,9,85107,82246,2861,3.4
MT4811100000000,48,11100,"Amarillo, TX MSA",2023,9,135619,131428,4191,3.1
MT4812420000000,48,12420,"Austin-Round Rock-San Marcos, TX MSA",2023,9,1466402,1414726,51676,3.5
MT4813140000000,48,13140,"Beaumont-Port Arthur, TX MSA",2023,9,175963,166605,9358,5.3
MT4815180000000,48,15180,"Brownsville-Harlingen, TX MSA",2023,9,186224,176595,9629,5.2
MT4817780000000,48,17780,"College Station-Bryan, TX MSA",2023,9,147346,142414,4932,3.3
MT4818580000000,48,18580,"Corpus Christi, TX MSA",2023,9,207488,198737,8751,4.2
MT4819100000000,48,19100,"Dallas-Fort Worth-Arlington, TX MSA",2023,9,4402645,4235407,167238,3.8
MT4820580000000,48,20580,"Eagle Pass, TX MSA",2023,9,23770,22056,1714,7.2
MT4821340000000,48,21340,"El Paso, TX MSA",2023,9,403808,386566,17242,4.3
MT4826420000000,48,26420,"Houston-Pasadena-The Woodlands, TX MSA",2023,9,3758664,3601637,157027,4.2
MT4828660000000,48,28660,"Killeen-Temple, TX MSA",2023,9,198573,190215,8358,4.2
MT4829700000000,48,29700,"Laredo, TX MSA",2023,9,116037,111466,4571,3.9
MT4830980000000,48,30980,"Longview, TX MSA",2023,9,128418,122830,5588,4.4
MT4831180000000,48,31180,"Lubbock, TX MSA",2023,9,180856,174817,6039,3.3
MT4832580000000,48,32580,"McAllen-Edinburg-Mission, TX MSA",2023,9,389600,366430,23170,5.9
MT4833260000000,48,33260,"Midland, TX MSA",2023,9,100282,97524,2758,2.8
MT4836220000000,48,36220,"Odessa, TX MSA",2023,9,83569,80825,2744,3.3
MT4841660000000,48,41660,"San Angelo, TX MSA",2023,9,60837,58893,1944,3.2
MT4841700000000,48,41700,"San Antonio-New Braunfels, TX MSA",2023,9,1308745,1260467,48278,3.7
MT4843300000000,48,43300,"Sherman-Denison, TX MSA",2023,9,70291,67649,2642,3.8
MT4845500000000,48,45500,"Texarkana, TX-AR MSA",2023,9,60925,58500,2425,4
MT4846340000000,48,46340,"Tyler, TX MSA",2023,9,115797,111589,4208,3.6
MT4847020000000,48,47020,"Victoria, TX MSA",2023,9,44625,42865,1760,3.9
MT4847380000000,48,47380,"Waco, TX MSA",2023,9,144192,138986,5206,3.6
MT4848660000000,48,48660,"Wichita Falls, TX MSA",2023,9,66350,63933,2417,3.6
MT4930860000000,49,30860,"Logan, UT-ID MSA",2023,9,79220,77230,1990,2.5
MT4936260000000,49,36260,"Ogden, UT MSA",2023,9,348585,339474,9111,2.6
MT4939340000000,49,39340,"Provo-Orem-Lehi, UT MSA",2023,9,365163,354865,10298,2.8
MT4941100000000,49,41100,"St. George, UT MSA",2023,9,91328,88546,2782,3
MT4941620000000,49,41620,"Salt Lake City-Murray, UT MSA",2023,9,729239,708688,20551,2.8
MT5015540000000,50,15540,"Burlington-South Burlington, VT MSA",2023,9,130732,128637,2095,1.6
MT5113980000000,51,13980,"Blacksburg-Christiansburg-Radford, VA MSA",2023,9,94374,91726,2648,2.8
MT5116820000000,51,16820,"Charlottesville, VA MSA",2023,9,119435,116531,2904,2.4
MT5125500000000,51,25500,"Harrisonburg, VA MSA",2023,9,72634,70739,1895,2.6
MT5131340000000,51,31340,"Lynchburg, VA MSA",2023,9,128600,124621,3979,3.1
MT5140060000000,51,40060,"Richmond, VA MSA",2023,9,724233,703335,20898,2.9
MT5140220000000,51,40220,"Roanoke, VA MSA",2023,9,158093,153745,4348,2.8
MT5144420000000,51,44420,"Staunton-Stuarts Draft, VA MSA",2023,9,65599,64016,1583,2.4
MT5147260000000,51,47260,"Virginia Beach-Chesapeake-Norfolk, VA-NC MSA",2023,9,883228,857248,25980,2.9
MT5149020000000,51,49020,"Winchester, VA-WV MSA",2023,9,77323,75238,2085,2.7
MT5313380000000,53,13380,"Bellingham, WA MSA",2023,9,113999,108970,5029,4.4
MT5314740000000,53,14740,"Bremerton-Silverdale-Port Orchard, WA MSA",2023,9,122465,117049,5416,4.4
MT5328420000000,53,28420,"Kennewick-Richland, WA MSA",2023,9,144623,137181,7442,5.1
MT5331020000000,53,31020,"Longview-Kelso, WA MSA",2023,9,47398,44943,2455,5.2
MT5334580000000,53,34580,"Mount Vernon-Anacortes, WA MSA",2023,9,58712,55797,2915,5
MT5336500000000,53,36500,"Olympia-Lacey-Tumwater, WA MSA",2023,9,142631,136399,6232,4.4
MT5342660000000,53,42660,"Seattle-Tacoma-Bellevue, WA MSA",2023,9,2313935,2218883,95052,4.1
MT5344060000000,53,44060,"Spokane-Spokane Valley, WA MSA",2023,9,282389,269702,12687,4.5
MT5347460000000,53,47460,"Walla Walla, WA MSA",2023,9,29229,28014,1215,4.2
MT5348300000000,53,48300,"Wenatchee-East Wenatchee, WA MSA",2023,9,61438,58539,2899,4.7
MT5349420000000,53,49420,"Yakima, WA MSA",2023,9,125942,118422,7520,6
MT5413220000000,54,13220,"Beckley, WV MSA",2023,9,46242,44305,1937,4.2
MT5416620000000,54,16620,"Charleston, WV MSA",2023,9,91739,88045,3694,4
MT5426580000000,54,26580,"Huntington-Ashland, WV-KY-OH MSA",2023,9,156364,149096,7268,4.6
MT5434060000000,54,34060,"Morgantown, WV MSA",2023,9,71395,68890,2505,3.5
MT5437620000000,54,37620,"Parkersburg-Vienna, WV MSA",2023,9,39780,38085,1695,4.3
MT5448540000000,54,48540,"Wheeling, WV-OH MSA",2023,9,59538,56723,2815,4.7
MT5511540000000,55,11540,"Appleton, WI MSA",2023,9,137037,133475,3562,2.6
MT5520740000000,55,20740,"Eau Claire, WI MSA",2023,9,95767,92904,2863,3
MT5522540000000,55,22540,"Fond du Lac, WI MSA",2023,9,56087,54595,1492,2.7
MT5524580000000,55,24580,"Green Bay, WI MSA",2023,9,178088,173128,4960,2.8
MT5527500000000,55,27500,"Janesville-Beloit, WI MSA",2023,9,86991,84026,2965,3.4
MT5528450000000,55,28450,"Kenosha, WI MSA",2023,9,95160,92109,3051,3.2
MT5529100000000,55,29100,"La Crosse-Onalaska, WI-MN MSA",2023,9,90710,88202,2508,2.8
MT5531540000000,55,31540,"Madison, WI MSA",2023,9,408670,398742,9928,2.4
MT5533340000000,55,33340,"Milwaukee-Waukesha, WI MSA",2023,9,821997,795832,26165,3.2
MT5536780000000,55,36780,"Oshkosh-Neenah, WI MSA",2023,9,93139,90643,2496,2.7
MT5539540000000,55,39540,"Racine-Mount Pleasant, WI MSA",2023,9,101633,98152,3481,3.4
MT5543100000000,55,43100,"Sheboygan, WI MSA",2023,9,63412,61814,1598,2.5
MT5548140000000,55,48140,"Wausau, WI MSA",2023,9,74730,72699,2031,2.7
MT5616220000000,56,16220,"Casper, WY MSA",2023,9,42199,40974,1225,2.9
MT5616940000000,56,16940,"Cheyenne, WY MSA",2023,9,48749,47335,1414,2.9
MT7210380000000,72,10380,"Aguadilla, PR MSA",2023,9,88585,82337,6248,7.1
MT7211640000000,72,11640,"Arecibo, PR MSA",2023,9,66461,62412,4049,6.1
MT7225020000000,72,25020,"Guayama, PR MSA",2023,9,19052,17297,1755,9.2
MT7232420000000,72,32420,"Mayaguez, PR MSA",2023,9,66243,61477,4766,7.2
MT7238660000000,72,38660,"Ponce, PR MSA",2023,9,88947,81106,7841,8.8
MT7241980000000,72,41980,"San Juan-Bayamon-Caguas, PR MSA",2023,9,814415,773965,40450,5
MT0111500000000,1,11500,"Anniston-Oxford, AL MSA",2023,10,49209,47823,1386,2.8
MT0112220000000,1,12220,"Auburn-Opelika, AL MSA",2023,10,95312,93019,2293,2.4
MT0113820000000,1,13820,"Birmingham, AL MSA",2023,10,565683,551849,13834,2.4
MT0119300000000,1,19300,"Daphne-Fairhope-Foley, AL MSA",2023,10,114487,111834,2653,2.3
MT0119460000000,1,19460,"Decatur, AL MSA",2023,10,74556,72856,1700,2.3
MT0120020000000,1,20020,"Dothan, AL MSA",2023,10,67551,65724,1827,2.7
MT0122520000000,1,22520,"Florence-Muscle Shoals, AL MSA",2023,10,68167,66193,1974,2.9
MT0123460000000,1,23460,"Gadsden, AL MSA",2023,10,41434,40264,1170,2.8
MT0126620000000,1,26620,"Huntsville, AL MSA",2023,10,271035,265103,5932,2.2
MT0133660000000,1,33660,"Mobile, AL MSA",2023,10,183544,177249,6295,3.4
MT0133860000000,1,33860,"Montgomery, AL MSA",2023,10,175393,170652,4741,2.7
MT0146220000000,1,46220,"Tuscaloosa, AL MSA",2023,10,125695,122212,3483,2.8
MT0211260000000,2,11260,"Anchorage, AK MSA",2023,10,200447,192270,8177,4.1
MT0221820000000,2,21820,"Fairbanks-College, AK MSA",2023,10,45270,43495,1775,3.9
MT0422380000000,4,22380,"Flagstaff, AZ MSA",2023,10,74582,71539,3043,4.1
MT0429420000000,4,29420,"Lake Havasu City-Kingman, AZ MSA",2023,10,87096,83268,3828,4.4
MT0438060000000,4,38060,"Phoenix-Mesa-Chandler, AZ MSA",2023,10,2686474,2598250,88224,3.3
MT0439150000000,4,39150,"Prescott Valley-Prescott, AZ MSA",2023,10,105768,102017,3751,3.5
MT0443420000000,4,43420,"Sierra Vista-Douglas, AZ MSA",2023,10,47966,45917,2049,4.3
MT0446060000000,4,46060,"Tucson, AZ MSA",2023,10,496450,478437,18013,3.6
MT0449740000000,4,49740,"Yuma, AZ MSA",2023,10,98796,86656,12140,12.3
MT0522220000000,5,22220,"Fayetteville-Springdale-Rogers, AR MSA",2023,10,300456,292537,7919,2.6
MT0522900000000,5,22900,"Fort Smith, AR-OK MSA",2023,10,101705,97886,3819,3.8
MT0526300000000,5,26300,"Hot Springs, AR MSA",2023,10,43861,42285,1576,3.6
MT0527860000000,5,27860,"Jonesboro, AR MSA",2023,10,65292,63266,2026,3.1
MT0530780000000,5,30780,"Little Rock-North Little Rock-Conway, AR MSA",2023,10,375171,363286,11885,3.2
MT0612540000000,6,12540,"Bakersfield-Delano, CA MSA",2023,10,404591,370491,34100,8.4
MT0617020000000,6,17020,"Chico, CA MSA",2023,10,90924,85971,4953,5.4
MT0620940000000,6,20940,"El Centro, CA MSA",2023,10,72377,59262,13115,18.1
MT0623420000000,6,23420,"Fresno, CA MSA",2023,10,532185,491604,40581,7.6
MT0625260000000,6,25260,"Hanford-Corcoran, CA MSA",2023,10,57641,52623,5018,8.7
MT0631080000000,6,31080,"Los Angeles-Long Beach-Anaheim, CA MSA",2023,10,6688454,6359021,329433,4.9
MT0632900000000,6,32900,"Merced, CA MSA",2023,10,119721,108606,11115,9.3
MT0633700000000,6,33700,"Modesto, CA MSA",2023,10,250844,234394,16450,6.6
MT0634900000000,6,34900,"Napa, CA MSA",2023,10,73486,70894,2592,3.5
MT0637100000000,6,37100,"Oxnard-Thousand Oaks-Ventura, CA MSA",2023,10,418825,400207,18618,4.4
MT0639820000000,6,39820,"Redding, CA MSA",2023,10,78540,74606,3934,5
MT0640140000000,6,40140,"Riverside-San Bernardino-Ontario, CA MSA",2023,10,2195715,2086429,109286,5
MT0640900000000,6,40900,"Sacramento-Roseville-Folsom, CA MSA",2023,10,1171508,1119413,52095,4.4
MT0641500000000,6,41500,"Salinas, CA MSA",2023,10,219503,203991,15512,7.1
MT0641740000000,6,41740,"San Diego-Chula Vista-Carlsbad, CA MSA",2023,10,1642334,1576100,66234,4
MT0641860000000,6,41860,"San Francisco-Oakland-Fremont, CA MSA",2023,10,2511474,2412016,99458,4
MT0641940000000,6,41940,"San Jose-Sunnyvale-Santa Clara, CA MSA",2023,10,1056847,1014297,42550,4
MT0642020000000,6,42020,"San Luis Obispo-Paso Robles, CA MSA",2023,10,132651,127623,5028,3.8
MT0642100000000,6,42100,"Santa Cruz-Watsonville, CA MSA",2023,10,135524,127738,7786,5.7
MT0642200000000,6,42200,"Santa Maria-Santa Barbara, CA MSA",2023,10,220940,211631,9309,4.2
MT0642220000000,6,42220,"Santa Rosa-Petaluma, CA MSA",2023,10,247257,237833,9424,3.8
MT0644700000000,6,44700,"Stockton-Lodi, CA MSA",2023,10,366421,343466,22955,6.3
MT0646700000000,6,46700,"Vallejo, CA MSA",2023,10,215991,205986,10005,4.6
MT0647300000000,6,47300,"Visalia, CA MSA",2023,10,219760,197631,22129,10.1
MT0649700000000,6,49700,"Yuba City, CA MSA",2023,10,80401,74466,5935,7.4
MT0814500000000,8,14500,"Boulder, CO MSA",2023,10,194013,187247,6766,3.5
MT0817820000000,8,17820,"Colorado Springs, CO MSA",2023,10,391962,377640,14322,3.7
MT0819740000000,8,19740,"Denver-Aurora-Centennial, CO MSA",2023,10,1764889,1702034,62855,3.6
MT0822660000000,8,22660,"Fort Collins-Loveland, CO MSA",2023,10,208470,201348,7122,3.4
MT0824300000000,8,24300,"Grand Junction, CO MSA",2023,10,79010,75968,3042,3.9
MT0824540000000,8,24540,"Greeley, CO MSA",2023,10,175386,168727,6659,3.8
MT0839380000000,8,39380,"Pueblo, CO MSA",2023,10,73620,69902,3718,5.1
MT0914860000000,9,14860,"Bridgeport-Stamford-Danbury, CT MSA",2023,10,509468,493311,16157,3.2
MT0925540000000,9,25540,"Hartford-West Hartford-East Hartford, CT MSA",2023,10,607864,588366,19498,3.2
MT0935300000000,9,35300,"New Haven, CT MSA",2023,10,312399,302390,10009,3.2
MT0935980000000,9,35980,"Norwich-New London-Willimantic, CT MSA",2023,10,140889,136315,4574,3.2
MT0947930000000,9,47930,"Waterbury-Shelton, CT MSA",2023,10,238386,229479,8907,3.7
MT1020100000000,10,20100,"Dover, DE MSA",2023,10,85758,82192,3566,4.2
MT1147900000000,11,47900,"Washington-Arlington-Alexandria, DC-VA-MD-WV MSA",2023,10,3525962,3431677,94285,2.7
MT1215980000000,12,15980,"Cape Coral-Fort Myers, FL MSA",2023,10,374719,362193,12526,3.3
MT1218880000000,12,18880,"Crestview-Fort Walton Beach-Destin, FL MSA",2023,10,142564,138479,4085,2.9
MT1219660000000,12,19660,"Deltona-Daytona Beach-Ormond Beach, FL MSA",2023,10,321002,309351,11651,3.6
MT1223540000000,12,23540,"Gainesville, FL MSA",2023,10,169371,163449,5922,3.5
MT1226140000000,12,26140,"Homosassa Springs, FL MSA",2023,10,53952,51420,2532,4.7
MT1227260000000,12,27260,"Jacksonville, FL MSA",2023,10,852454,824595,27859,3.3
MT1229460000000,12,29460,"Lakeland-Winter Haven, FL MSA",2023,10,357512,343731,13781,3.9
MT1233100000000,12,33100,"Miami-Fort Lauderdale-West Palm Beach, FL MSA",2023,10,3292753,3208632,84121,2.6
MT1234940000000,12,34940,"Naples-Marco Island, FL MSA",2023,10,183548,177898,5650,3.1
MT1235840000000,12,35840,"North Port-Bradenton-Sarasota, FL MSA",2023,10,394827,381858,12969,3.3
MT1236100000000,12,36100,"Ocala, FL MSA",2023,10,157656,151518,6138,3.9
MT1236740000000,12,36740,"Orlando-Kissimmee-Sanford, FL MSA",2023,10,1521968,1475033,46935,3.1
MT1237340000000,12,37340,"Palm Bay-Melbourne-Titusville, FL MSA",2023,10,305252,295316,9936,3.3
MT1237460000000,12,37460,"Panama City-Panama City Beach, FL MSA",2023,10,101114,97945,3169,3.1
MT1237860000000,12,37860,"Pensacola-Ferry Pass-Brent, FL MSA",2023,10,240956,233144,7812,3.2
MT1238940000000,12,38940,"Port St. Lucie, FL MSA",2023,10,238864,230340,8524,3.6
MT1239460000000,12,39460,"Punta Gorda, FL MSA",2023,10,75989,73112,2877,3.8
MT1242680000000,12,42680,"Sebastian-Vero Beach-West Vero Corridor, FL MSA",2023,10,68077,65459,2618,3.8
MT1242700000000,12,42700,"Sebring, FL MSA",2023,10,36522,34875,1647,4.5
MT1245220000000,12,45220,"Tallahassee, FL MSA",2023,10,205921,199288,6633,3.2
MT1245300000000,12,45300,"Tampa-St. Petersburg-Clearwater, FL MSA",2023,10,1701643,1647252,54391,3.2
MT1248680000000,12,48680,"Wildwood-The Villages, FL MSA",2023,10,33853,31942,1911,5.6
MT1310500000000,13,10500,"Albany, GA MSA",2023,10,62324,59924,2400,3.9
MT1312020000000,13,12020,"Athens-Clarke County, GA MSA",2023,10,108182,104954,3228,3
MT1312060000000,13,12060,"Atlanta-Sandy Springs-Roswell, GA MSA",2023,10,3283504,3176066,107438,3.3
MT1312260000000,13,12260,"Augusta-Richmond County, GA-SC MSA",2023,10,265777,255834,9943,3.7
MT1315260000000,13,15260,"Brunswick-St. Simons, GA MSA",2023,10,55042,53464,1578,2.9
MT1317980000000,13,17980,"Columbus, GA-AL MSA",2023,10,129858,125117,4741,3.7
MT1319140000000,13,19140,"Dalton, GA MSA",2023,10,67797,65520,2277,3.4
MT1323580000000,13,23580,"Gainesville, GA MSA",2023,10,108918,106073,2845,2.6
MT1325980000000,13,25980,"Hinesville, GA MSA",2023,10,31071,29897,1174,3.8
MT1331420000000,13,31420,"Macon-Bibb County, GA MSA",2023,10,97363,93681,3682,3.8
MT1340660000000,13,40660,"Rome, GA MSA",2023,10,48235,46755,1480,3.1
MT1342340000000,13,42340,"Savannah, GA MSA",2023,10,208695,202662,6033,2.9
MT1346660000000,13,46660,"Valdosta, GA MSA",2023,10,61516,59303,2213,3.6
MT1347580000000,13,47580,"Warner Robins, GA MSA",2023,10,89827,87192,2635,2.9
MT1527980000000,15,27980,"Kahului-Wailuku, HI MSA",2023,10,81628,75518,6110,7.5
MT1546520000000,15,46520,"Urban Honolulu, HI MSA",2023,10,468393,457060,11333,2.4
MT1614260000000,16,14260,"Boise City, ID MSA",2023,10,441455,427351,14104,3.2
MT1617660000000,16,17660,"Coeur d'Alene, ID MSA",2023,10,89417,85856,3561,4
MT1626820000000,16,26820,"Idaho Falls, ID MSA",2023,10,83915,81616,2299,2.7
MT1630300000000,16,30300,"Lewiston, ID-WA MSA",2023,10,30986,29951,1035,3.3
MT1638540000000,16,38540,"Pocatello, ID MSA",2023,10,40321,38845,1476,3.7
MT1646300000000,16,46300,"Twin Falls, ID MSA",2023,10,59509,57569,1940,3.3
MT1714010000000,17,14010,"Bloomington, IL MSA",2023,10,96172,92537,3635,3.8
MT1716580000000,17,16580,"Champaign-Urbana, IL MSA",2023,10,125135,119657,5478,4.4
MT1716980000000,17,16980,"Chicago-Naperville-Elgin, IL-IN MSA",2023,10,4931349,4698812,232537,4.7
MT1719340000000,17,19340,"Davenport-Moline-Rock Island, IA-IL MSA",2023,10,190559,182135,8424,4.4
MT1719500000000,17,19500,"Decatur, IL MSA",2023,10,44735,41931,2804,6.3
MT1728100000000,17,28100,"Kankakee, IL MSA",2023,10,51266,48128,3138,6.1
MT1737900000000,17,37900,"Peoria, IL MSA",2023,10,177105,168388,8717,4.9
MT1740420000000,17,40420,"Rockford, IL MSA",2023,10,161257,151002,10255,6.4
MT1744100000000,17,44100,"Springfield, IL MSA",2023,10,102622,98085,4537,4.4
MT1814020000000,18,14020,"Bloomington, IN MSA",2023,10,84398,81662,2736,3.2
MT1818020000000,18,18020,"Columbus, IN MSA",2023,10,39497,38153,1344,3.4
MT1821140000000,18,21140,"Elkhart-Goshen, IN MSA",2023,10,99332,94917,4415,4.4
MT1821780000000,18,21780,"Evansville, IN MSA",2023,10,134587,130074,4513,3.4
MT1823060000000,18,23060,"Fort Wayne, IN MSA",2023,10,230076,222544,7532,3.3
MT1826900000000,18,26900,"Indianapolis-Carmel-Greenwood, IN MSA",2023,10,1123764,1087042,36722,3.3
MT1829020000000,18,29020,"Kokomo, IN MSA",2023,10,35079,33457,1622,4.6
MT1829200000000,18,29200,"Lafayette-West Lafayette, IN MSA",2023,10,119886,116289,3597,3
MT1833140000000,18,33140,"Michigan City-La Porte, IN MSA",2023,10,51506,49457,2049,4
MT1834620000000,18,34620,"Muncie, IN MSA",2023,10,51764,49659,2105,4.1
MT1843780000000,18,43780,"South Bend-Mishawaka, IN-MI MSA",2023,10,153953,147490,6463,4.2
MT1845460000000,18,45460,"Terre Haute, IN MSA",2023,10,76487,73625,2862,3.7
MT1911180000000,19,11180,"Ames, IA MSA",2023,10,69626,67979,1647,2.4
MT1916300000000,19,16300,"Cedar Rapids, IA MSA",2023,10,147273,142526,4747,3.2
MT1919780000000,19,19780,"Des Moines-West Des Moines, IA MSA",2023,10,410118,398955,11163,2.7
MT1920220000000,19,20220,"Dubuque, IA MSA",2023,10,53604,51986,1618,3
MT1926980000000,19,26980,"Iowa City, IA MSA",2023,10,99403,96992,2411,2.4
MT1943580000000,19,43580,"Sioux City, IA-NE-SD MSA",2023,10,76965,74755,2210,2.9
MT1947940000000,19,47940,"Waterloo-Cedar Falls, IA MSA",2023,10,88531,85948,2583,2.9
MT2029940000000,20,29940,"Lawrence, KS MSA",2023,10,70319,68463,1856,2.6
MT2031740000000,20,31740,"Manhattan, KS MSA",2023,10,63486,61725,1761,2.8
MT2045820000000,20,45820,"Topeka, KS MSA",2023,10,118038,114473,3565,3
MT2048620000000,20,48620,"Wichita, KS MSA",2023,10,333209,322777,10432,3.1
MT2114540000000,21,14540,"Bowling Green, KY MSA",2023,10,91077,87240,3837,4.2
MT2121060000000,21,21060,"Elizabethtown, KY MSA",2023,10,55130,52691,2439,4.4
MT2130460000000,21,30460,"Lexington-Fayette, KY MSA",2023,10,273343,263113,10230,3.7
MT2131140000000,21,31140,"Louisville/Jefferson County, KY-IN MSA",2023,10,691155,663811,27344,4
MT2136980000000,21,36980,"Owensboro, KY MSA",2023,10,51001,48678,2323,4.6
MT2137140000000,21,37140,"Paducah, KY-IL MSA",2023,10,45872,43743,2129,4.6
MT2210780000000,22,10780,"Alexandria, LA MSA",2023,10,64425,62022,2403,3.7
MT2212940000000,22,12940,"Baton Rouge, LA MSA",2023,10,423916,408009,15907,3.8
MT2225220000000,22,25220,"Hammond, LA MSA",2023,10,60185,57551,2634,4.4
MT2226380000000,22,26380,"Houma-Bayou Cane-Thibodaux, LA MSA",2023,10,88716,85707,3009,3.4
MT2229180000000,22,29180,"Lafayette, LA MSA",2023,10,197283,190517,6766,3.4
MT2229340000000,22,29340,"Lake Charles, LA MSA",2023,10,97651,93671,3980,4.1
MT2233740000000,22,33740,"Monroe, LA MSA",2023,10,95963,91659,4304,4.5
MT2235380000000,22,35380,"New Orleans-Metairie, LA MSA",2023,10,467369,448372,18997,4.1
MT2243340000000,22,43340,"Shreveport-Bossier City, LA MSA",2023,10,168517,161678,6839,4.1
MT2243640000000,22,43640,"Slidell-Mandeville-Covington, LA MSA",2023,10,129085,124584,4501,3.5
MT2312620000000,23,12620,"Bangor, ME MSA",2023,10,74829,72463,2366,3.2
MT2330340000000,23,30340,"Lewiston-Auburn, ME MSA",2023,10,55133,53552,1581,2.9
MT2338860000000,23,38860,"Portland-South Portland, ME MSA",2023,10,310545,303091,7454,2.4
MT2412580000000,24,12580,"Baltimore-Columbia-Towson, MD MSA",2023,10,1482287,1445384,36903,2.5
MT2425180000000,24,25180,"Hagerstown-Martinsburg, MD-WV MSA",2023,10,142840,138316,4524,3.2
MT2430500000000,24,30500,"Lexington Park, MD MSA",2023,10,107796,105429,2367,2.2
MT2441540000000,24,41540,"Salisbury, MD MSA",2023,10,64206,62451,1755,2.7
MT2511200000000,25,11200,"Amherst Town-Northampton, MA MSA",2023,10,84093,81299,2794,3.3
MT2512700000000,25,12700,"Barnstable Town, MA MSA",2023,10,114874,109695,5179,4.5
MT2514460000000,25,14460,"Boston-Cambridge-Newton, MA-NH MSA",2023,10,2786718,2696348,90370,3.2
MT2538340000000,25,38340,"Pittsfield, MA MSA",2023,10,63942,61558,2384,3.7
MT2544140000000,25,44140,"Springfield, MA MSA",2023,10,221763,211604,10159,4.6
MT2549340000000,25,49340,"Worcester, MA MSA",2023,10,460176,443322,16854,3.7
MT2611460000000,26,11460,"Ann Arbor, MI MSA",2023,10,206735,200054,6681,3.2
MT2612980000000,26,12980,"Battle Creek, MI MSA",2023,10,62477,59750,2727,4.4
MT2613020000000,26,13020,"Bay City, MI MSA",2023,10,50221,47748,2473,4.9
MT2619820000000,26,19820,"Detroit-Warren-Dearborn, MI MSA",2023,10,2188170,2103863,84307,3.9
MT2622420000000,26,22420,"Flint, MI MSA",2023,10,187070,177898,9172,4.9
MT2624340000000,26,24340,"Grand Rapids-Wyoming-Kentwood, MI MSA",2023,10,628685,607164,21521,3.4
MT2627100000000,26,27100,"Jackson, MI MSA",2023,10,75138,71989,3149,4.2
MT2628020000000,26,28020,"Kalamazoo-Portage, MI MSA",2023,10,139479,134427,5052,3.6
MT2629620000000,26,29620,"Lansing-East Lansing, MI MSA",2023,10,252300,242706,9594,3.8
MT2633220000000,26,33220,"Midland, MI MSA",2023,10,42735,41112,1623,3.8
MT2633780000000,26,33780,"Monroe, MI MSA",2023,10,78630,75240,3390,4.3
MT2634740000000,26,34740,"Muskegon-Norton Shores, MI MSA",2023,10,84283,80625,3658,4.3
MT2635660000000,26,35660,"Niles, MI MSA",2023,10,76352,73139,3213,4.2
MT2640980000000,26,40980,"Saginaw, MI MSA",2023,10,85168,80810,4358,5.1
MT2645900000000,26,45900,"Traverse City, MI MSA",2023,10,80979,77808,3171,3.9
MT2720260000000,27,20260,"Duluth, MN-WI MSA",2023,10,139392,134785,4607,3.3
MT2731860000000,27,31860,"Mankato, MN MSA",2023,10,60057,58670,1387,2.3
MT2733460000000,27,33460,"Minneapolis-St. Paul-Bloomington, MN-WI MSA",2023,10,2060061,2006207,53854,2.6
MT2740340000000,27,40340,"Rochester, MN MSA",2023,10,125638,122749,2889,2.3
MT2741060000000,27,41060,"St. Cloud, MN MSA",2023,10,109496,106331,3165,2.9
MT2825060000000,28,25060,"Gulfport-Biloxi, MS MSA",2023,10,184675,179507,5168,2.8
MT2825620000000,28,25620,"Hattiesburg, MS MSA",2023,10,69819,67910,1909,2.7
MT2827140000000,28,27140,"Jackson, MS MSA",2023,10,276715,269212,7503,2.7
MT2916020000000,29,16020,"Cape Girardeau, MO-IL MSA",2023,10,49114,47595,1519,3.1
MT2917860000000,29,17860,"Columbia, MO MSA",2023,10,112396,109184,3212,2.9
MT2927620000000,29,27620,"Jefferson City, MO MSA",2023,10,75537,73358,2179,2.9
MT2927900000000,29,27900,"Joplin, MO-KS MSA",2023,10,97221,94078,3143,3.2
MT2928140000000,29,28140,"Kansas City, MO-KS MSA",2023,10,1188054,1150328,37726,3.2
MT2941140000000,29,41140,"St. Joseph, MO-KS MSA",2023,10,53901,52078,1823,3.4
MT2941180000000,29,41180,"St. Louis, MO-IL MSA",2023,10,1479818,1427791,52027,3.5
MT2944180000000,29,44180,"Springfield, MO MSA",2023,10,240494,233280,7214,3
MT3013740000000,30,13740,"Billings, MT MSA",2023,10,99256,96603,2653,2.7
MT3014580000000,30,14580,"Bozeman, MT MSA",2023,10,76487,74765,1722,2.3
MT3024500000000,30,24500,"Great Falls, MT MSA",2023,10,40020,38863,1157,2.9
MT3025740000000,30,25740,"Helena, MT MSA",2023,10,47173,45861,1312,2.8
MT3033540000000,30,33540,"Missoula, MT MSA",2023,10,74028,71932,2096,2.8
MT3124260000000,31,24260,"Grand Island, NE MSA",2023,10,42470,41454,1016,2.4
MT3130700000000,31,30700,"Lincoln, NE MSA",2023,10,191767,187339,4428,2.3
MT3136540000000,31,36540,"Omaha, NE-IA MSA",2023,10,523089,508974,14115,2.7
MT3216180000000,32,16180,"Carson City, NV MSA",2023,10,28862,27602,1260,4.4
MT3229820000000,32,29820,"Las Vegas-Henderson-North Las Vegas, NV MSA",2023,10,1198068,1132954,65114,5.4
MT3239900000000,32,39900,"Reno, NV MSA",2023,10,297234,283921,13313,4.5
MT3331700000000,33,31700,"Manchester-Nashua, NH MSA",2023,10,239688,233865,5823,2.4
MT3412100000000,34,12100,"Atlantic City-Hammonton, NJ MSA",2023,10,180119,169030,11089,6.2
MT3445940000000,34,45940,"Trenton-Princeton, NJ MSA",2023,10,198876,190222,8654,4.4
MT3447220000000,34,47220,"Vineland, NJ MSA",2023,10,65840,61218,4622,7
MT3510740000000,35,10740,"Albuquerque, NM MSA",2023,10,459301,442949,16352,3.6
MT3522140000000,35,22140,"Farmington, NM MSA",2023,10,49426,47365,2061,4.2
MT3529740000000,35,29740,"Las Cruces, NM MSA",2023,10,101091,96693,4398,4.4
MT3542140000000,35,42140,"Santa Fe, NM MSA",2023,10,73734,71150,2584,3.5
MT3610580000000,36,10580,"Albany-Schenectady-Troy, NY MSA",2023,10,459689,444048,15641,3.4
MT3613780000000,36,13780,"Binghamton, NY MSA",2023,10,107589,103348,4241,3.9
MT3615380000000,36,15380,"Buffalo-Cheektowaga, NY MSA",2023,10,562934,540850,22084,3.9
MT3621300000000,36,21300,"Elmira, NY MSA",2023,10,35889,34478,1411,3.9
MT3624020000000,36,24020,"Glens Falls, NY MSA",2023,10,59851,57665,2186,3.7
MT3627060000000,36,27060,"Ithaca, NY MSA",2023,10,48618,46967,1651,3.4
MT3628740000000,36,28740,"Kingston, NY MSA",2023,10,88061,84801,3260,3.7
MT3628880000000,36,28880,"Kiryas Joel-Poughkeepsie-Newburgh, NY MSA",2023,10,341999,329792,12207,3.6
MT3635620000000,36,35620,"New York-Newark-Jersey City, NY-NJ MSA",2023,10,10149720,9703637,446083,4.4
MT3640380000000,36,40380,"Rochester, NY MSA",2023,10,517417,498253,19164,3.7
MT3645060000000,36,45060,"Syracuse, NY MSA",2023,10,312624,300894,11730,3.8
MT3646540000000,36,46540,"Utica-Rome, NY MSA",2023,10,128331,123374,4957,3.9
MT3648060000000,36,48060,"Watertown-Fort Drum, NY MSA",2023,10,45241,43198,2043,4.5
MT3711700000000,37,11700,"Asheville, NC MSA",2023,10,211798,205610,6188,2.9
MT3715500000000,37,15500,"Burlington, NC MSA",2023,10,86124,83088,3036,3.5
MT3716740000000,37,16740,"Charlotte-Concord-Gastonia, NC-SC MSA",2023,10,1477784,1427326,50458,3.4
MT3720500000000,37,20500,"Durham-Chapel Hill, NC MSA",2023,10,321953,311716,10237,3.2
MT3722180000000,37,22180,"Fayetteville, NC MSA",2023,10,156203,149337,6866,4.4
MT3724140000000,37,24140,"Goldsboro, NC MSA",2023,10,50523,48638,1885,3.7
MT3724660000000,37,24660,"Greensboro-High Point, NC MSA",2023,10,373353,358795,14558,3.9
MT3724780000000,37,24780,"Greenville, NC MSA",2023,10,84155,80711,3444,4.1
MT3725860000000,37,25860,"Hickory-Lenoir-Morganton, NC MSA",2023,10,172620,166670,5950,3.4
MT3727340000000,37,27340,"Jacksonville, NC MSA",2023,10,74592,71851,2741,3.7
MT3738240000000,37,38240,"Pinehurst-Southern Pines, NC MSA",2023,10,44484,42925,1559,3.5
MT3739580000000,37,39580,"Raleigh-Cary, NC MSA",2023,10,840490,814469,26021,3.1
MT3740580000000,37,40580,"Rocky Mount, NC MSA",2023,10,63706,60684,3022,4.7
MT3748900000000,37,48900,"Wilmington, NC MSA",2023,10,222769,214780,7989,3.6
MT3749180000000,37,49180,"Winston-Salem, NC MSA",2023,10,325594,313942,11652,3.6
MT3813900000000,38,13900,"Bismarck, ND MSA",2023,10,72481,70985,1496,2.1
MT3822020000000,38,22020,"Fargo, ND-MN MSA",2023,10,152826,149866,2960,1.9
MT3824220000000,38,24220,"Grand Forks, ND-MN MSA",2023,10,55723,54498,1225,2.2
MT3833500000000,38,33500,"Minot, ND MSA",2023,10,39987,39106,881,2.2
MT3910420000000,39,10420,"Akron, OH MSA",2023,10,357474,343361,14113,3.9
MT3915940000000,39,15940,"Canton-Massillon, OH MSA",2023,10,192724,184743,7981,4.1
MT3917140000000,39,17140,"Cincinnati, OH-KY-IN MSA",2023,10,1164265,1121660,42605,3.7
MT3917410000000,39,17410,"Cleveland, OH MSA",2023,10,1089894,1049182,40712,3.7
MT3918140000000,39,18140,"Columbus, OH MSA",2023,10,1142471,1103172,39299,3.4
MT3919430000000,39,19430,"Dayton-Kettering-Beavercreek, OH MSA",2023,10,390173,374966,15207,3.9
MT3930620000000,39,30620,"Lima, OH MSA",2023,10,47223,45393,1830,3.9
MT3931900000000,39,31900,"Mansfield, OH MSA",2023,10,52971,50657,2314,4.4
MT3941780000000,39,41780,"Sandusky, OH MSA",2023,10,56984,54229,2755,4.8
MT3944220000000,39,44220,"Springfield, OH MSA",2023,10,62166,59642,2524,4.1
MT3945780000000,39,45780,"Toledo, OH MSA",2023,10,294926,282285,12641,4.3
MT3948260000000,39,48260,"Weirton-Steubenville, WV-OH MSA",2023,10,51976,49222,2754,5.3
MT3949660000000,39,49660,"Youngstown-Warren, OH MSA",2023,10,191223,182594,8629,4.5
MT4021420000000,40,21420,"Enid, OK MSA",2023,10,28515,27573,942,3.3
MT4030020000000,40,30020,"Lawton, OK MSA",2023,10,52283,50193,2090,4
MT4036420000000,40,36420,"Oklahoma City, OK MSA",2023,10,767541,743067,24474,3.2
MT4046140000000,40,46140,"Tulsa, OK MSA",2023,10,521304,503289,18015,3.5
MT4110540000000,41,10540,"Albany, OR MSA",2023,10,61350,58713,2637,4.3
MT4113460000000,41,13460,"Bend, OR MSA",2023,10,130991,125638,5353,4.1
MT4118700000000,41,18700,"Corvallis, OR MSA",2023,10,49115,47422,1693,3.4
MT4121660000000,41,21660,"Eugene-Springfield, OR MSA",2023,10,186931,179289,7642,4.1
MT4124420000000,41,24420,"Grants Pass, OR MSA",2023,10,34968,33054,1914,5.5
MT4132780000000,41,32780,"Medford, OR MSA",2023,10,105656,100766,4890,4.6
MT4138900000000,41,38900,"Portland-Vancouver-Hillsboro, OR-WA MSA",2023,10,1381365,1328942,52423,3.8
MT4141420000000,41,41420,"Salem, OR MSA",2023,10,218584,210064,8520,3.9
MT4210900000000,42,10900,"Allentown-Bethlehem-Easton, PA-NJ MSA",2023,10,452118,433475,18643,4.1
MT4211020000000,42,11020,"Altoona, PA MSA",2023,10,57671,55591,2080,3.6
MT4216540000000,42,16540,"Chambersburg, PA MSA",2023,10,76767,74365,2402,3.1
MT4221500000000,42,21500,"Erie, PA MSA",2023,10,127446,122239,5207,4.1
MT4223900000000,42,23900,"Gettysburg, PA MSA",2023,10,52609,51032,1577,3
MT4225420000000,42,25420,"Harrisburg-Carlisle, PA MSA",2023,10,314794,304564,10230,3.2
MT4227780000000,42,27780,"Johnstown, PA MSA",2023,10,57327,54853,2474,4.3
MT4229540000000,42,29540,"Lancaster, PA MSA",2023,10,294697,286149,8548,2.9
MT4230140000000,42,30140,"Lebanon, PA MSA",2023,10,74204,71862,2342,3.2
MT4237980000000,42,37980,"Philadelphia-Camden-Wilmington, PA-NJ-DE-MD MSA",2023,10,3304062,3178395,125667,3.8
MT4238300000000,42,38300,"Pittsburgh, PA MSA",2023,10,1240695,1195801,44894,3.6
MT4239740000000,42,39740,"Reading, PA MSA",2023,10,220735,212446,8289,3.8
MT4242540000000,42,42540,"Scranton--Wilkes-Barre, PA MSA",2023,10,281105,268936,12169,4.3
MT4244300000000,42,44300,"State College, PA MSA",2023,10,77798,75614,2184,2.8
MT4248700000000,42,48700,"Williamsport, PA MSA",2023,10,53393,51293,2100,3.9
MT4249620000000,42,49620,"York-Hanover, PA MSA",2023,10,241950,234101,7849,3.2
MT4439300000000,44,39300,"Providence-Warwick, RI-MA MSA",2023,10,888837,856449,32388,3.6
MT4516700000000,45,16700,"Charleston-North Charleston, SC MSA",2023,10,435835,424631,11204,2.6
MT4517900000000,45,17900,"Columbia, SC MSA",2023,10,412754,400767,11987,2.9
MT4522500000000,45,22500,"Florence, SC MSA",2023,10,91475,88442,3033,3.3
MT4524860000000,45,24860,"Greenville-Anderson-Greer, SC MSA",2023,10,472361,459088,13273,2.8
MT4525940000000,45,25940,"Hilton Head Island-Bluffton-Port Royal, SC MSA",2023,10,97046,94332,2714,2.8
MT4534820000000,45,34820,"Myrtle Beach-Conway-North Myrtle Beach, SC MSA",2023,10,168441,162466,5975,3.5
MT4543900000000,45,43900,"Spartanburg, SC MSA",2023,10,174077,168631,5446,3.1
MT4544940000000,45,44940,"Sumter, SC MSA",2023,10,41385,39801,1584,3.8
MT4639660000000,46,39660,"Rapid City, SD MSA",2023,10,79038,77603,1435,1.8
MT4643620000000,46,43620,"Sioux Falls, SD-MN MSA",2023,10,172504,169571,2933,1.7
MT4716860000000,47,16860,"Chattanooga, TN-GA MSA",2023,10,287751,279074,8677,3
MT4717300000000,47,17300,"Clarksville, TN-KY MSA",2023,10,136252,130860,5392,4
MT4717420000000,47,17420,"Cleveland, TN MSA",2023,10,56751,54766,1985,3.5
MT4727180000000,47,27180,"Jackson, TN MSA",2023,10,78240,75486,2754,3.5
MT4727740000000,47,27740,"Johnson City, TN MSA",2023,10,96517,93309,3208,3.3
MT4728700000000,47,28700,"Kingsport-Bristol, TN-VA MSA",2023,10,132695,128116,4579,3.5
MT4728940000000,47,28940,"Knoxville, TN MSA",2023,10,447362,433741,13621,3
MT4732820000000,47,32820,"Memphis, TN-MS-AR MSA",2023,10,623958,600100,23858,3.8
MT4734100000000,47,34100,"Morristown, TN MSA",2023,10,52851,51015,1836,3.5
MT4734980000000,47,34980,"Nashville-Davidson--Murfreesboro--Franklin, TN MSA",2023,10,1148519,1117793,30726,2.7
MT4810180000000,48,10180,"Abilene, TX MSA",2023,10,85202,82362,2840,3.3
MT4811100000000,48,11100,"Amarillo, TX MSA",2023,10,135812,131678,4134,3
MT4812420000000,48,12420,"Austin-Round Rock-San Marcos, TX MSA",2023,10,1469520,1418155,51365,3.5
MT4813140000000,48,13140,"Beaumont-Port Arthur, TX MSA",2023,10,176347,167152,9195,5.2
MT4815180000000,48,15180,"Brownsville-Harlingen, TX MSA",2023,10,186576,177055,9521,5.1
MT4817780000000,48,17780,"College Station-Bryan, TX MSA",2023,10,147700,142787,4913,3.3
MT4818580000000,48,18580,"Corpus Christi, TX MSA",2023,10,207692,198978,8714,4.2
MT4819100000000,48,19100,"Dallas-Fort Worth-Arlington, TX MSA",2023,10,4409581,4242516,167065,3.8
MT4820580000000,48,20580,"Eagle Pass, TX MSA",2023,10,23740,22024,1716,7.2
MT4821340000000,48,21340,"El Paso, TX MSA",2023,10,404552,387432,17120,4.2
MT4826420000000,48,26420,"Houston-Pasadena-The Woodlands, TX MSA",2023,10,3765535,3608880,156655,4.2
MT4828660000000,48,28660,"Killeen-Temple, TX MSA",2023,10,199024,190705,8319,4.2
MT4829700000000,48,29700,"Laredo, TX MSA",2023,10,116180,111585,4595,4
MT4830980000000,48,30980,"Longview, TX MSA",2023,10,128371,122723,5648,4.4
MT4831180000000,48,31180,"Lubbock, TX MSA",2023,10,181395,175364,6031,3.3
MT4832580000000,48,32580,"McAllen-Edinburg-Mission, TX MSA",2023,10,390164,367250,22914,5.9
MT4833260000000,48,33260,"Midland, TX MSA",2023,10,100679,97933,2746,2.7
MT4836220000000,48,36220,"Odessa, TX MSA",2023,10,83870,81106,2764,3.3
MT4841660000000,48,41660,"San Angelo, TX MSA",2023,10,60934,59026,1908,3.1
MT4841700000000,48,41700,"San Antonio-New Braunfels, TX MSA",2023,10,1311633,1263766,47867,3.6
MT4843300000000,48,43300,"Sherman-Denison, TX MSA",2023,10,70479,67858,2621,3.7
MT4845500000000,48,45500,"Texarkana, TX-AR MSA",2023,10,60932,58520,2412,4
MT4846340000000,48,46340,"Tyler, TX MSA",2023,10,115929,111754,4175,3.6
MT4847020000000,48,47020,"Victoria, TX MSA",2023,10,44584,42827,1757,3.9
MT4847380000000,48,47380,"Waco, TX MSA",2023,10,144354,139154,5200,3.6
MT4848660000000,48,48660,"Wichita Falls, TX MSA",2023,10,66382,63981,2401,3.6
MT4930860000000,49,30860,"Logan, UT-ID MSA",2023,10,79169,77141,2028,2.6
MT4936260000000,49,36260,"Ogden, UT MSA",2023,10,349042,339799,9243,2.6
MT4939340000000,49,39340,"Provo-Orem-Lehi, UT MSA",2023,10,365841,355349,10492,2.9
MT4941100000000,49,41100,"St. George, UT MSA",2023,10,91628,88814,2814,3.1
MT4941620000000,49,41620,"Salt Lake City-Murray, UT MSA",2023,10,730342,709465,20877,2.9
MT5015540000000,50,15540,"Burlington-South Burlington, VT MSA",2023,10,130751,128613,2138,1.6
MT5113980000000,51,13980,"Blacksburg-Christiansburg-Radford, VA MSA",2023,10,94660,91987,2673,2.8
MT5116820000000,51,16820,"Charlottesville, VA MSA",2023,10,119754,116816,2938,2.5
MT5125500000000,51,25500,"Harrisonburg, VA MSA",2023,10,72653,70734,1919,2.6
MT5131340000000,51,31340,"Lynchburg, VA MSA",2023,10,128628,124604,4024,3.1
MT5140060000000,51,40060,"Richmond, VA MSA",2023,10,724157,703063,21094,2.9
MT5140220000000,51,40220,"Roanoke, VA MSA",2023,10,158235,153836,4399,2.8
MT5144420000000,51,44420,"Staunton-Stuarts Draft, VA MSA",2023,10,65619,64026,1593,2.4
MT5147260000000,51,47260,"Virginia Beach-Chesapeake-Norfolk, VA-NC MSA",2023,10,883906,857619,26287,3
MT5149020000000,51,49020,"Winchester, VA-WV MSA",2023,10,77379,75284,2095,2.7
MT5313380000000,53,13380,"Bellingham, WA MSA",2023,10,114211,108983,5228,4.6
MT5314740000000,53,14740,"Bremerton-Silverdale-Port Orchard, WA MSA",2023,10,122665,117005,5660,4.6
MT5328420000000,53,28420,"Kennewick-Richland, WA MSA",2023,10,144999,137435,7564,5.2
MT5331020000000,53,31020,"Longview-Kelso, WA MSA",2023,10,47420,44887,2533,5.3
MT5334580000000,53,34580,"Mount Vernon-Anacortes, WA MSA",2023,10,58930,55921,3009,5.1
MT5336500000000,53,36500,"Olympia-Lacey-Tumwater, WA MSA",2023,10,143045,136534,6511,4.6
MT5342660000000,53,42660,"Seattle-Tacoma-Bellevue, WA MSA",2023,10,2313617,2216466,97151,4.2
MT5344060000000,53,44060,"Spokane-Spokane Valley, WA MSA",2023,10,282806,269721,13085,4.6
MT5347460000000,53,47460,"Walla Walla, WA MSA",2023,10,29211,27964,1247,4.3
MT5348300000000,53,48300,"Wenatchee-East Wenatchee, WA MSA",2023,10,61664,58680,2984,4.8
MT5349420000000,53,49420,"Yakima, WA MSA",2023,10,125871,118168,7703,6.1
MT5413220000000,54,13220,"Beckley, WV MSA",2023,10,46249,44335,1914,4.1
MT5416620000000,54,16620,"Charleston, WV MSA",2023,10,91675,87965,3710,4
MT5426580000000,54,26580,"Huntington-Ashland, WV-KY-OH MSA",2023,10,156490,149116,7374,4.7
MT5434060000000,54,34060,"Morgantown, WV MSA",2023,10,71297,68767,2530,3.5
MT5437620000000,54,37620,"Parkersburg-Vienna, WV MSA",2023,10,39800,38073,1727,4.3
MT5448540000000,54,48540,"Wheeling, WV-OH MSA",2023,10,59489,56666,2823,4.7
MT5511540000000,55,11540,"Appleton, WI MSA",2023,10,137027,133557,3470,2.5
MT5520740000000,55,20740,"Eau Claire, WI MSA",2023,10,95799,92971,2828,3
MT5522540000000,55,22540,"Fond du Lac, WI MSA",2023,10,55984,54512,1472,2.6
MT5524580000000,55,24580,"Green Bay, WI MSA",2023,10,178217,173334,4883,2.7
MT5527500000000,55,27500,"Janesville-Beloit, WI MSA",2023,10,87006,84106,2900,3.3
MT5528450000000,55,28450,"Kenosha, WI MSA",2023,10,95411,92359,3052,3.2
MT5529100000000,55,29100,"La Crosse-Onalaska, WI-MN MSA",2023,10,90660,88209,2451,2.7
MT5531540000000,55,31540,"Madison, WI MSA",2023,10,409195,399551,9644,2.4
MT5533340000000,55,33340,"Milwaukee-Waukesha, WI MSA",2023,10,822897,796845,26052,3.2
MT5536780000000,55,36780,"Oshkosh-Neenah, WI MSA",2023,10,93242,90787,2455,2.6
MT5539540000000,55,39540,"Racine-Mount Pleasant, WI MSA",2023,10,101777,98339,3438,3.4
MT5543100000000,55,43100,"Sheboygan, WI MSA",2023,10,63395,61829,1566,2.5
MT5548140000000,55,48140,"Wausau, WI MSA",2023,10,74838,72839,1999,2.7
MT5616220000000,56,16220,"Casper, WY MSA",2023,10,42150,40923,1227,2.9
MT5616940000000,56,16940,"Cheyenne, WY MSA",2023,10,48763,47342,1421,2.9
MT7210380000000,72,10380,"Aguadilla, PR MSA",2023,10,88907,82792,6115,6.9
MT7211640000000,72,11640,"Arecibo, PR MSA",2023,10,66724,62788,3936,5.9
MT7225020000000,72,25020,"Guayama, PR MSA",2023,10,19151,17419,1732,9
MT7232420000000,72,32420,"Mayaguez, PR MSA",2023,10,66726,62059,4667,7
MT7238660000000,72,38660,"Ponce, PR MSA",2023,10,89497,81719,7778,8.7
MT7241980000000,72,41980,"San Juan-Bayamon-Caguas, PR MSA",2023,10,819705,779472,40233,4.9
MT0111500000000,1,11500,"Anniston-Oxford, AL MSA",2023,11,49189,47766,1423,2.9
MT0112220000000,1,12220,"Auburn-Opelika, AL MSA",2023,11,95574,93209,2365,2.5
MT0113820000000,1,13820,"Birmingham, AL MSA",2023,11,566466,552150,14316,2.5
MT0119300000000,1,19300,"Daphne-Fairhope-Foley, AL MSA",2023,11,115008,112299,2709,2.4
MT0119460000000,1,19460,"Decatur, AL MSA",2023,11,74784,73066,1718,2.3
MT0120020000000,1,20020,"Dothan, AL MSA",2023,11,67608,65731,1877,2.8
MT0122520000000,1,22520,"Florence-Muscle Shoals, AL MSA",2023,11,68143,66134,2009,2.9
MT0123460000000,1,23460,"Gadsden, AL MSA",2023,11,41517,40315,1202,2.9
MT0126620000000,1,26620,"Huntsville, AL MSA",2023,11,271789,265653,6136,2.3
MT0133660000000,1,33660,"Mobile, AL MSA",2023,11,183980,177335,6645,3.6
MT0133860000000,1,33860,"Montgomery, AL MSA",2023,11,176014,171108,4906,2.8
MT0146220000000,1,46220,"Tuscaloosa, AL MSA",2023,11,125857,122281,3576,2.8
MT0211260000000,2,11260,"Anchorage, AK MSA",2023,11,200487,192331,8156,4.1
MT0221820000000,2,21820,"Fairbanks-College, AK MSA",2023,11,45303,43538,1765,3.9
MT0422380000000,4,22380,"Flagstaff, AZ MSA",2023,11,74845,71881,2964,4
MT0429420000000,4,29420,"Lake Havasu City-Kingman, AZ MSA",2023,11,87250,83495,3755,4.3
MT0438060000000,4,38060,"Phoenix-Mesa-Chandler, AZ MSA",2023,11,2687448,2601491,85957,3.2
MT0439150000000,4,39150,"Prescott Valley-Prescott, AZ MSA",2023,11,105929,102273,3656,3.5
MT0443420000000,4,43420,"Sierra Vista-Douglas, AZ MSA",2023,11,48012,45985,2027,4.2
MT0446060000000,4,46060,"Tucson, AZ MSA",2023,11,495752,478139,17613,3.6
MT0449740000000,4,49740,"Yuma, AZ MSA",2023,11,98742,86712,12030,12.2
MT0522220000000,5,22220,"Fayetteville-Springdale-Rogers, AR MSA",2023,11,301195,293247,7948,2.6
MT0522900000000,5,22900,"Fort Smith, AR-OK MSA",2023,11,101745,97959,3786,3.7
MT0526300000000,5,26300,"Hot Springs, AR MSA",2023,11,43906,42329,1577,3.6
MT0527860000000,5,27860,"Jonesboro, AR MSA",2023,11,65378,63337,2041,3.1
MT0530780000000,5,30780,"Little Rock-North Little Rock-Conway, AR MSA",2023,11,376049,364006,12043,3.2
MT0612540000000,6,12540,"Bakersfield-Delano, CA MSA",2023,11,404989,370560,34429,8.5
MT0617020000000,6,17020,"Chico, CA MSA",2023,11,91010,85972,5038,5.5
MT0620940000000,6,20940,"El Centro, CA MSA",2023,11,72456,59203,13253,18.3
MT0623420000000,6,23420,"Fresno, CA MSA",2023,11,532819,491992,40827,7.7
MT0625260000000,6,25260,"Hanford-Corcoran, CA MSA",2023,11,57799,52756,5043,8.7
MT0631080000000,6,31080,"Los Angeles-Long Beach-Anaheim, CA MSA",2023,11,6692770,6360628,332142,5
MT0632900000000,6,32900,"Merced, CA MSA",2023,11,119566,108365,11201,9.4
MT0633700000000,6,33700,"Modesto, CA MSA",2023,11,250857,234244,16613,6.6
MT0634900000000,6,34900,"Napa, CA MSA",2023,11,73432,70811,2621,3.6
MT0637100000000,6,37100,"Oxnard-Thousand Oaks-Ventura, CA MSA",2023,11,418787,399942,18845,4.5
MT0639820000000,6,39820,"Redding, CA MSA",2023,11,78562,74584,3978,5.1
MT0640140000000,6,40140,"Riverside-San Bernardino-Ontario, CA MSA",2023,11,2198100,2087240,110860,5
MT0640900000000,6,40900,"Sacramento-Roseville-Folsom, CA MSA",2023,11,1173006,1120238,52768,4.5
MT0641500000000,6,41500,"Salinas, CA MSA",2023,11,219320,203552,15768,7.2
MT0641740000000,6,41740,"San Diego-Chula Vista-Carlsbad, CA MSA",2023,11,1643359,1575746,67613,4.1
MT0641860000000,6,41860,"San Francisco-Oakland-Fremont, CA MSA",2023,11,2510690,2409371,101319,4
MT0641940000000,6,41940,"San Jose-Sunnyvale-Santa Clara, CA MSA",2023,11,1056772,1013521,43251,4.1
MT0642020000000,6,42020,"San Luis Obispo-Paso Robles, CA MSA",2023,11,132552,127433,5119,3.9
MT0642100000000,6,42100,"Santa Cruz-Watsonville, CA MSA",2023,11,135593,127718,7875,5.8
MT0642200000000,6,42200,"Santa Maria-Santa Barbara, CA MSA",2023,11,220673,211202,9471,4.3
MT0642220000000,6,42220,"Santa Rosa-Petaluma, CA MSA",2023,11,247318,237760,9558,3.9
MT0644700000000,6,44700,"Stockton-Lodi, CA MSA",2023,11,366370,343249,23121,6.3
MT0646700000000,6,46700,"Vallejo, CA MSA",2023,11,216332,206174,10158,4.7
MT0647300000000,6,47300,"Visalia, CA MSA",2023,11,220435,197965,22470,10.2
MT0649700000000,6,49700,"Yuba City, CA MSA",2023,11,80462,74458,6004,7.5
MT0814500000000,8,14500,"Boulder, CO MSA",2023,11,193974,187157,6817,3.5
MT0817820000000,8,17820,"Colorado Springs, CO MSA",2023,11,392457,377912,14545,3.7
MT0819740000000,8,19740,"Denver-Aurora-Centennial, CO MSA",2023,11,1765462,1701492,63970,3.6
MT0822660000000,8,22660,"Fort Collins-Loveland, CO MSA",2023,11,208842,201628,7214,3.5
MT0824300000000,8,24300,"Grand Junction, CO MSA",2023,11,79125,76056,3069,3.9
MT0824540000000,8,24540,"Greeley, CO MSA",2023,11,175385,168619,6766,3.9
MT0839380000000,8,39380,"Pueblo, CO MSA",2023,11,73619,69831,3788,5.1
MT0914860000000,9,14860,"Bridgeport-Stamford-Danbury, CT MSA",2023,11,510063,493742,16321,3.2
MT0925540000000,9,25540,"Hartford-West Hartford-East Hartford, CT MSA",2023,11,607574,587802,19772,3.3
MT0935300000000,9,35300,"New Haven, CT MSA",2023,11,313104,302910,10194,3.3
MT0935980000000,9,35980,"Norwich-New London-Willimantic, CT MSA",2023,11,141141,136534,4607,3.3
MT0947930000000,9,47930,"Waterbury-Shelton, CT MSA",2023,11,238529,229494,9035,3.8
MT1020100000000,10,20100,"Dover, DE MSA",2023,11,85684,82138,3546,4.1
MT1147900000000,11,47900,"Washington-Arlington-Alexandria, DC-VA-MD-WV MSA",2023,11,3529752,3433006,96746,2.7
MT1215980000000,12,15980,"Cape Coral-Fort Myers, FL MSA",2023,11,375141,362500,12641,3.4
MT1218880000000,12,18880,"Crestview-Fort Walton Beach-Destin, FL MSA",2023,11,142399,138295,4104,2.9
MT1219660000000,12,19660,"Deltona-Daytona Beach-Ormond Beach, FL MSA",2023,11,321657,309953,11704,3.6
MT1223540000000,12,23540,"Gainesville, FL MSA",2023,11,169295,163308,5987,3.5
MT1226140000000,12,26140,"Homosassa Springs, FL MSA",2023,11,53948,51405,2543,4.7
MT1227260000000,12,27260,"Jacksonville, FL MSA",2023,11,853486,825377,28109,3.3
MT1229460000000,12,29460,"Lakeland-Winter Haven, FL MSA",2023,11,357675,343678,13997,3.9
MT1233100000000,12,33100,"Miami-Fort Lauderdale-West Palm Beach, FL MSA",2023,11,3298287,3212703,85584,2.6
MT1234940000000,12,34940,"Naples-Marco Island, FL MSA",2023,11,183670,177904,5766,3.1
MT1235840000000,12,35840,"North Port-Bradenton-Sarasota, FL MSA",2023,11,395417,382297,13120,3.3
MT1236100000000,12,36100,"Ocala, FL MSA",2023,11,157964,151786,6178,3.9
MT1236740000000,12,36740,"Orlando-Kissimmee-Sanford, FL MSA",2023,11,1523868,1476359,47509,3.1
MT1237340000000,12,37340,"Palm Bay-Melbourne-Titusville, FL MSA",2023,11,305331,295315,10016,3.3
MT1237460000000,12,37460,"Panama City-Panama City Beach, FL MSA",2023,11,101107,97907,3200,3.2
MT1237860000000,12,37860,"Pensacola-Ferry Pass-Brent, FL MSA",2023,11,240951,233025,7926,3.3
MT1238940000000,12,38940,"Port St. Lucie, FL MSA",2023,11,238568,229941,8627,3.6
MT1239460000000,12,39460,"Punta Gorda, FL MSA",2023,11,76315,73420,2895,3.8
MT1242680000000,12,42680,"Sebastian-Vero Beach-West Vero Corridor, FL MSA",2023,11,68065,65401,2664,3.9
MT1242700000000,12,42700,"Sebring, FL MSA",2023,11,36476,34815,1661,4.6
MT1245220000000,12,45220,"Tallahassee, FL MSA",2023,11,206350,199657,6693,3.2
MT1245300000000,12,45300,"Tampa-St. Petersburg-Clearwater, FL MSA",2023,11,1702429,1647431,54998,3.2
MT1248680000000,12,48680,"Wildwood-The Villages, FL MSA",2023,11,33849,31945,1904,5.6
MT1310500000000,13,10500,"Albany, GA MSA",2023,11,62213,59813,2400,3.9
MT1312020000000,13,12020,"Athens-Clarke County, GA MSA",2023,11,108470,105202,3268,3
MT1312060000000,13,12060,"Atlanta-Sandy Springs-Roswell, GA MSA",2023,11,3286490,3179060,107430,3.3
MT1312260000000,13,12260,"Augusta-Richmond County, GA-SC MSA",2023,11,265813,255776,10037,3.8
MT1315260000000,13,15260,"Brunswick-St. Simons, GA MSA",2023,11,55093,53522,1571,2.9
MT1317980000000,13,17980,"Columbus, GA-AL MSA",2023,11,129598,124846,4752,3.7
MT1319140000000,13,19140,"Dalton, GA MSA",2023,11,67904,65650,2254,3.3
MT1323580000000,13,23580,"Gainesville, GA MSA",2023,11,109032,106199,2833,2.6
MT1325980000000,13,25980,"Hinesville, GA MSA",2023,11,31025,29860,1165,3.8
MT1331420000000,13,31420,"Macon-Bibb County, GA MSA",2023,11,97266,93587,3679,3.8
MT1340660000000,13,40660,"Rome, GA MSA",2023,11,48272,46797,1475,3.1
MT1342340000000,13,42340,"Savannah, GA MSA",2023,11,209273,203254,6019,2.9
MT1346660000000,13,46660,"Valdosta, GA MSA",2023,11,61497,59296,2201,3.6
MT1347580000000,13,47580,"Warner Robins, GA MSA",2023,11,89831,87213,2618,2.9
MT1527980000000,15,27980,"Kahului-Wailuku, HI MSA",2023,11,81858,76416,5442,6.6
MT1546520000000,15,46520,"Urban Honolulu, HI MSA",2023,11,468412,457081,11331,2.4
MT1614260000000,16,14260,"Boise City, ID MSA",2023,11,442134,427955,14179,3.2
MT1617660000000,16,17660,"Coeur d'Alene, ID MSA",2023,11,89334,85727,3607,4
MT1626820000000,16,26820,"Idaho Falls, ID MSA",2023,11,83937,81633,2304,2.7
MT1630300000000,16,30300,"Lewiston, ID-WA MSA",2023,11,31027,30000,1027,3.3
MT1638540000000,16,38540,"Pocatello, ID MSA",2023,11,40450,38980,1470,3.6
MT1646300000000,16,46300,"Twin Falls, ID MSA",2023,11,59455,57525,1930,3.2
MT1714010000000,17,14010,"Bloomington, IL MSA",2023,11,96477,92877,3600,3.7
MT1716580000000,17,16580,"Champaign-Urbana, IL MSA",2023,11,124869,119432,5437,4.4
MT1716980000000,17,16980,"Chicago-Naperville-Elgin, IL-IN MSA",2023,11,4939789,4705542,234247,4.7
MT1719340000000,17,19340,"Davenport-Moline-Rock Island, IA-IL MSA",2023,11,190596,182404,8192,4.3
MT1719500000000,17,19500,"Decatur, IL MSA",2023,11,44745,41980,2765,6.2
MT1728100000000,17,28100,"Kankakee, IL MSA",2023,11,51276,48166,3110,6.1
MT1737900000000,17,37900,"Peoria, IL MSA",2023,11,177357,168707,8650,4.9
MT1740420000000,17,40420,"Rockford, IL MSA",2023,11,161062,150974,10088,6.3
MT1744100000000,17,44100,"Springfield, IL MSA",2023,11,103238,98780,4458,4.3
MT1814020000000,18,14020,"Bloomington, IN MSA",2023,11,84344,81541,2803,3.3
MT1818020000000,18,18020,"Columbus, IN MSA",2023,11,39528,38155,1373,3.5
MT1821140000000,18,21140,"Elkhart-Goshen, IN MSA",2023,11,98970,94633,4337,4.4
MT1821780000000,18,21780,"Evansville, IN MSA",2023,11,134561,129982,4579,3.4
MT1823060000000,18,23060,"Fort Wayne, IN MSA",2023,11,230175,222570,7605,3.3
MT1826900000000,18,26900,"Indianapolis-Carmel-Greenwood, IN MSA",2023,11,1125661,1088294,37367,3.3
MT1829020000000,18,29020,"Kokomo, IN MSA",2023,11,35099,33439,1660,4.7
MT1829200000000,18,29200,"Lafayette-West Lafayette, IN MSA",2023,11,119892,116214,3678,3.1
MT1833140000000,18,33140,"Michigan City-La Porte, IN MSA",2023,11,51569,49492,2077,4
MT1834620000000,18,34620,"Muncie, IN MSA",2023,11,51839,49694,2145,4.1
MT1843780000000,18,43780,"South Bend-Mishawaka, IN-MI MSA",2023,11,153530,147069,6461,4.2
MT1845460000000,18,45460,"Terre Haute, IN MSA",2023,11,76463,73565,2898,3.8
MT1911180000000,19,11180,"Ames, IA MSA",2023,11,69623,67989,1634,2.3
MT1916300000000,19,16300,"Cedar Rapids, IA MSA",2023,11,147087,142419,4668,3.2
MT1919780000000,19,19780,"Des Moines-West Des Moines, IA MSA",2023,11,410791,399711,11080,2.7
MT1920220000000,19,20220,"Dubuque, IA MSA",2023,11,53615,52031,1584,3
MT1926980000000,19,26980,"Iowa City, IA MSA",2023,11,99443,97088,2355,2.4
MT1943580000000,19,43580,"Sioux City, IA-NE-SD MSA",2023,11,76861,74679,2182,2.8
MT1947940000000,19,47940,"Waterloo-Cedar Falls, IA MSA",2023,11,88344,85792,2552,2.9
MT2029940000000,20,29940,"Lawrence, KS MSA",2023,11,70385,68495,1890,2.7
MT2031740000000,20,31740,"Manhattan, KS MSA",2023,11,63554,61760,1794,2.8
MT2045820000000,20,45820,"Topeka, KS MSA",2023,11,117977,114389,3588,3
MT2048620000000,20,48620,"Wichita, KS MSA",2023,11,333510,322903,10607,3.2
MT2114540000000,21,14540,"Bowling Green, KY MSA",2023,11,91235,87327,3908,4.3
MT2121060000000,21,21060,"Elizabethtown, KY MSA",2023,11,55398,52929,2469,4.5
MT2130460000000,21,30460,"Lexington-Fayette, KY MSA",2023,11,273930,263519,10411,3.8
MT2131140000000,21,31140,"Louisville/Jefferson County, KY-IN MSA",2023,11,692232,664506,27726,4
MT2136980000000,21,36980,"Owensboro, KY MSA",2023,11,51158,48797,2361,4.6
MT2137140000000,21,37140,"Paducah, KY-IL MSA",2023,11,45911,43780,2131,4.6
MT2210780000000,22,10780,"Alexandria, LA MSA",2023,11,64480,61939,2541,3.9
MT2212940000000,22,12940,"Baton Rouge, LA MSA",2023,11,425529,408931,16598,3.9
MT2225220000000,22,25220,"Hammond, LA MSA",2023,11,60358,57624,2734,4.5
MT2226380000000,22,26380,"Houma-Bayou Cane-Thibodaux, LA MSA",2023,11,88733,85579,3154,3.6
MT2229180000000,22,29180,"Lafayette, LA MSA",2023,11,197777,190695,7082,3.6
MT2229340000000,22,29340,"Lake Charles, LA MSA",2023,11,97864,93699,4165,4.3
MT2233740000000,22,33740,"Monroe, LA MSA",2023,11,96022,91562,4460,4.6
MT2235380000000,22,35380,"New Orleans-Metairie, LA MSA",2023,11,467694,448040,19654,4.2
MT2243340000000,22,43340,"Shreveport-Bossier City, LA MSA",2023,11,168634,161504,7130,4.2
MT2243640000000,22,43640,"Slidell-Mandeville-Covington, LA MSA",2023,11,129361,124640,4721,3.6
MT2312620000000,23,12620,"Bangor, ME MSA",2023,11,74943,72570,2373,3.2
MT2330340000000,23,30340,"Lewiston-Auburn, ME MSA",2023,11,55152,53563,1589,2.9
MT2338860000000,23,38860,"Portland-South Portland, ME MSA",2023,11,310963,303539,7424,2.4
MT2412580000000,24,12580,"Baltimore-Columbia-Towson, MD MSA",2023,11,1486388,1447275,39113,2.6
MT2425180000000,24,25180,"Hagerstown-Martinsburg, MD-WV MSA",2023,11,143032,138431,4601,3.2
MT2430500000000,24,30500,"Lexington Park, MD MSA",2023,11,108120,105611,2509,2.3
MT2441540000000,24,41540,"Salisbury, MD MSA",2023,11,64323,62495,1828,2.8
MT2511200000000,25,11200,"Amherst Town-Northampton, MA MSA",2023,11,84417,81566,2851,3.4
MT2512700000000,25,12700,"Barnstable Town, MA MSA",2023,11,115079,109850,5229,4.5
MT2514460000000,25,14460,"Boston-Cambridge-Newton, MA-NH MSA",2023,11,2795155,2702855,92300,3.3
MT2538340000000,25,38340,"Pittsfield, MA MSA",2023,11,64100,61703,2397,3.7
MT2544140000000,25,44140,"Springfield, MA MSA",2023,11,222300,211900,10400,4.7
MT2549340000000,25,49340,"Worcester, MA MSA",2023,11,461443,444180,17263,3.7
MT2611460000000,26,11460,"Ann Arbor, MI MSA",2023,11,206649,199945,6704,3.2
MT2612980000000,26,12980,"Battle Creek, MI MSA",2023,11,62568,59822,2746,4.4
MT2613020000000,26,13020,"Bay City, MI MSA",2023,11,50220,47758,2462,4.9
MT2619820000000,26,19820,"Detroit-Warren-Dearborn, MI MSA",2023,11,2186768,2102942,83826,3.8
MT2622420000000,26,22420,"Flint, MI MSA",2023,11,187037,177817,9220,4.9
MT2624340000000,26,24340,"Grand Rapids-Wyoming-Kentwood, MI MSA",2023,11,628527,607245,21282,3.4
MT2627100000000,26,27100,"Jackson, MI MSA",2023,11,75024,71880,3144,4.2
MT2628020000000,26,28020,"Kalamazoo-Portage, MI MSA",2023,11,139586,134555,5031,3.6
MT2629620000000,26,29620,"Lansing-East Lansing, MI MSA",2023,11,252385,242701,9684,3.8
MT2633220000000,26,33220,"Midland, MI MSA",2023,11,42730,41116,1614,3.8
MT2633780000000,26,33780,"Monroe, MI MSA",2023,11,78705,75267,3438,4.4
MT2634740000000,26,34740,"Muskegon-Norton Shores, MI MSA",2023,11,84312,80653,3659,4.3
MT2635660000000,26,35660,"Niles, MI MSA",2023,11,76333,73125,3208,4.2
MT2640980000000,26,40980,"Saginaw, MI MSA",2023,11,85068,80704,4364,5.1
MT2645900000000,26,45900,"Traverse City, MI MSA",2023,11,81003,77899,3104,3.8
MT2720260000000,27,20260,"Duluth, MN-WI MSA",2023,11,139355,134771,4584,3.3
MT2731860000000,27,31860,"Mankato, MN MSA",2023,11,60015,58612,1403,2.3
MT2733460000000,27,33460,"Minneapolis-St. Paul-Bloomington, MN-WI MSA",2023,11,2058945,2004862,54083,2.6
MT2740340000000,27,40340,"Rochester, MN MSA",2023,11,125648,122794,2854,2.3
MT2741060000000,27,41060,"St. Cloud, MN MSA",2023,11,109487,106370,3117,2.8
MT2825060000000,28,25060,"Gulfport-Biloxi, MS MSA",2023,11,184734,179713,5021,2.7
MT2825620000000,28,25620,"Hattiesburg, MS MSA",2023,11,69804,67932,1872,2.7
MT2827140000000,28,27140,"Jackson, MS MSA",2023,11,276739,269411,7328,2.6
MT2916020000000,29,16020,"Cape Girardeau, MO-IL MSA",2023,11,49154,47620,1534,3.1
MT2917860000000,29,17860,"Columbia, MO MSA",2023,11,112539,109294,3245,2.9
MT2927620000000,29,27620,"Jefferson City, MO MSA",2023,11,75625,73425,2200,2.9
MT2927900000000,29,27900,"Joplin, MO-KS MSA",2023,11,97343,94128,3215,3.3
MT2928140000000,29,28140,"Kansas City, MO-KS MSA",2023,11,1189054,1150471,38583,3.2
MT2941140000000,29,41140,"St. Joseph, MO-KS MSA",2023,11,53899,52062,1837,3.4
MT2941180000000,29,41180,"St. Louis, MO-IL MSA",2023,11,1480158,1427697,52461,3.5
MT2944180000000,29,44180,"Springfield, MO MSA",2023,11,240820,233511,7309,3
MT3013740000000,30,13740,"Billings, MT MSA",2023,11,99267,96533,2734,2.8
MT3014580000000,30,14580,"Bozeman, MT MSA",2023,11,76771,75028,1743,2.3
MT3024500000000,30,24500,"Great Falls, MT MSA",2023,11,40054,38859,1195,3
MT3025740000000,30,25740,"Helena, MT MSA",2023,11,47263,45921,1342,2.8
MT3033540000000,30,33540,"Missoula, MT MSA",2023,11,74035,71875,2160,2.9
MT3124260000000,31,24260,"Grand Island, NE MSA",2023,11,42564,41524,1040,2.4
MT3130700000000,31,30700,"Lincoln, NE MSA",2023,11,191849,187401,4448,2.3
MT3136540000000,31,36540,"Omaha, NE-IA MSA",2023,11,523307,509084,14223,2.7
MT3216180000000,32,16180,"Carson City, NV MSA",2023,11,28825,27591,1234,4.3
MT3229820000000,32,29820,"Las Vegas-Henderson-North Las Vegas, NV MSA",2023,11,1201201,1135749,65452,5.4
MT3239900000000,32,39900,"Reno, NV MSA",2023,11,297104,283915,13189,4.4
MT3331700000000,33,31700,"Manchester-Nashua, NH MSA",2023,11,239691,233785,5906,2.5
MT3412100000000,34,12100,"Atlantic City-Hammonton, NJ MSA",2023,11,179936,168946,10990,6.1
MT3445940000000,34,45940,"Trenton-Princeton, NJ MSA",2023,11,198981,190370,8611,4.3
MT3447220000000,34,47220,"Vineland, NJ MSA",2023,11,65686,61111,4575,7
MT3510740000000,35,10740,"Albuquerque, NM MSA",2023,11,459539,443225,16314,3.6
MT3522140000000,35,22140,"Farmington, NM MSA",2023,11,49450,47374,2076,4.2
MT3529740000000,35,29740,"Las Cruces, NM MSA",2023,11,101277,96873,4404,4.3
MT3542140000000,35,42140,"Santa Fe, NM MSA",2023,11,73736,71186,2550,3.5
MT3610580000000,36,10580,"Albany-Schenectady-Troy, NY MSA",2023,11,459236,443444,15792,3.4
MT3613780000000,36,13780,"Binghamton, NY MSA",2023,11,107612,103361,4251,4
MT3615380000000,36,15380,"Buffalo-Cheektowaga, NY MSA",2023,11,561970,539627,22343,4
MT3621300000000,36,21300,"Elmira, NY MSA",2023,11,35880,34474,1406,3.9
MT3624020000000,36,24020,"Glens Falls, NY MSA",2023,11,59805,57616,2189,3.7
MT3627060000000,36,27060,"Ithaca, NY MSA",2023,11,48526,46856,1670,3.4
MT3628740000000,36,28740,"Kingston, NY MSA",2023,11,88052,84764,3288,3.7
MT3628880000000,36,28880,"Kiryas Joel-Poughkeepsie-Newburgh, NY MSA",2023,11,342005,329666,12339,3.6
MT3635620000000,36,35620,"New York-Newark-Jersey City, NY-NJ MSA",2023,11,10152681,9708902,443779,4.4
MT3640380000000,36,40380,"Rochester, NY MSA",2023,11,516552,497138,19414,3.8
MT3645060000000,36,45060,"Syracuse, NY MSA",2023,11,311998,300233,11765,3.8
MT3646540000000,36,46540,"Utica-Rome, NY MSA",2023,11,128301,123345,4956,3.9
MT3648060000000,36,48060,"Watertown-Fort Drum, NY MSA",2023,11,45139,43090,2049,4.5
MT3711700000000,37,11700,"Asheville, NC MSA",2023,11,211819,205654,6165,2.9
MT3715500000000,37,15500,"Burlington, NC MSA",2023,11,86109,83082,3027,3.5
MT3716740000000,37,16740,"Charlotte-Concord-Gastonia, NC-SC MSA",2023,11,1477180,1426228,50952,3.4
MT3720500000000,37,20500,"Durham-Chapel Hill, NC MSA",2023,11,321943,311674,10269,3.2
MT3722180000000,37,22180,"Fayetteville, NC MSA",2023,11,156244,149370,6874,4.4
MT3724140000000,37,24140,"Goldsboro, NC MSA",2023,11,50524,48645,1879,3.7
MT3724660000000,37,24660,"Greensboro-High Point, NC MSA",2023,11,373684,359097,14587,3.9
MT3724780000000,37,24780,"Greenville, NC MSA",2023,11,84201,80722,3479,4.1
MT3725860000000,37,25860,"Hickory-Lenoir-Morganton, NC MSA",2023,11,172246,166354,5892,3.4
MT3727340000000,37,27340,"Jacksonville, NC MSA",2023,11,74603,71850,2753,3.7
MT3738240000000,37,38240,"Pinehurst-Southern Pines, NC MSA",2023,11,44587,43028,1559,3.5
MT3739580000000,37,39580,"Raleigh-Cary, NC MSA",2023,11,841348,815057,26291,3.1
MT3740580000000,37,40580,"Rocky Mount, NC MSA",2023,11,63617,60593,3024,4.8
MT3748900000000,37,48900,"Wilmington, NC MSA",2023,11,222716,214747,7969,3.6
MT3749180000000,37,49180,"Winston-Salem, NC MSA",2023,11,325136,313519,11617,3.6
MT3813900000000,38,13900,"Bismarck, ND MSA",2023,11,72517,71026,1491,2.1
MT3822020000000,38,22020,"Fargo, ND-MN MSA",2023,11,152925,149907,3018,2
MT3824220000000,38,24220,"Grand Forks, ND-MN MSA",2023,11,55815,54593,1222,2.2
MT3833500000000,38,33500,"Minot, ND MSA",2023,11,40078,39186,892,2.2
MT3910420000000,39,10420,"Akron, OH MSA",2023,11,358034,343869,14165,4
MT3915940000000,39,15940,"Canton-Massillon, OH MSA",2023,11,193108,185140,7968,4.1
MT3917140000000,39,17140,"Cincinnati, OH-KY-IN MSA",2023,11,1164838,1121589,43249,3.7
MT3917410000000,39,17410,"Cleveland, OH MSA",2023,11,1090451,1049552,40899,3.8
MT3918140000000,39,18140,"Columbus, OH MSA",2023,11,1143760,1103921,39839,3.5
MT3919430000000,39,19430,"Dayton-Kettering-Beavercreek, OH MSA",2023,11,391182,375952,15230,3.9
MT3930620000000,39,30620,"Lima, OH MSA",2023,11,47259,45440,1819,3.8
MT3931900000000,39,31900,"Mansfield, OH MSA",2023,11,53040,50709,2331,4.4
MT3941780000000,39,41780,"Sandusky, OH MSA",2023,11,56843,54132,2711,4.8
MT3944220000000,39,44220,"Springfield, OH MSA",2023,11,62151,59625,2526,4.1
MT3945780000000,39,45780,"Toledo, OH MSA",2023,11,295126,282182,12944,4.4
MT3948260000000,39,48260,"Weirton-Steubenville, WV-OH MSA",2023,11,51925,49158,2767,5.3
MT3949660000000,39,49660,"Youngstown-Warren, OH MSA",2023,11,191831,183050,8781,4.6
MT4021420000000,40,21420,"Enid, OK MSA",2023,11,28480,27517,963,3.4
MT4030020000000,40,30020,"Lawton, OK MSA",2023,11,52360,50292,2068,3.9
MT4036420000000,40,36420,"Oklahoma City, OK MSA",2023,11,769274,744631,24643,3.2
MT4046140000000,40,46140,"Tulsa, OK MSA",2023,11,522355,504200,18155,3.5
MT4110540000000,41,10540,"Albany, OR MSA",2023,11,61363,58666,2697,4.4
MT4113460000000,41,13460,"Bend, OR MSA",2023,11,131520,126102,5418,4.1
MT4118700000000,41,18700,"Corvallis, OR MSA",2023,11,49221,47470,1751,3.6
MT4121660000000,41,21660,"Eugene-Springfield, OR MSA",2023,11,187118,179284,7834,4.2
MT4124420000000,41,24420,"Grants Pass, OR MSA",2023,11,35023,33076,1947,5.6
MT4132780000000,41,32780,"Medford, OR MSA",2023,11,105862,100843,5019,4.7
MT4138900000000,41,38900,"Portland-Vancouver-Hillsboro, OR-WA MSA",2023,11,1381511,1327861,53650,3.9
MT4141420000000,41,41420,"Salem, OR MSA",2023,11,219284,210541,8743,4
MT4210900000000,42,10900,"Allentown-Bethlehem-Easton, PA-NJ MSA",2023,11,452968,434270,18698,4.1
MT4211020000000,42,11020,"Altoona, PA MSA",2023,11,57705,55643,2062,3.6
MT4216540000000,42,16540,"Chambersburg, PA MSA",2023,11,76698,74297,2401,3.1
MT4221500000000,42,21500,"Erie, PA MSA",2023,11,127406,122336,5070,4
MT4223900000000,42,23900,"Gettysburg, PA MSA",2023,11,52531,50946,1585,3
MT4225420000000,42,25420,"Harrisburg-Carlisle, PA MSA",2023,11,315535,305285,10250,3.2
MT4227780000000,42,27780,"Johnstown, PA MSA",2023,11,57385,54920,2465,4.3
MT4229540000000,42,29540,"Lancaster, PA MSA",2023,11,294767,286190,8577,2.9
MT4230140000000,42,30140,"Lebanon, PA MSA",2023,11,74141,71799,2342,3.2
MT4237980000000,42,37980,"Philadelphia-Camden-Wilmington, PA-NJ-DE-MD MSA",2023,11,3307498,3181258,126240,3.8
MT4238300000000,42,38300,"Pittsburgh, PA MSA",2023,11,1243026,1198325,44701,3.6
MT4239740000000,42,39740,"Reading, PA MSA",2023,11,220830,212483,8347,3.8
MT4242540000000,42,42540,"Scranton--Wilkes-Barre, PA MSA",2023,11,281469,269303,12166,4.3
MT4244300000000,42,44300,"State College, PA MSA",2023,11,77784,75584,2200,2.8
MT4248700000000,42,48700,"Williamsport, PA MSA",2023,11,53430,51336,2094,3.9
MT4249620000000,42,49620,"York-Hanover, PA MSA",2023,11,242352,234430,7922,3.3
MT4439300000000,44,39300,"Providence-Warwick, RI-MA MSA",2023,11,891257,857286,33971,3.8
MT4516700000000,45,16700,"Charleston-North Charleston, SC MSA",2023,11,437309,425464,11845,2.7
MT4517900000000,45,17900,"Columbia, SC MSA",2023,11,413565,400793,12772,3.1
MT4522500000000,45,22500,"Florence, SC MSA",2023,11,91545,88349,3196,3.5
MT4524860000000,45,24860,"Greenville-Anderson-Greer, SC MSA",2023,11,473897,459892,14005,3
MT4525940000000,45,25940,"Hilton Head Island-Bluffton-Port Royal, SC MSA",2023,11,97061,94201,2860,2.9
MT4534820000000,45,34820,"Myrtle Beach-Conway-North Myrtle Beach, SC MSA",2023,11,168995,162673,6322,3.7
MT4543900000000,45,43900,"Spartanburg, SC MSA",2023,11,174525,168797,5728,3.3
MT4544940000000,45,44940,"Sumter, SC MSA",2023,11,41386,39718,1668,4
MT4639660000000,46,39660,"Rapid City, SD MSA",2023,11,79036,77621,1415,1.8
MT4643620000000,46,43620,"Sioux Falls, SD-MN MSA",2023,11,172670,169763,2907,1.7
MT4716860000000,47,16860,"Chattanooga, TN-GA MSA",2023,11,287958,279386,8572,3
MT4717300000000,47,17300,"Clarksville, TN-KY MSA",2023,11,136464,131070,5394,4
MT4717420000000,47,17420,"Cleveland, TN MSA",2023,11,56600,54648,1952,3.4
MT4727180000000,47,27180,"Jackson, TN MSA",2023,11,78264,75520,2744,3.5
MT4727740000000,47,27740,"Johnson City, TN MSA",2023,11,96447,93288,3159,3.3
MT4728700000000,47,28700,"Kingsport-Bristol, TN-VA MSA",2023,11,132579,128056,4523,3.4
MT4728940000000,47,28940,"Knoxville, TN MSA",2023,11,447573,434095,13478,3
MT4732820000000,47,32820,"Memphis, TN-MS-AR MSA",2023,11,623851,600028,23823,3.8
MT4734100000000,47,34100,"Morristown, TN MSA",2023,11,52849,51051,1798,3.4
MT4734980000000,47,34980,"Nashville-Davidson--Murfreesboro--Franklin, TN MSA",2023,11,1149126,1118509,30617,2.7
MT4810180000000,48,10180,"Abilene, TX MSA",2023,11,85313,82480,2833,3.3
MT4811100000000,48,11100,"Amarillo, TX MSA",2023,11,135930,131825,4105,3
MT4812420000000,48,12420,"Austin-Round Rock-San Marcos, TX MSA",2023,11,1472830,1421815,51015,3.5
MT4813140000000,48,13140,"Beaumont-Port Arthur, TX MSA",2023,11,176826,167750,9076,5.1
MT4815180000000,48,15180,"Brownsville-Harlingen, TX MSA",2023,11,186833,177415,9418,5
MT4817780000000,48,17780,"College Station-Bryan, TX MSA",2023,11,148011,143090,4921,3.3
MT4818580000000,48,18580,"Corpus Christi, TX MSA",2023,11,207950,199282,8668,4.2
MT4819100000000,48,19100,"Dallas-Fort Worth-Arlington, TX MSA",2023,11,4416543,4249576,166967,3.8
MT4820580000000,48,20580,"Eagle Pass, TX MSA",2023,11,23687,21965,1722,7.3
MT4821340000000,48,21340,"El Paso, TX MSA",2023,11,405388,388439,16949,4.2
MT4826420000000,48,26420,"Houston-Pasadena-The Woodlands, TX MSA",2023,11,3771683,3615206,156477,4.1
MT4828660000000,48,28660,"Killeen-Temple, TX MSA",2023,11,199526,191249,8277,4.1
MT4829700000000,48,29700,"Laredo, TX MSA",2023,11,116334,111686,4648,4
MT4830980000000,48,30980,"Longview, TX MSA",2023,11,128411,122695,5716,4.5
MT4831180000000,48,31180,"Lubbock, TX MSA",2023,11,181904,175873,6031,3.3
MT4832580000000,48,32580,"McAllen-Edinburg-Mission, TX MSA",2023,11,390451,367832,22619,5.8
MT4833260000000,48,33260,"Midland, TX MSA",2023,11,101133,98383,2750,2.7
MT4836220000000,48,36220,"Odessa, TX MSA",2023,11,84230,81443,2787,3.3
MT4841660000000,48,41660,"San Angelo, TX MSA",2023,11,61071,59182,1889,3.1
MT4841700000000,48,41700,"San Antonio-New Braunfels, TX MSA",2023,11,1314030,1266452,47578,3.6
MT4843300000000,48,43300,"Sherman-Denison, TX MSA",2023,11,70609,68009,2600,3.7
MT4845500000000,48,45500,"Texarkana, TX-AR MSA",2023,11,60978,58571,2407,3.9
MT4846340000000,48,46340,"Tyler, TX MSA",2023,11,116109,111936,4173,3.6
MT4847020000000,48,47020,"Victoria, TX MSA",2023,11,44584,42829,1755,3.9
MT4847380000000,48,47380,"Waco, TX MSA",2023,11,144465,139251,5214,3.6
MT4848660000000,48,48660,"Wichita Falls, TX MSA",2023,11,66450,64054,2396,3.6
MT4930860000000,49,30860,"Logan, UT-ID MSA",2023,11,79112,77068,2044,2.6
MT4936260000000,49,36260,"Ogden, UT MSA",2023,11,349303,339951,9352,2.7
MT4939340000000,49,39340,"Provo-Orem-Lehi, UT MSA",2023,11,366424,355803,10621,2.9
MT4941100000000,49,41100,"St. George, UT MSA",2023,11,91873,89044,2829,3.1
MT4941620000000,49,41620,"Salt Lake City-Murray, UT MSA",2023,11,731357,710160,21197,2.9
MT5015540000000,50,15540,"Burlington-South Burlington, VT MSA",2023,11,130694,128519,2175,1.7
MT5113980000000,51,13980,"Blacksburg-Christiansburg-Radford, VA MSA",2023,11,94669,91992,2677,2.8
MT5116820000000,51,16820,"Charlottesville, VA MSA",2023,11,120016,117061,2955,2.5
MT5125500000000,51,25500,"Harrisonburg, VA MSA",2023,11,72689,70754,1935,2.7
MT5131340000000,51,31340,"Lynchburg, VA MSA",2023,11,128583,124537,4046,3.1
MT5140060000000,51,40060,"Richmond, VA MSA",2023,11,724144,703011,21133,2.9
MT5140220000000,51,40220,"Roanoke, VA MSA",2023,11,158316,153885,4431,2.8
MT5144420000000,51,44420,"Staunton-Stuarts Draft, VA MSA",2023,11,65629,64035,1594,2.4
MT5147260000000,51,47260,"Virginia Beach-Chesapeake-Norfolk, VA-NC MSA",2023,11,884062,857660,26402,3
MT5149020000000,51,49020,"Winchester, VA-WV MSA",2023,11,77416,75331,2085,2.7
MT5313380000000,53,13380,"Bellingham, WA MSA",2023,11,114302,109009,5293,4.6
MT5314740000000,53,14740,"Bremerton-Silverdale-Port Orchard, WA MSA",2023,11,122639,116881,5758,4.7
MT5328420000000,53,28420,"Kennewick-Richland, WA MSA",2023,11,145290,137775,7515,5.2
MT5331020000000,53,31020,"Longview-Kelso, WA MSA",2023,11,47363,44809,2554,5.4
MT5334580000000,53,34580,"Mount Vernon-Anacortes, WA MSA",2023,11,59055,56030,3025,5.1
MT5336500000000,53,36500,"Olympia-Lacey-Tumwater, WA MSA",2023,11,143218,136573,6645,4.6
MT5342660000000,53,42660,"Seattle-Tacoma-Bellevue, WA MSA",2023,11,2313874,2214608,99266,4.3
MT5344060000000,53,44060,"Spokane-Spokane Valley, WA MSA",2023,11,282722,269551,13171,4.7
MT5347460000000,53,47460,"Walla Walla, WA MSA",2023,11,29193,27931,1262,4.3
MT5348300000000,53,48300,"Wenatchee-East Wenatchee, WA MSA",2023,11,61896,58885,3011,4.9
MT5349420000000,53,49420,"Yakima, WA MSA",2023,11,125899,118203,7696,6.1
MT5413220000000,54,13220,"Beckley, WV MSA",2023,11,46238,44368,1870,4
MT5416620000000,54,16620,"Charleston, WV MSA",2023,11,91533,87848,3685,4
MT5426580000000,54,26580,"Huntington-Ashland, WV-KY-OH MSA",2023,11,156551,149091,7460,4.8
MT5434060000000,54,34060,"Morgantown, WV MSA",2023,11,71228,68693,2535,3.6
MT5437620000000,54,37620,"Parkersburg-Vienna, WV MSA",2023,11,39751,38007,1744,4.4
MT5448540000000,54,48540,"Wheeling, WV-OH MSA",2023,11,59445,56654,2791,4.7
MT5511540000000,55,11540,"Appleton, WI MSA",2023,11,137009,133662,3347,2.4
MT5520740000000,55,20740,"Eau Claire, WI MSA",2023,11,95853,93090,2763,2.9
MT5522540000000,55,22540,"Fond du Lac, WI MSA",2023,11,55873,54435,1438,2.6
MT5524580000000,55,24580,"Green Bay, WI MSA",2023,11,178338,173589,4749,2.7
MT5527500000000,55,27500,"Janesville-Beloit, WI MSA",2023,11,86951,84129,2822,3.2
MT5528450000000,55,28450,"Kenosha, WI MSA",2023,11,95630,92590,3040,3.2
MT5529100000000,55,29100,"La Crosse-Onalaska, WI-MN MSA",2023,11,90552,88197,2355,2.6
MT5531540000000,55,31540,"Madison, WI MSA",2023,11,409466,400207,9259,2.3
MT5533340000000,55,33340,"Milwaukee-Waukesha, WI MSA",2023,11,822711,796894,25817,3.1
MT5536780000000,55,36780,"Oshkosh-Neenah, WI MSA",2023,11,93316,90913,2403,2.6
MT5539540000000,55,39540,"Racine-Mount Pleasant, WI MSA",2023,11,101868,98487,3381,3.3
MT5543100000000,55,43100,"Sheboygan, WI MSA",2023,11,63365,61846,1519,2.4
MT5548140000000,55,48140,"Wausau, WI MSA",2023,11,74973,73014,1959,2.6
MT5616220000000,56,16220,"Casper, WY MSA",2023,11,42096,40875,1221,2.9
MT5616940000000,56,16940,"Cheyenne, WY MSA",2023,11,48794,47366,1428,2.9
MT7210380000000,72,10380,"Aguadilla, PR MSA",2023,11,89251,83155,6096,6.8
MT7211640000000,72,11640,"Arecibo, PR MSA",2023,11,66938,63077,3861,5.8
MT7225020000000,72,25020,"Guayama, PR MSA",2023,11,19220,17485,1735,9
MT7232420000000,72,32420,"Mayaguez, PR MSA",2023,11,67043,62422,4621,6.9
MT7238660000000,72,38660,"Ponce, PR MSA",2023,11,89797,82003,7794,8.7
MT7241980000000,72,41980,"San Juan-Bayamon-Caguas, PR MSA",2023,11,821470,781420,40050,4.9
MT0111500000000,1,11500,"Anniston-Oxford, AL MSA",2023,12,49172,47721,1451,3
MT0112220000000,1,12220,"Auburn-Opelika, AL MSA",2023,12,95860,93417,2443,2.5
MT0113820000000,1,13820,"Birmingham, AL MSA",2023,12,567390,552667,14723,2.6
MT0119300000000,1,19300,"Daphne-Fairhope-Foley, AL MSA",2023,12,115404,112639,2765,2.4
MT0119460000000,1,19460,"Decatur, AL MSA",2023,12,74978,73254,1724,2.3
MT0120020000000,1,20020,"Dothan, AL MSA",2023,12,67609,65696,1913,2.8
MT0122520000000,1,22520,"Florence-Muscle Shoals, AL MSA",2023,12,68180,66156,2024,3
MT0123460000000,1,23460,"Gadsden, AL MSA",2023,12,41608,40386,1222,2.9
MT0126620000000,1,26620,"Huntsville, AL MSA",2023,12,272516,266219,6297,2.3
MT0133660000000,1,33660,"Mobile, AL MSA",2023,12,184388,177479,6909,3.7
MT0133860000000,1,33860,"Montgomery, AL MSA",2023,12,176615,171573,5042,2.9
MT0146220000000,1,46220,"Tuscaloosa, AL MSA",2023,12,125964,122309,3655,2.9
MT0211260000000,2,11260,"Anchorage, AK MSA",2023,12,200397,192318,8079,4
MT0221820000000,2,21820,"Fairbanks-College, AK MSA",2023,12,45332,43591,1741,3.8
MT0422380000000,4,22380,"Flagstaff, AZ MSA",2023,12,75125,72265,2860,3.8
MT0429420000000,4,29420,"Lake Havasu City-Kingman, AZ MSA",2023,12,87381,83717,3664,4.2
MT0438060000000,4,38060,"Phoenix-Mesa-Chandler, AZ MSA",2023,12,2688324,2605192,83132,3.1
MT0439150000000,4,39150,"Prescott Valley-Prescott, AZ MSA",2023,12,106127,102569,3558,3.4
MT0443420000000,4,43420,"Sierra Vista-Douglas, AZ MSA",2023,12,48073,46073,2000,4.2
MT0446060000000,4,46060,"Tucson, AZ MSA",2023,12,494623,477524,17099,3.5
MT0449740000000,4,49740,"Yuma, AZ MSA",2023,12,98617,86729,11888,12.1
MT0522220000000,5,22220,"Fayetteville-Springdale-Rogers, AR MSA",2023,12,301888,293970,7918,2.6
MT0522900000000,5,22900,"Fort Smith, AR-OK MSA",2023,12,101693,97980,3713,3.7
MT0526300000000,5,26300,"Hot Springs, AR MSA",2023,12,43921,42352,1569,3.6
MT0527860000000,5,27860,"Jonesboro, AR MSA",2023,12,65493,63455,2038,3.1
MT0530780000000,5,30780,"Little Rock-North Little Rock-Conway, AR MSA",2023,12,376682,364593,12089,3.2
MT0612540000000,6,12540,"Bakersfield-Delano, CA MSA",2023,12,405172,370539,34633,8.5
MT0617020000000,6,17020,"Chico, CA MSA",2023,12,91077,85979,5098,5.6
MT0620940000000,6,20940,"El Centro, CA MSA",2023,12,72486,59177,13309,18.4
MT0623420000000,6,23420,"Fresno, CA MSA",2023,12,533346,492289,41057,7.7
MT0625260000000,6,25260,"Hanford-Corcoran, CA MSA",2023,12,57874,52817,5057,8.7
MT0631080000000,6,31080,"Los Angeles-Long Beach-Anaheim, CA MSA",2023,12,6695453,6362888,332565,5
MT0632900000000,6,32900,"Merced, CA MSA",2023,12,119414,108125,11289,9.5
MT0633700000000,6,33700,"Modesto, CA MSA",2023,12,250759,234045,16714,6.7
MT0634900000000,6,34900,"Napa, CA MSA",2023,12,73371,70718,2653,3.6
MT0637100000000,6,37100,"Oxnard-Thousand Oaks-Ventura, CA MSA",2023,12,418833,399919,18914,4.5
MT0639820000000,6,39820,"Redding, CA MSA",2023,12,78571,74563,4008,5.1
MT0640140000000,6,40140,"Riverside-San Bernardino-Ontario, CA MSA",2023,12,2198545,2087019,111526,5.1
MT0640900000000,6,40900,"Sacramento-Roseville-Folsom, CA MSA",2023,12,1173853,1120813,53040,4.5
MT0641500000000,6,41500,"Salinas, CA MSA",2023,12,219304,203322,15982,7.3
MT0641740000000,6,41740,"San Diego-Chula Vista-Carlsbad, CA MSA",2023,12,1643975,1575603,68372,4.2
MT0641860000000,6,41860,"San Francisco-Oakland-Fremont, CA MSA",2023,12,2508967,2406771,102196,4.1
MT0641940000000,6,41940,"San Jose-Sunnyvale-Santa Clara, CA MSA",2023,12,1056354,1012827,43527,4.1
MT0642020000000,6,42020,"San Luis Obispo-Paso Robles, CA MSA",2023,12,132436,127265,5171,3.9
MT0642100000000,6,42100,"Santa Cruz-Watsonville, CA MSA",2023,12,135649,127731,7918,5.8
MT0642200000000,6,42200,"Santa Maria-Santa Barbara, CA MSA",2023,12,220516,210944,9572,4.3
MT0642220000000,6,42220,"Santa Rosa-Petaluma, CA MSA",2023,12,247345,237700,9645,3.9
MT0644700000000,6,44700,"Stockton-Lodi, CA MSA",2023,12,366135,342981,23154,6.3
MT0646700000000,6,46700,"Vallejo, CA MSA",2023,12,216482,206255,10227,4.7
MT0647300000000,6,47300,"Visalia, CA MSA",2023,12,220888,198165,22723,10.3
MT0649700000000,6,49700,"Yuba City, CA MSA",2023,12,80498,74437,6061,7.5
MT0814500000000,8,14500,"Boulder, CO MSA",2023,12,193902,187032,6870,3.5
MT0817820000000,8,17820,"Colorado Springs, CO MSA",2023,12,392856,378126,14730,3.7
MT0819740000000,8,19740,"Denver-Aurora-Centennial, CO MSA",2023,12,1766181,1701229,64952,3.7
MT0822660000000,8,22660,"Fort Collins-Loveland, CO MSA",2023,12,209001,201698,7303,3.5
MT0824300000000,8,24300,"Grand Junction, CO MSA",2023,12,79228,76141,3087,3.9
MT0824540000000,8,24540,"Greeley, CO MSA",2023,12,175457,168599,6858,3.9
MT0839380000000,8,39380,"Pueblo, CO MSA",2023,12,73607,69773,3834,5.2
MT0914860000000,9,14860,"Bridgeport-Stamford-Danbury, CT MSA",2023,12,510889,494560,16329,3.2
MT0925540000000,9,25540,"Hartford-West Hartford-East Hartford, CT MSA",2023,12,607354,587465,19889,3.3
MT0935300000000,9,35300,"New Haven, CT MSA",2023,12,313755,303469,10286,3.3
MT0935980000000,9,35980,"Norwich-New London-Willimantic, CT MSA",2023,12,141362,136763,4599,3.3
MT0947930000000,9,47930,"Waterbury-Shelton, CT MSA",2023,12,238672,229613,9059,3.8
MT1020100000000,10,20100,"Dover, DE MSA",2023,12,85544,82032,3512,4.1
MT1147900000000,11,47900,"Washington-Arlington-Alexandria, DC-VA-MD-WV MSA",2023,12,3533831,3435440,98391,2.8
MT1215980000000,12,15980,"Cape Coral-Fort Myers, FL MSA",2023,12,375437,362731,12706,3.4
MT1218880000000,12,18880,"Crestview-Fort Walton Beach-Destin, FL MSA",2023,12,142211,138104,4107,2.9
MT1219660000000,12,19660,"Deltona-Daytona Beach-Ormond Beach, FL MSA",2023,12,322180,310472,11708,3.6
MT1223540000000,12,23540,"Gainesville, FL MSA",2023,12,169187,163152,6035,3.6
MT1226140000000,12,26140,"Homosassa Springs, FL MSA",2023,12,53895,51354,2541,4.7
MT1227260000000,12,27260,"Jacksonville, FL MSA",2023,12,854245,825985,28260,3.3
MT1229460000000,12,29460,"Lakeland-Winter Haven, FL MSA",2023,12,357613,343436,14177,4
MT1233100000000,12,33100,"Miami-Fort Lauderdale-West Palm Beach, FL MSA",2023,12,3302655,3215684,86971,2.6
MT1234940000000,12,34940,"Naples-Marco Island, FL MSA",2023,12,183871,177990,5881,3.2
MT1235840000000,12,35840,"North Port-Bradenton-Sarasota, FL MSA",2023,12,396121,382899,13222,3.3
MT1236100000000,12,36100,"Ocala, FL MSA",2023,12,158170,151963,6207,3.9
MT1236740000000,12,36740,"Orlando-Kissimmee-Sanford, FL MSA",2023,12,1526053,1478160,47893,3.1
MT1237340000000,12,37340,"Palm Bay-Melbourne-Titusville, FL MSA",2023,12,305246,295201,10045,3.3
MT1237460000000,12,37460,"Panama City-Panama City Beach, FL MSA",2023,12,101086,97865,3221,3.2
MT1237860000000,12,37860,"Pensacola-Ferry Pass-Brent, FL MSA",2023,12,240858,232843,8015,3.3
MT1238940000000,12,38940,"Port St. Lucie, FL MSA",2023,12,238294,229588,8706,3.7
MT1239460000000,12,39460,"Punta Gorda, FL MSA",2023,12,76654,73741,2913,3.8
MT1242680000000,12,42680,"Sebastian-Vero Beach-West Vero Corridor, FL MSA",2023,12,68049,65359,2690,4
MT1242700000000,12,42700,"Sebring, FL MSA",2023,12,36440,34765,1675,4.6
MT1245220000000,12,45220,"Tallahassee, FL MSA",2023,12,206692,199954,6738,3.3
MT1245300000000,12,45300,"Tampa-St. Petersburg-Clearwater, FL MSA",2023,12,1702645,1647309,55336,3.3
MT1248680000000,12,48680,"Wildwood-The Villages, FL MSA",2023,12,33855,31954,1901,5.6
MT1310500000000,13,10500,"Albany, GA MSA",2023,12,62126,59723,2403,3.9
MT1312020000000,13,12020,"Athens-Clarke County, GA MSA",2023,12,108578,105271,3307,3
MT1312060000000,13,12060,"Atlanta-Sandy Springs-Roswell, GA MSA",2023,12,3289776,3182556,107220,3.3
MT1312260000000,13,12260,"Augusta-Richmond County, GA-SC MSA",2023,12,266089,255924,10165,3.8
MT1315260000000,13,15260,"Brunswick-St. Simons, GA MSA",2023,12,55158,53588,1570,2.8
MT1317980000000,13,17980,"Columbus, GA-AL MSA",2023,12,129272,124505,4767,3.7
MT1319140000000,13,19140,"Dalton, GA MSA",2023,12,67920,65671,2249,3.3
MT1323580000000,13,23580,"Gainesville, GA MSA",2023,12,109061,106236,2825,2.6
MT1325980000000,13,25980,"Hinesville, GA MSA",2023,12,30992,29829,1163,3.8
MT1331420000000,13,31420,"Macon-Bibb County, GA MSA",2023,12,97158,93466,3692,3.8
MT1340660000000,13,40660,"Rome, GA MSA",2023,12,48203,46721,1482,3.1
MT1342340000000,13,42340,"Savannah, GA MSA",2023,12,209756,203741,6015,2.9
MT1346660000000,13,46660,"Valdosta, GA MSA",2023,12,61476,59285,2191,3.6
MT1347580000000,13,47580,"Warner Robins, GA MSA",2023,12,89822,87206,2616,2.9
MT1527980000000,15,27980,"Kahului-Wailuku, HI MSA",2023,12,81972,77039,4933,6
MT1546520000000,15,46520,"Urban Honolulu, HI MSA",2023,12,468479,457037,11442,2.4
MT1614260000000,16,14260,"Boise City, ID MSA",2023,12,442455,428204,14251,3.2
MT1617660000000,16,17660,"Coeur d'Alene, ID MSA",2023,12,89231,85591,3640,4.1
MT1626820000000,16,26820,"Idaho Falls, ID MSA",2023,12,83949,81613,2336,2.8
MT1630300000000,16,30300,"Lewiston, ID-WA MSA",2023,12,31051,30036,1015,3.3
MT1638540000000,16,38540,"Pocatello, ID MSA",2023,12,40594,39127,1467,3.6
MT1646300000000,16,46300,"Twin Falls, ID MSA",2023,12,59376,57454,1922,3.2
MT1714010000000,17,14010,"Bloomington, IL MSA",2023,12,96688,93109,3579,3.7
MT1716580000000,17,16580,"Champaign-Urbana, IL MSA",2023,12,124619,119223,5396,4.3
MT1716980000000,17,16980,"Chicago-Naperville-Elgin, IL-IN MSA",2023,12,4947843,4712463,235380,4.8
MT1719340000000,17,19340,"Davenport-Moline-Rock Island, IA-IL MSA",2023,12,190417,182453,7964,4.2
MT1719500000000,17,19500,"Decatur, IL MSA",2023,12,44771,42054,2717,6.1
MT1728100000000,17,28100,"Kankakee, IL MSA",2023,12,51245,48171,3074,6
MT1737900000000,17,37900,"Peoria, IL MSA",2023,12,177421,168807,8614,4.9
MT1740420000000,17,40420,"Rockford, IL MSA",2023,12,160871,150995,9876,6.1
MT1744100000000,17,44100,"Springfield, IL MSA",2023,12,103753,99356,4397,4.2
MT1814020000000,18,14020,"Bloomington, IN MSA",2023,12,84405,81535,2870,3.4
MT1818020000000,18,18020,"Columbus, IN MSA",2023,12,39574,38172,1402,3.5
MT1821140000000,18,21140,"Elkhart-Goshen, IN MSA",2023,12,98630,94266,4364,4.4
MT1821780000000,18,21780,"Evansville, IN MSA",2023,12,134595,129947,4648,3.5
MT1823060000000,18,23060,"Fort Wayne, IN MSA",2023,12,230291,222621,7670,3.3
MT1826900000000,18,26900,"Indianapolis-Carmel-Greenwood, IN MSA",2023,12,1127451,1089351,38100,3.4
MT1829020000000,18,29020,"Kokomo, IN MSA",2023,12,35208,33497,1711,4.9
MT1829200000000,18,29200,"Lafayette-West Lafayette, IN MSA",2023,12,119881,116110,3771,3.1
MT1833140000000,18,33140,"Michigan City-La Porte, IN MSA",2023,12,51608,49498,2110,4.1
MT1834620000000,18,34620,"Muncie, IN MSA",2023,12,51944,49750,2194,4.2
MT1843780000000,18,43780,"South Bend-Mishawaka, IN-MI MSA",2023,12,153187,146645,6542,4.3
MT1845460000000,18,45460,"Terre Haute, IN MSA",2023,12,76537,73595,2942,3.8
MT1911180000000,19,11180,"Ames, IA MSA",2023,12,69587,67974,1613,2.3
MT1916300000000,19,16300,"Cedar Rapids, IA MSA",2023,12,146890,142307,4583,3.1
MT1919780000000,19,19780,"Des Moines-West Des Moines, IA MSA",2023,12,411462,400492,10970,2.7
MT1920220000000,19,20220,"Dubuque, IA MSA",2023,12,53593,52055,1538,2.9
MT1926980000000,19,26980,"Iowa City, IA MSA",2023,12,99479,97181,2298,2.3
MT1943580000000,19,43580,"Sioux City, IA-NE-SD MSA",2023,12,76747,74607,2140,2.8
MT1947940000000,19,47940,"Waterloo-Cedar Falls, IA MSA",2023,12,88205,85687,2518,2.9
MT2029940000000,20,29940,"Lawrence, KS MSA",2023,12,70466,68532,1934,2.7
MT2031740000000,20,31740,"Manhattan, KS MSA",2023,12,63616,61785,1831,2.9
MT2045820000000,20,45820,"Topeka, KS MSA",2023,12,117946,114320,3626,3.1
MT2048620000000,20,48620,"Wichita, KS MSA",2023,12,333671,322855,10816,3.2
MT2114540000000,21,14540,"Bowling Green, KY MSA",2023,12,91387,87406,3981,4.4
MT2121060000000,21,21060,"Elizabethtown, KY MSA",2023,12,55570,53067,2503,4.5
MT2130460000000,21,30460,"Lexington-Fayette, KY MSA",2023,12,274667,264059,10608,3.9
MT2131140000000,21,31140,"Louisville/Jefferson County, KY-IN MSA",2023,12,693059,665005,28054,4
MT2136980000000,21,36980,"Owensboro, KY MSA",2023,12,51324,48938,2386,4.6
MT2137140000000,21,37140,"Paducah, KY-IL MSA",2023,12,45919,43785,2134,4.6
MT2210780000000,22,10780,"Alexandria, LA MSA",2023,12,64484,61854,2630,4.1
MT2212940000000,22,12940,"Baton Rouge, LA MSA",2023,12,427022,409965,17057,4
MT2225220000000,22,25220,"Hammond, LA MSA",2023,12,60548,57741,2807,4.6
MT2226380000000,22,26380,"Houma-Bayou Cane-Thibodaux, LA MSA",2023,12,88610,85365,3245,3.7
MT2229180000000,22,29180,"Lafayette, LA MSA",2023,12,198080,190792,7288,3.7
MT2229340000000,22,29340,"Lake Charles, LA MSA",2023,12,98111,93831,4280,4.4
MT2233740000000,22,33740,"Monroe, LA MSA",2023,12,96089,91525,4564,4.7
MT2235380000000,22,35380,"New Orleans-Metairie, LA MSA",2023,12,467838,447743,20095,4.3
MT2243340000000,22,43340,"Shreveport-Bossier City, LA MSA",2023,12,168655,161328,7327,4.3
MT2243640000000,22,43640,"Slidell-Mandeville-Covington, LA MSA",2023,12,129481,124615,4866,3.8
MT2312620000000,23,12620,"Bangor, ME MSA",2023,12,75041,72696,2345,3.1
MT2330340000000,23,30340,"Lewiston-Auburn, ME MSA",2023,12,55184,53600,1584,2.9
MT2338860000000,23,38860,"Portland-South Portland, ME MSA",2023,12,311340,303995,7345,2.4
MT2412580000000,24,12580,"Baltimore-Columbia-Towson, MD MSA",2023,12,1490635,1449958,40677,2.7
MT2425180000000,24,25180,"Hagerstown-Martinsburg, MD-WV MSA",2023,12,143290,138668,4622,3.2
MT2430500000000,24,30500,"Lexington Park, MD MSA",2023,12,108405,105795,2610,2.4
MT2441540000000,24,41540,"Salisbury, MD MSA",2023,12,64369,62480,1889,2.9
MT2511200000000,25,11200,"Amherst Town-Northampton, MA MSA",2023,12,84739,81835,2904,3.4
MT2512700000000,25,12700,"Barnstable Town, MA MSA",2023,12,115291,110022,5269,4.6
MT2514460000000,25,14460,"Boston-Cambridge-Newton, MA-NH MSA",2023,12,2802916,2708778,94138,3.4
MT2538340000000,25,38340,"Pittsfield, MA MSA",2023,12,64212,61809,2403,3.7
MT2544140000000,25,44140,"Springfield, MA MSA",2023,12,222776,212185,10591,4.8
MT2549340000000,25,49340,"Worcester, MA MSA",2023,12,462388,444817,17571,3.8
MT2611460000000,26,11460,"Ann Arbor, MI MSA",2023,12,206579,199865,6714,3.3
MT2612980000000,26,12980,"Battle Creek, MI MSA",2023,12,62675,59910,2765,4.4
MT2613020000000,26,13020,"Bay City, MI MSA",2023,12,50198,47747,2451,4.9
MT2619820000000,26,19820,"Detroit-Warren-Dearborn, MI MSA",2023,12,2185056,2101944,83112,3.8
MT2622420000000,26,22420,"Flint, MI MSA",2023,12,187088,177834,9254,4.9
MT2624340000000,26,24340,"Grand Rapids-Wyoming-Kentwood, MI MSA",2023,12,628048,607019,21029,3.3
MT2627100000000,26,27100,"Jackson, MI MSA",2023,12,74907,71779,3128,4.2
MT2628020000000,26,28020,"Kalamazoo-Portage, MI MSA",2023,12,139652,134643,5009,3.6
MT2629620000000,26,29620,"Lansing-East Lansing, MI MSA",2023,12,252564,242871,9693,3.8
MT2633220000000,26,33220,"Midland, MI MSA",2023,12,42697,41097,1600,3.7
MT2633780000000,26,33780,"Monroe, MI MSA",2023,12,78777,75340,3437,4.4
MT2634740000000,26,34740,"Muskegon-Norton Shores, MI MSA",2023,12,84331,80679,3652,4.3
MT2635660000000,26,35660,"Niles, MI MSA",2023,12,76355,73151,3204,4.2
MT2640980000000,26,40980,"Saginaw, MI MSA",2023,12,84942,80577,4365,5.1
MT2645900000000,26,45900,"Traverse City, MI MSA",2023,12,81051,78019,3032,3.7
MT2720260000000,27,20260,"Duluth, MN-WI MSA",2023,12,139557,134946,4611,3.3
MT2731860000000,27,31860,"Mankato, MN MSA",2023,12,60044,58621,1423,2.4
MT2733460000000,27,33460,"Minneapolis-St. Paul-Bloomington, MN-WI MSA",2023,12,2059914,2005187,54727,2.7
MT2740340000000,27,40340,"Rochester, MN MSA",2023,12,125758,122913,2845,2.3
MT2741060000000,27,41060,"St. Cloud, MN MSA",2023,12,109533,106434,3099,2.8
MT2825060000000,28,25060,"Gulfport-Biloxi, MS MSA",2023,12,184848,179982,4866,2.6
MT2825620000000,28,25620,"Hattiesburg, MS MSA",2023,12,69802,67974,1828,2.6
MT2827140000000,28,27140,"Jackson, MS MSA",2023,12,276946,269825,7121,2.6
MT2916020000000,29,16020,"Cape Girardeau, MO-IL MSA",2023,12,49153,47603,1550,3.2
MT2917860000000,29,17860,"Columbia, MO MSA",2023,12,112643,109369,3274,2.9
MT2927620000000,29,27620,"Jefferson City, MO MSA",2023,12,75719,73498,2221,2.9
MT2927900000000,29,27900,"Joplin, MO-KS MSA",2023,12,97497,94211,3286,3.4
MT2928140000000,29,28140,"Kansas City, MO-KS MSA",2023,12,1190111,1150764,39347,3.3
MT2941140000000,29,41140,"St. Joseph, MO-KS MSA",2023,12,53922,52075,1847,3.4
MT2941180000000,29,41180,"St. Louis, MO-IL MSA",2023,12,1479939,1427146,52793,3.6
MT2944180000000,29,44180,"Springfield, MO MSA",2023,12,241140,233724,7416,3.1
MT3013740000000,30,13740,"Billings, MT MSA",2023,12,99218,96442,2776,2.8
MT3014580000000,30,14580,"Bozeman, MT MSA",2023,12,77088,75338,1750,2.3
MT3024500000000,30,24500,"Great Falls, MT MSA",2023,12,40028,38813,1215,3
MT3025740000000,30,25740,"Helena, MT MSA",2023,12,47349,45998,1351,2.9
MT3033540000000,30,33540,"Missoula, MT MSA",2023,12,74005,71814,2191,3
MT3124260000000,31,24260,"Grand Island, NE MSA",2023,12,42662,41602,1060,2.5
MT3130700000000,31,30700,"Lincoln, NE MSA",2023,12,192027,187596,4431,2.3
MT3136540000000,31,36540,"Omaha, NE-IA MSA",2023,12,523686,509427,14259,2.7
MT3216180000000,32,16180,"Carson City, NV MSA",2023,12,28799,27584,1215,4.2
MT3229820000000,32,29820,"Las Vegas-Henderson-North Las Vegas, NV MSA",2023,12,1204201,1138468,65733,5.5
MT3239900000000,32,39900,"Reno, NV MSA",2023,12,296933,283846,13087,4.4
MT3331700000000,33,31700,"Manchester-Nashua, NH MSA",2023,12,239743,233771,5972,2.5
MT3412100000000,34,12100,"Atlantic City-Hammonton, NJ MSA",2023,12,179847,168969,10878,6
MT3445940000000,34,45940,"Trenton-Princeton, NJ MSA",2023,12,199076,190538,8538,4.3
MT3447220000000,34,47220,"Vineland, NJ MSA",2023,12,65527,61000,4527,6.9
MT3510740000000,35,10740,"Albuquerque, NM MSA",2023,12,459777,443563,16214,3.5
MT3522140000000,35,22140,"Farmington, NM MSA",2023,12,49516,47424,2092,4.2
MT3529740000000,35,29740,"Las Cruces, NM MSA",2023,12,101517,97073,4444,4.4
MT3542140000000,35,42140,"Santa Fe, NM MSA",2023,12,73757,71262,2495,3.4
MT3610580000000,36,10580,"Albany-Schenectady-Troy, NY MSA",2023,12,458704,442931,15773,3.4
MT3613780000000,36,13780,"Binghamton, NY MSA",2023,12,107526,103313,4213,3.9
MT3615380000000,36,15380,"Buffalo-Cheektowaga, NY MSA",2023,12,561004,538640,22364,4
MT3621300000000,36,21300,"Elmira, NY MSA",2023,12,35812,34429,1383,3.9
MT3624020000000,36,24020,"Glens Falls, NY MSA",2023,12,59718,57541,2177,3.6
MT3627060000000,36,27060,"Ithaca, NY MSA",2023,12,48416,46760,1656,3.4
MT3628740000000,36,28740,"Kingston, NY MSA",2023,12,87942,84671,3271,3.7
MT3628880000000,36,28880,"Kiryas Joel-Poughkeepsie-Newburgh, NY MSA",2023,12,341753,329434,12319,3.6
MT3635620000000,36,35620,"New York-Newark-Jersey City, NY-NJ MSA",2023,12,10157182,9717223,439959,4.3
MT3640380000000,36,40380,"Rochester, NY MSA",2023,12,515529,496060,19469,3.8
MT3645060000000,36,45060,"Syracuse, NY MSA",2023,12,311265,299585,11680,3.8
MT3646540000000,36,46540,"Utica-Rome, NY MSA",2023,12,128208,123287,4921,3.8
MT3648060000000,36,48060,"Watertown-Fort Drum, NY MSA",2023,12,45031,42984,2047,4.5
MT3711700000000,37,11700,"Asheville, NC MSA",2023,12,211835,205726,6109,2.9
MT3715500000000,37,15500,"Burlington, NC MSA",2023,12,86076,83059,3017,3.5
MT3716740000000,37,16740,"Charlotte-Concord-Gastonia, NC-SC MSA",2023,12,1476597,1425272,51325,3.5
MT3720500000000,37,20500,"Durham-Chapel Hill, NC MSA",2023,12,321977,311705,10272,3.2
MT3722180000000,37,22180,"Fayetteville, NC MSA",2023,12,156071,149190,6881,4.4
MT3724140000000,37,24140,"Goldsboro, NC MSA",2023,12,50517,48652,1865,3.7
MT3724660000000,37,24660,"Greensboro-High Point, NC MSA",2023,12,373903,359299,14604,3.9
MT3724780000000,37,24780,"Greenville, NC MSA",2023,12,84208,80711,3497,4.2
MT3725860000000,37,25860,"Hickory-Lenoir-Morganton, NC MSA",2023,12,171805,165976,5829,3.4
MT3727340000000,37,27340,"Jacksonville, NC MSA",2023,12,74544,71783,2761,3.7
MT3738240000000,37,38240,"Pinehurst-Southern Pines, NC MSA",2023,12,44680,43130,1550,3.5
MT3739580000000,37,39580,"Raleigh-Cary, NC MSA",2023,12,842267,815812,26455,3.1
MT3740580000000,37,40580,"Rocky Mount, NC MSA",2023,12,63566,60543,3023,4.8
MT3748900000000,37,48900,"Wilmington, NC MSA",2023,12,222583,214656,7927,3.6
MT3749180000000,37,49180,"Winston-Salem, NC MSA",2023,12,324696,313133,11563,3.6
MT3813900000000,38,13900,"Bismarck, ND MSA",2023,12,72547,71061,1486,2
MT3822020000000,38,22020,"Fargo, ND-MN MSA",2023,12,153044,149962,3082,2
MT3824220000000,38,24220,"Grand Forks, ND-MN MSA",2023,12,55911,54695,1216,2.2
MT3833500000000,38,33500,"Minot, ND MSA",2023,12,40168,39273,895,2.2
MT3910420000000,39,10420,"Akron, OH MSA",2023,12,358694,344485,14209,4
MT3915940000000,39,15940,"Canton-Massillon, OH MSA",2023,12,193443,185494,7949,4.1
MT3917140000000,39,17140,"Cincinnati, OH-KY-IN MSA",2023,12,1165386,1121518,43868,3.8
MT3917410000000,39,17410,"Cleveland, OH MSA",2023,12,1091027,1050109,40918,3.8
MT3918140000000,39,18140,"Columbus, OH MSA",2023,12,1145190,1104804,40386,3.5
MT3919430000000,39,19430,"Dayton-Kettering-Beavercreek, OH MSA",2023,12,392147,376903,15244,3.9
MT3930620000000,39,30620,"Lima, OH MSA",2023,12,47297,45481,1816,3.8
MT3931900000000,39,31900,"Mansfield, OH MSA",2023,12,53132,50772,2360,4.4
MT3941780000000,39,41780,"Sandusky, OH MSA",2023,12,56788,54116,2672,4.7
MT3944220000000,39,44220,"Springfield, OH MSA",2023,12,62131,59612,2519,4.1
MT3945780000000,39,45780,"Toledo, OH MSA",2023,12,295402,282230,13172,4.5
MT3948260000000,39,48260,"Weirton-Steubenville, WV-OH MSA",2023,12,51921,49155,2766,5.3
MT3949660000000,39,49660,"Youngstown-Warren, OH MSA",2023,12,192319,183430,8889,4.6
MT4021420000000,40,21420,"Enid, OK MSA",2023,12,28436,27463,973,3.4
MT4030020000000,40,30020,"Lawton, OK MSA",2023,12,52420,50391,2029,3.9
MT4036420000000,40,36420,"Oklahoma City, OK MSA",2023,12,770783,746231,24552,3.2
MT4046140000000,40,46140,"Tulsa, OK MSA",2023,12,523265,505167,18098,3.5
MT4110540000000,41,10540,"Albany, OR MSA",2023,12,61414,58665,2749,4.5
MT4113460000000,41,13460,"Bend, OR MSA",2023,12,132138,126659,5479,4.1
MT4118700000000,41,18700,"Corvallis, OR MSA",2023,12,49378,47593,1785,3.6
MT4121660000000,41,21660,"Eugene-Springfield, OR MSA",2023,12,187379,179426,7953,4.2
MT4124420000000,41,24420,"Grants Pass, OR MSA",2023,12,35081,33121,1960,5.6
MT4132780000000,41,32780,"Medford, OR MSA",2023,12,106068,100956,5112,4.8
MT4138900000000,41,38900,"Portland-Vancouver-Hillsboro, OR-WA MSA",2023,12,1381364,1326969,54395,3.9
MT4141420000000,41,41420,"Salem, OR MSA",2023,12,219917,211017,8900,4
MT4210900000000,42,10900,"Allentown-Bethlehem-Easton, PA-NJ MSA",2023,12,453430,434889,18541,4.1
MT4211020000000,42,11020,"Altoona, PA MSA",2023,12,57720,55687,2033,3.5
MT4216540000000,42,16540,"Chambersburg, PA MSA",2023,12,76606,74223,2383,3.1
MT4221500000000,42,21500,"Erie, PA MSA",2023,12,127417,122482,4935,3.9
MT4223900000000,42,23900,"Gettysburg, PA MSA",2023,12,52403,50815,1588,3
MT4225420000000,42,25420,"Harrisburg-Carlisle, PA MSA",2023,12,315866,305648,10218,3.2
MT4227780000000,42,27780,"Johnstown, PA MSA",2023,12,57409,54974,2435,4.2
MT4229540000000,42,29540,"Lancaster, PA MSA",2023,12,294580,286021,8559,2.9
MT4230140000000,42,30140,"Lebanon, PA MSA",2023,12,73989,71661,2328,3.1
MT4237980000000,42,37980,"Philadelphia-Camden-Wilmington, PA-NJ-DE-MD MSA",2023,12,3309292,3183228,126064,3.8
MT4238300000000,42,38300,"Pittsburgh, PA MSA",2023,12,1244862,1200518,44344,3.6
MT4239740000000,42,39740,"Reading, PA MSA",2023,12,220662,212316,8346,3.8
MT4242540000000,42,42540,"Scranton--Wilkes-Barre, PA MSA",2023,12,281739,269605,12134,4.3
MT4244300000000,42,44300,"State College, PA MSA",2023,12,77729,75518,2211,2.8
MT4248700000000,42,48700,"Williamsport, PA MSA",2023,12,53441,51363,2078,3.9
MT4249620000000,42,49620,"York-Hanover, PA MSA",2023,12,242475,234517,7958,3.3
MT4439300000000,44,39300,"Providence-Warwick, RI-MA MSA",2023,12,893524,858165,35359,4
MT4516700000000,45,16700,"Charleston-North Charleston, SC MSA",2023,12,438523,426074,12449,2.8
MT4517900000000,45,17900,"Columbia, SC MSA",2023,12,414398,400879,13519,3.3
MT4522500000000,45,22500,"Florence, SC MSA",2023,12,91630,88273,3357,3.7
MT4524860000000,45,24860,"Greenville-Anderson-Greer, SC MSA",2023,12,475272,460613,14659,3.1
MT4525940000000,45,25940,"Hilton Head Island-Bluffton-Port Royal, SC MSA",2023,12,97044,94046,2998,3.1
MT4534820000000,45,34820,"Myrtle Beach-Conway-North Myrtle Beach, SC MSA",2023,12,169402,162760,6642,3.9
MT4543900000000,45,43900,"Spartanburg, SC MSA",2023,12,174896,168909,5987,3.4
MT4544940000000,45,44940,"Sumter, SC MSA",2023,12,41410,39669,1741,4.2
MT4639660000000,46,39660,"Rapid City, SD MSA",2023,12,78968,77581,1387,1.8
MT4643620000000,46,43620,"Sioux Falls, SD-MN MSA",2023,12,172777,169924,2853,1.7
MT4716860000000,47,16860,"Chattanooga, TN-GA MSA",2023,12,288294,279815,8479,2.9
MT4717300000000,47,17300,"Clarksville, TN-KY MSA",2023,12,136776,131421,5355,3.9
MT4717420000000,47,17420,"Cleveland, TN MSA",2023,12,56471,54554,1917,3.4
MT4727180000000,47,27180,"Jackson, TN MSA",2023,12,78271,75553,2718,3.5
MT4727740000000,47,27740,"Johnson City, TN MSA",2023,12,96380,93290,3090,3.2
MT4728700000000,47,28700,"Kingsport-Bristol, TN-VA MSA",2023,12,132488,128054,4434,3.3
MT4728940000000,47,28940,"Knoxville, TN MSA",2023,12,447899,434614,13285,3
MT4732820000000,47,32820,"Memphis, TN-MS-AR MSA",2023,12,623917,600268,23649,3.8
MT4734100000000,47,34100,"Morristown, TN MSA",2023,12,52874,51121,1753,3.3
MT4734980000000,47,34980,"Nashville-Davidson--Murfreesboro--Franklin, TN MSA",2023,12,1150080,1119758,30322,2.6
MT4810180000000,48,10180,"Abilene, TX MSA",2023,12,85465,82623,2842,3.3
MT4811100000000,48,11100,"Amarillo, TX MSA",2023,12,136034,131930,4104,3
MT4812420000000,48,12420,"Austin-Round Rock-San Marcos, TX MSA",2023,12,1476553,1425811,50742,3.4
MT4813140000000,48,13140,"Beaumont-Port Arthur, TX MSA",2023,12,177442,168425,9017,5.1
MT4815180000000,48,15180,"Brownsville-Harlingen, TX MSA",2023,12,187036,177688,9348,5
MT4817780000000,48,17780,"College Station-Bryan, TX MSA",2023,12,148367,143415,4952,3.3
MT4818580000000,48,18580,"Corpus Christi, TX MSA",2023,12,208251,199607,8644,4.2
MT4819100000000,48,19100,"Dallas-Fort Worth-Arlington, TX MSA",2023,12,4424286,4257287,166999,3.8
MT4820580000000,48,20580,"Eagle Pass, TX MSA",2023,12,23633,21903,1730,7.3
MT4821340000000,48,21340,"El Paso, TX MSA",2023,12,406450,389663,16787,4.1
MT4826420000000,48,26420,"Houston-Pasadena-The Woodlands, TX MSA",2023,12,3777833,3621363,156470,4.1
MT4828660000000,48,28660,"Killeen-Temple, TX MSA",2023,12,200095,191846,8249,4.1
MT4829700000000,48,29700,"Laredo, TX MSA",2023,12,116550,111833,4717,4
MT4830980000000,48,30980,"Longview, TX MSA",2023,12,128553,122778,5775,4.5
MT4831180000000,48,31180,"Lubbock, TX MSA",2023,12,182423,176380,6043,3.3
MT4832580000000,48,32580,"McAllen-Edinburg-Mission, TX MSA",2023,12,390708,368314,22394,5.7
MT4833260000000,48,33260,"Midland, TX MSA",2023,12,101637,98868,2769,2.7
MT4836220000000,48,36220,"Odessa, TX MSA",2023,12,84617,81809,2808,3.3
MT4841660000000,48,41660,"San Angelo, TX MSA",2023,12,61240,59350,1890,3.1
MT4841700000000,48,41700,"San Antonio-New Braunfels, TX MSA",2023,12,1316228,1268766,47462,3.6
MT4843300000000,48,43300,"Sherman-Denison, TX MSA",2023,12,70709,68122,2587,3.7
MT4845500000000,48,45500,"Texarkana, TX-AR MSA",2023,12,61079,58665,2414,4
MT4846340000000,48,46340,"Tyler, TX MSA",2023,12,116354,112150,4204,3.6
MT4847020000000,48,47020,"Victoria, TX MSA",2023,12,44636,42883,1753,3.9
MT4847380000000,48,47380,"Waco, TX MSA",2023,12,144600,139356,5244,3.6
MT4848660000000,48,48660,"Wichita Falls, TX MSA",2023,12,66542,64139,2403,3.6
MT4930860000000,49,30860,"Logan, UT-ID MSA",2023,12,79087,77049,2038,2.6
MT4936260000000,49,36260,"Ogden, UT MSA",2023,12,349460,340005,9455,2.7
MT4939340000000,49,39340,"Provo-Orem-Lehi, UT MSA",2023,12,366960,356260,10700,2.9
MT4941100000000,49,41100,"St. George, UT MSA",2023,12,92075,89239,2836,3.1
MT4941620000000,49,41620,"Salt Lake City-Murray, UT MSA",2023,12,732352,710832,21520,2.9
MT5015540000000,50,15540,"Burlington-South Burlington, VT MSA",2023,12,130644,128432,2212,1.7
MT5113980000000,51,13980,"Blacksburg-Christiansburg-Radford, VA MSA",2023,12,94430,91770,2660,2.8
MT5116820000000,51,16820,"Charlottesville, VA MSA",2023,12,120223,117269,2954,2.5
MT5125500000000,51,25500,"Harrisonburg, VA MSA",2023,12,72731,70790,1941,2.7
MT5131340000000,51,31340,"Lynchburg, VA MSA",2023,12,128482,124438,4044,3.1
MT5140060000000,51,40060,"Richmond, VA MSA",2023,12,724396,703347,21049,2.9
MT5140220000000,51,40220,"Roanoke, VA MSA",2023,12,158370,153926,4444,2.8
MT5144420000000,51,44420,"Staunton-Stuarts Draft, VA MSA",2023,12,65646,64059,1587,2.4
MT5147260000000,51,47260,"Virginia Beach-Chesapeake-Norfolk, VA-NC MSA",2023,12,883856,857526,26330,3
MT5149020000000,51,49020,"Winchester, VA-WV MSA",2023,12,77452,75391,2061,2.7
MT5313380000000,53,13380,"Bellingham, WA MSA",2023,12,114299,109046,5253,4.6
MT5314740000000,53,14740,"Bremerton-Silverdale-Port Orchard, WA MSA",2023,12,122482,116746,5736,4.7
MT5328420000000,53,28420,"Kennewick-Richland, WA MSA",2023,12,145476,138104,7372,5.1
MT5331020000000,53,31020,"Longview-Kelso, WA MSA",2023,12,47252,44721,2531,5.4
MT5334580000000,53,34580,"Mount Vernon-Anacortes, WA MSA",2023,12,59111,56123,2988,5.1
MT5336500000000,53,36500,"Olympia-Lacey-Tumwater, WA MSA",2023,12,143192,136538,6654,4.6
MT5342660000000,53,42660,"Seattle-Tacoma-Bellevue, WA MSA",2023,12,2314604,2213799,100805,4.4
MT5344060000000,53,44060,"Spokane-Spokane Valley, WA MSA",2023,12,282372,269359,13013,4.6
MT5347460000000,53,47460,"Walla Walla, WA MSA",2023,12,29200,27938,1262,4.3
MT5348300000000,53,48300,"Wenatchee-East Wenatchee, WA MSA",2023,12,62074,59083,2991,4.8
MT5349420000000,53,49420,"Yakima, WA MSA",2023,12,126017,118449,7568,6
MT5413220000000,54,13220,"Beckley, WV MSA",2023,12,46232,44413,1819,3.9
MT5416620000000,54,16620,"Charleston, WV MSA",2023,12,91389,87759,3630,4
MT5426580000000,54,26580,"Huntington-Ashland, WV-KY-OH MSA",2023,12,156604,149085,7519,4.8
MT5434060000000,54,34060,"Morgantown, WV MSA",2023,12,71203,68683,2520,3.5
MT5437620000000,54,37620,"Parkersburg-Vienna, WV MSA",2023,12,39664,37920,1744,4.4
MT5448540000000,54,48540,"Wheeling, WV-OH MSA",2023,12,59417,56678,2739,4.6
MT5511540000000,55,11540,"Appleton, WI MSA",2023,12,137027,133786,3241,2.4
MT5520740000000,55,20740,"Eau Claire, WI MSA",2023,12,95949,93256,2693,2.8
MT5522540000000,55,22540,"Fond du Lac, WI MSA",2023,12,55788,54381,1407,2.5
MT5524580000000,55,24580,"Green Bay, WI MSA",2023,12,178430,173809,4621,2.6
MT5527500000000,55,27500,"Janesville-Beloit, WI MSA",2023,12,86879,84124,2755,3.2
MT5528450000000,55,28450,"Kenosha, WI MSA",2023,12,95780,92757,3023,3.2
MT5529100000000,55,29100,"La Crosse-Onalaska, WI-MN MSA",2023,12,90437,88177,2260,2.5
MT5531540000000,55,31540,"Madison, WI MSA",2023,12,409577,400645,8932,2.2
MT5533340000000,55,33340,"Milwaukee-Waukesha, WI MSA",2023,12,821723,796114,25609,3.1
MT5536780000000,55,36780,"Oshkosh-Neenah, WI MSA",2023,12,93378,91013,2365,2.5
MT5539540000000,55,39540,"Racine-Mount Pleasant, WI MSA",2023,12,101915,98578,3337,3.3
MT5543100000000,55,43100,"Sheboygan, WI MSA",2023,12,63374,61894,1480,2.3
MT5548140000000,55,48140,"Wausau, WI MSA",2023,12,75126,73199,1927,2.6
MT5616220000000,56,16220,"Casper, WY MSA",2023,12,42056,40843,1213,2.9
MT5616940000000,56,16940,"Cheyenne, WY MSA",2023,12,48840,47400,1440,2.9
MT7210380000000,72,10380,"Aguadilla, PR MSA",2023,12,89593,83427,6166,6.9
MT7211640000000,72,11640,"Arecibo, PR MSA",2023,12,67092,63269,3823,5.7
MT7225020000000,72,25020,"Guayama, PR MSA",2023,12,19249,17486,1763,9.2
MT7232420000000,72,32420,"Mayaguez, PR MSA",2023,12,67182,62550,4632,6.9
MT7238660000000,72,38660,"Ponce, PR MSA",2023,12,89863,81984,7879,8.8
MT7241980000000,72,41980,"San Juan-Bayamon-Caguas, PR MSA",2023,12,820110,780158,39952,4.9
MT0111500000000,1,11500,"Anniston-Oxford, AL MSA",2024,1,49163,47700,1463,3
MT0112220000000,1,12220,"Auburn-Opelika, AL MSA",2024,1,96143,93634,2509,2.6
MT0113820000000,1,13820,"Birmingham, AL MSA",2024,1,568350,553382,14968,2.6
MT0119300000000,1,19300,"Daphne-Fairhope-Foley, AL MSA",2024,1,115622,112811,2811,2.4
MT0119460000000,1,19460,"Decatur, AL MSA",2024,1,75115,73391,1724,2.3
MT0120020000000,1,20020,"Dothan, AL MSA",2024,1,67560,65632,1928,2.9
MT0122520000000,1,22520,"Florence-Muscle Shoals, AL MSA",2024,1,68271,66251,2020,3
MT0123460000000,1,23460,"Gadsden, AL MSA",2024,1,41702,40473,1229,2.9
MT0126620000000,1,26620,"Huntsville, AL MSA",2024,1,273160,266777,6383,2.3
MT0133660000000,1,33660,"Mobile, AL MSA",2024,1,184676,177647,7029,3.8
MT0133860000000,1,33860,"Montgomery, AL MSA",2024,1,177132,172009,5123,2.9
MT0146220000000,1,46220,"Tuscaloosa, AL MSA",2024,1,126032,122333,3699,2.9
MT0211260000000,2,11260,"Anchorage, AK MSA",2024,1,200227,192251,7976,4
MT0221820000000,2,21820,"Fairbanks-College, AK MSA",2024,1,45374,43661,1713,3.8
MT0422380000000,4,22380,"Flagstaff, AZ MSA",2024,1,75355,72603,2752,3.7
MT0429420000000,4,29420,"Lake Havasu City-Kingman, AZ MSA",2024,1,87443,83862,3581,4.1
MT0438060000000,4,38060,"Phoenix-Mesa-Chandler, AZ MSA",2024,1,2689947,2609568,80379,3
MT0439150000000,4,39150,"Prescott Valley-Prescott, AZ MSA",2024,1,106299,102823,3476,3.3
MT0443420000000,4,43420,"Sierra Vista-Douglas, AZ MSA",2024,1,48137,46162,1975,4.1
MT0446060000000,4,46060,"Tucson, AZ MSA",2024,1,493177,476608,16569,3.4
MT0449740000000,4,49740,"Yuma, AZ MSA",2024,1,98468,86730,11738,11.9
MT0522220000000,5,22220,"Fayetteville-Springdale-Rogers, AR MSA",2024,1,302510,294647,7863,2.6
MT0522900000000,5,22900,"Fort Smith, AR-OK MSA",2024,1,101531,97904,3627,3.6
MT0526300000000,5,26300,"Hot Springs, AR MSA",2024,1,43887,42331,1556,3.5
MT0527860000000,5,27860,"Jonesboro, AR MSA",2024,1,65632,63606,2026,3.1
MT0530780000000,5,30780,"Little Rock-North Little Rock-Conway, AR MSA",2024,1,377096,365038,12058,3.2
MT0612540000000,6,12540,"Bakersfield-Delano, CA MSA",2024,1,405024,370369,34655,8.6
MT0617020000000,6,17020,"Chico, CA MSA",2024,1,91133,86000,5133,5.6
MT0620940000000,6,20940,"El Centro, CA MSA",2024,1,72476,59203,13273,18.3
MT0623420000000,6,23420,"Fresno, CA MSA",2024,1,533799,492564,41235,7.7
MT0625260000000,6,25260,"Hanford-Corcoran, CA MSA",2024,1,57878,52823,5055,8.7
MT0631080000000,6,31080,"Los Angeles-Long Beach-Anaheim, CA MSA",2024,1,6697093,6365604,331489,4.9
MT0632900000000,6,32900,"Merced, CA MSA",2024,1,119309,107940,11369,9.5
MT0633700000000,6,33700,"Modesto, CA MSA",2024,1,250633,233896,16737,6.7
MT0634900000000,6,34900,"Napa, CA MSA",2024,1,73337,70652,2685,3.7
MT0637100000000,6,37100,"Oxnard-Thousand Oaks-Ventura, CA MSA",2024,1,418992,400160,18832,4.5
MT0639820000000,6,39820,"Redding, CA MSA",2024,1,78575,74556,4019,5.1
MT0640140000000,6,40140,"Riverside-San Bernardino-Ontario, CA MSA",2024,1,2197470,2086224,111246,5.1
MT0640900000000,6,40900,"Sacramento-Roseville-Folsom, CA MSA",2024,1,1174253,1121360,52893,4.5
MT0641500000000,6,41500,"Salinas, CA MSA",2024,1,219440,203370,16070,7.3
MT0641740000000,6,41740,"San Diego-Chula Vista-Carlsbad, CA MSA",2024,1,1644185,1575747,68438,4.2
MT0641860000000,6,41860,"San Francisco-Oakland-Fremont, CA MSA",2024,1,2506650,2404636,102014,4.1
MT0641940000000,6,41940,"San Jose-Sunnyvale-Santa Clara, CA MSA",2024,1,1055872,1012514,43358,4.1
MT0642020000000,6,42020,"San Luis Obispo-Paso Robles, CA MSA",2024,1,132353,127179,5174,3.9
MT0642100000000,6,42100,"Santa Cruz-Watsonville, CA MSA",2024,1,135681,127788,7893,5.8
MT0642200000000,6,42200,"Santa Maria-Santa Barbara, CA MSA",2024,1,220481,210887,9594,4.4
MT0642220000000,6,42220,"Santa Rosa-Petaluma, CA MSA",2024,1,247289,237612,9677,3.9
MT0644700000000,6,44700,"Stockton-Lodi, CA MSA",2024,1,365812,342773,23039,6.3
MT0646700000000,6,46700,"Vallejo, CA MSA",2024,1,216496,206275,10221,4.7
MT0647300000000,6,47300,"Visalia, CA MSA",2024,1,221011,198214,22797,10.3
MT0649700000000,6,49700,"Yuba City, CA MSA",2024,1,80528,74437,6091,7.6
MT0814500000000,8,14500,"Boulder, CO MSA",2024,1,193811,186871,6940,3.6
MT0817820000000,8,17820,"Colorado Springs, CO MSA",2024,1,393116,378261,14855,3.8
MT0819740000000,8,19740,"Denver-Aurora-Centennial, CO MSA",2024,1,1766713,1701041,65672,3.7
MT0822660000000,8,22660,"Fort Collins-Loveland, CO MSA",2024,1,208991,201607,7384,3.5
MT0824300000000,8,24300,"Grand Junction, CO MSA",2024,1,79315,76217,3098,3.9
MT0824540000000,8,24540,"Greeley, CO MSA",2024,1,175677,168748,6929,3.9
MT0839380000000,8,39380,"Pueblo, CO MSA",2024,1,73559,69707,3852,5.2
MT0914860000000,9,14860,"Bridgeport-Stamford-Danbury, CT MSA",2024,1,511938,495782,16156,3.2
MT0925540000000,9,25540,"Hartford-West Hartford-East Hartford, CT MSA",2024,1,607563,587779,19784,3.3
MT0935300000000,9,35300,"New Haven, CT MSA",2024,1,314361,304111,10250,3.3
MT0935980000000,9,35980,"Norwich-New London-Willimantic, CT MSA",2024,1,141566,137023,4543,3.2
MT0947930000000,9,47930,"Waterbury-Shelton, CT MSA",2024,1,238834,229884,8950,3.7
MT1020100000000,10,20100,"Dover, DE MSA",2024,1,85360,81888,3472,4.1
MT1147900000000,11,47900,"Washington-Arlington-Alexandria, DC-VA-MD-WV MSA",2024,1,3537652,3438386,99266,2.8
MT1215980000000,12,15980,"Cape Coral-Fort Myers, FL MSA",2024,1,375630,362916,12714,3.4
MT1218880000000,12,18880,"Crestview-Fort Walton Beach-Destin, FL MSA",2024,1,142079,137973,4106,2.9
MT1219660000000,12,19660,"Deltona-Daytona Beach-Ormond Beach, FL MSA",2024,1,322514,310830,11684,3.6
MT1223540000000,12,23540,"Gainesville, FL MSA",2024,1,169070,162996,6074,3.6
MT1226140000000,12,26140,"Homosassa Springs, FL MSA",2024,1,53780,51248,2532,4.7
MT1227260000000,12,27260,"Jacksonville, FL MSA",2024,1,854661,826341,28320,3.3
MT1229460000000,12,29460,"Lakeland-Winter Haven, FL MSA",2024,1,357376,343071,14305,4
MT1233100000000,12,33100,"Miami-Fort Lauderdale-West Palm Beach, FL MSA",2024,1,3306092,3217928,88164,2.7
MT1234940000000,12,34940,"Naples-Marco Island, FL MSA",2024,1,184219,178247,5972,3.2
MT1235840000000,12,35840,"North Port-Bradenton-Sarasota, FL MSA",2024,1,396938,383667,13271,3.3
MT1236100000000,12,36100,"Ocala, FL MSA",2024,1,158283,152061,6222,3.9
MT1236740000000,12,36740,"Orlando-Kissimmee-Sanford, FL MSA",2024,1,1528158,1480088,48070,3.1
MT1237340000000,12,37340,"Palm Bay-Melbourne-Titusville, FL MSA",2024,1,305037,294998,10039,3.3
MT1237460000000,12,37460,"Panama City-Panama City Beach, FL MSA",2024,1,101117,97881,3236,3.2
MT1237860000000,12,37860,"Pensacola-Ferry Pass-Brent, FL MSA",2024,1,240707,232627,8080,3.4
MT1238940000000,12,38940,"Port St. Lucie, FL MSA",2024,1,238121,229362,8759,3.7
MT1239460000000,12,39460,"Punta Gorda, FL MSA",2024,1,76962,74032,2930,3.8
MT1242680000000,12,42680,"Sebastian-Vero Beach-West Vero Corridor, FL MSA",2024,1,68016,65320,2696,4
MT1242700000000,12,42700,"Sebring, FL MSA",2024,1,36406,34721,1685,4.6
MT1245220000000,12,45220,"Tallahassee, FL MSA",2024,1,206930,200152,6778,3.3
MT1245300000000,12,45300,"Tampa-St. Petersburg-Clearwater, FL MSA",2024,1,1702551,1647112,55439,3.3
MT1248680000000,12,48680,"Wildwood-The Villages, FL MSA",2024,1,33875,31975,1900,5.6
MT1310500000000,13,10500,"Albany, GA MSA",2024,1,62102,59687,2415,3.9
MT1312020000000,13,12020,"Athens-Clarke County, GA MSA",2024,1,108569,105230,3339,3.1
MT1312060000000,13,12060,"Atlanta-Sandy Springs-Roswell, GA MSA",2024,1,3293631,3186527,107104,3.3
MT1312260000000,13,12260,"Augusta-Richmond County, GA-SC MSA",2024,1,266606,256279,10327,3.9
MT1315260000000,13,15260,"Brunswick-St. Simons, GA MSA",2024,1,55248,53670,1578,2.9
MT1317980000000,13,17980,"Columbus, GA-AL MSA",2024,1,128944,124151,4793,3.7
MT1319140000000,13,19140,"Dalton, GA MSA",2024,1,67854,65576,2278,3.4
MT1323580000000,13,23580,"Gainesville, GA MSA",2024,1,109046,106215,2831,2.6
MT1325980000000,13,25980,"Hinesville, GA MSA",2024,1,30992,29820,1172,3.8
MT1331420000000,13,31420,"Macon-Bibb County, GA MSA",2024,1,97097,93373,3724,3.8
MT1340660000000,13,40660,"Rome, GA MSA",2024,1,48054,46551,1503,3.1
MT1342340000000,13,42340,"Savannah, GA MSA",2024,1,210115,204082,6033,2.9
MT1346660000000,13,46660,"Valdosta, GA MSA",2024,1,61450,59262,2188,3.6
MT1347580000000,13,47580,"Warner Robins, GA MSA",2024,1,89814,87181,2633,2.9
MT1527980000000,15,27980,"Kahului-Wailuku, HI MSA",2024,1,81975,77458,4517,5.5
MT1546520000000,15,46520,"Urban Honolulu, HI MSA",2024,1,468585,457015,11570,2.5
MT1614260000000,16,14260,"Boise City, ID MSA",2024,1,442618,428270,14348,3.2
MT1617660000000,16,17660,"Coeur d'Alene, ID MSA",2024,1,89157,85492,3665,4.1
MT1626820000000,16,26820,"Idaho Falls, ID MSA",2024,1,83958,81570,2388,2.8
MT1630300000000,16,30300,"Lewiston, ID-WA MSA",2024,1,31072,30064,1008,3.2
MT1638540000000,16,38540,"Pocatello, ID MSA",2024,1,40710,39238,1472,3.6
MT1646300000000,16,46300,"Twin Falls, ID MSA",2024,1,59293,57371,1922,3.2
MT1714010000000,17,14010,"Bloomington, IL MSA",2024,1,96894,93304,3590,3.7
MT1716580000000,17,16580,"Champaign-Urbana, IL MSA",2024,1,124538,119159,5379,4.3
MT1716980000000,17,16980,"Chicago-Naperville-Elgin, IL-IN MSA",2024,1,4956328,4718975,237353,4.8
MT1719340000000,17,19340,"Davenport-Moline-Rock Island, IA-IL MSA",2024,1,190095,182283,7812,4.1
MT1719500000000,17,19500,"Decatur, IL MSA",2024,1,44814,42140,2674,6
MT1728100000000,17,28100,"Kankakee, IL MSA",2024,1,51215,48172,3043,5.9
MT1737900000000,17,37900,"Peoria, IL MSA",2024,1,177382,168751,8631,4.9
MT1740420000000,17,40420,"Rockford, IL MSA",2024,1,160776,151116,9660,6
MT1744100000000,17,44100,"Springfield, IL MSA",2024,1,104113,99738,4375,4.2
MT1814020000000,18,14020,"Bloomington, IN MSA",2024,1,84596,81655,2941,3.5
MT1818020000000,18,18020,"Columbus, IN MSA",2024,1,39637,38209,1428,3.6
MT1821140000000,18,21140,"Elkhart-Goshen, IN MSA",2024,1,98359,93886,4473,4.5
MT1821780000000,18,21780,"Evansville, IN MSA",2024,1,134654,129931,4723,3.5
MT1823060000000,18,23060,"Fort Wayne, IN MSA",2024,1,230464,222714,7750,3.4
MT1826900000000,18,26900,"Indianapolis-Carmel-Greenwood, IN MSA",2024,1,1129305,1090425,38880,3.4
MT1829020000000,18,29020,"Kokomo, IN MSA",2024,1,35416,33653,1763,5
MT1829200000000,18,29200,"Lafayette-West Lafayette, IN MSA",2024,1,119865,115987,3878,3.2
MT1833140000000,18,33140,"Michigan City-La Porte, IN MSA",2024,1,51615,49472,2143,4.2
MT1834620000000,18,34620,"Muncie, IN MSA",2024,1,52062,49817,2245,4.3
MT1843780000000,18,43780,"South Bend-Mishawaka, IN-MI MSA",2024,1,152998,146300,6698,4.4
MT1845460000000,18,45460,"Terre Haute, IN MSA",2024,1,76697,73701,2996,3.9
MT1911180000000,19,11180,"Ames, IA MSA",2024,1,69530,67939,1591,2.3
MT1916300000000,19,16300,"Cedar Rapids, IA MSA",2024,1,146692,142169,4523,3.1
MT1919780000000,19,19780,"Des Moines-West Des Moines, IA MSA",2024,1,412040,401177,10863,2.6
MT1920220000000,19,20220,"Dubuque, IA MSA",2024,1,53518,52022,1496,2.8
MT1926980000000,19,26980,"Iowa City, IA MSA",2024,1,99503,97246,2257,2.3
MT1943580000000,19,43580,"Sioux City, IA-NE-SD MSA",2024,1,76648,74555,2093,2.7
MT1947940000000,19,47940,"Waterloo-Cedar Falls, IA MSA",2024,1,88094,85602,2492,2.8
MT2029940000000,20,29940,"Lawrence, KS MSA",2024,1,70554,68562,1992,2.8
MT2031740000000,20,31740,"Manhattan, KS MSA",2024,1,63674,61798,1876,2.9
MT2045820000000,20,45820,"Topeka, KS MSA",2024,1,117989,114296,3693,3.1
MT2048620000000,20,48620,"Wichita, KS MSA",2024,1,333796,322740,11056,3.3
MT2114540000000,21,14540,"Bowling Green, KY MSA",2024,1,91552,87508,4044,4.4
MT2121060000000,21,21060,"Elizabethtown, KY MSA",2024,1,55626,53092,2534,4.6
MT2130460000000,21,30460,"Lexington-Fayette, KY MSA",2024,1,275437,264652,10785,3.9
MT2131140000000,21,31140,"Louisville/Jefferson County, KY-IN MSA",2024,1,693625,665355,28270,4.1
MT2136980000000,21,36980,"Owensboro, KY MSA",2024,1,51469,49074,2395,4.7
MT2137140000000,21,37140,"Paducah, KY-IL MSA",2024,1,45911,43767,2144,4.7
MT2210780000000,22,10780,"Alexandria, LA MSA",2024,1,64423,61769,2654,4.1
MT2212940000000,22,12940,"Baton Rouge, LA MSA",2024,1,428274,411100,17174,4
MT2225220000000,22,25220,"Hammond, LA MSA",2024,1,60703,57868,2835,4.7
MT2226380000000,22,26380,"Houma-Bayou Cane-Thibodaux, LA MSA",2024,1,88356,85095,3261,3.7
MT2229180000000,22,29180,"Lafayette, LA MSA",2024,1,198100,190763,7337,3.7
MT2229340000000,22,29340,"Lake Charles, LA MSA",2024,1,98308,94012,4296,4.4
MT2233740000000,22,33740,"Monroe, LA MSA",2024,1,96099,91508,4591,4.8
MT2235380000000,22,35380,"New Orleans-Metairie, LA MSA",2024,1,467664,447448,20216,4.3
MT2243340000000,22,43340,"Shreveport-Bossier City, LA MSA",2024,1,168479,161095,7384,4.4
MT2243640000000,22,43640,"Slidell-Mandeville-Covington, LA MSA",2024,1,129400,124496,4904,3.8
MT2312620000000,23,12620,"Bangor, ME MSA",2024,1,75128,72837,2291,3
MT2330340000000,23,30340,"Lewiston-Auburn, ME MSA",2024,1,55210,53638,1572,2.8
MT2338860000000,23,38860,"Portland-South Portland, ME MSA",2024,1,311685,304430,7255,2.3
MT2412580000000,24,12580,"Baltimore-Columbia-Towson, MD MSA",2024,1,1494262,1452623,41639,2.8
MT2425180000000,24,25180,"Hagerstown-Martinsburg, MD-WV MSA",2024,1,143601,138995,4606,3.2
MT2430500000000,24,30500,"Lexington Park, MD MSA",2024,1,108649,105978,2671,2.5
MT2441540000000,24,41540,"Salisbury, MD MSA",2024,1,64364,62421,1943,3
MT2511200000000,25,11200,"Amherst Town-Northampton, MA MSA",2024,1,85045,82093,2952,3.5
MT2512700000000,25,12700,"Barnstable Town, MA MSA",2024,1,115518,110217,5301,4.6
MT2514460000000,25,14460,"Boston-Cambridge-Newton, MA-NH MSA",2024,1,2809892,2714220,95672,3.4
MT2538340000000,25,38340,"Pittsfield, MA MSA",2024,1,64278,61869,2409,3.7
MT2544140000000,25,44140,"Springfield, MA MSA",2024,1,223189,212474,10715,4.8
MT2549340000000,25,49340,"Worcester, MA MSA",2024,1,463097,445334,17763,3.8
MT2611460000000,26,11460,"Ann Arbor, MI MSA",2024,1,206596,199865,6731,3.3
MT2612980000000,26,12980,"Battle Creek, MI MSA",2024,1,62793,60004,2789,4.4
MT2613020000000,26,13020,"Bay City, MI MSA",2024,1,50169,47719,2450,4.9
MT2619820000000,26,19820,"Detroit-Warren-Dearborn, MI MSA",2024,1,2183409,2100849,82560,3.8
MT2622420000000,26,22420,"Flint, MI MSA",2024,1,187264,177949,9315,5
MT2624340000000,26,24340,"Grand Rapids-Wyoming-Kentwood, MI MSA",2024,1,627619,606672,20947,3.3
MT2627100000000,26,27100,"Jackson, MI MSA",2024,1,74819,71700,3119,4.2
MT2628020000000,26,28020,"Kalamazoo-Portage, MI MSA",2024,1,139706,134697,5009,3.6
MT2629620000000,26,29620,"Lansing-East Lansing, MI MSA",2024,1,252903,243173,9730,3.8
MT2633220000000,26,33220,"Midland, MI MSA",2024,1,42663,41066,1597,3.7
MT2633780000000,26,33780,"Monroe, MI MSA",2024,1,78854,75468,3386,4.3
MT2634740000000,26,34740,"Muskegon-Norton Shores, MI MSA",2024,1,84400,80739,3661,4.3
MT2635660000000,26,35660,"Niles, MI MSA",2024,1,76479,73253,3226,4.2
MT2640980000000,26,40980,"Saginaw, MI MSA",2024,1,84845,80469,4376,5.2
MT2645900000000,26,45900,"Traverse City, MI MSA",2024,1,81118,78134,2984,3.7
MT2720260000000,27,20260,"Duluth, MN-WI MSA",2024,1,139883,135210,4673,3.3
MT2731860000000,27,31860,"Mankato, MN MSA",2024,1,60149,58699,1450,2.4
MT2733460000000,27,33460,"Minneapolis-St. Paul-Bloomington, MN-WI MSA",2024,1,2062438,2006775,55663,2.7
MT2740340000000,27,40340,"Rochester, MN MSA",2024,1,125979,123116,2863,2.3
MT2741060000000,27,41060,"St. Cloud, MN MSA",2024,1,109645,106523,3122,2.8
MT2825060000000,28,25060,"Gulfport-Biloxi, MS MSA",2024,1,185086,180337,4749,2.6
MT2825620000000,28,25620,"Hattiesburg, MS MSA",2024,1,69826,68035,1791,2.6
MT2827140000000,28,27140,"Jackson, MS MSA",2024,1,277414,270458,6956,2.5
MT2916020000000,29,16020,"Cape Girardeau, MO-IL MSA",2024,1,49141,47570,1571,3.2
MT2917860000000,29,17860,"Columbia, MO MSA",2024,1,112671,109362,3309,2.9
MT2927620000000,29,27620,"Jefferson City, MO MSA",2024,1,75843,73598,2245,3
MT2927900000000,29,27900,"Joplin, MO-KS MSA",2024,1,97646,94296,3350,3.4
MT2928140000000,29,28140,"Kansas City, MO-KS MSA",2024,1,1191509,1151452,40057,3.4
MT2941140000000,29,41140,"St. Joseph, MO-KS MSA",2024,1,53988,52127,1861,3.4
MT2941180000000,29,41180,"St. Louis, MO-IL MSA",2024,1,1479898,1426739,53159,3.6
MT2944180000000,29,44180,"Springfield, MO MSA",2024,1,241473,233933,7540,3.1
MT3013740000000,30,13740,"Billings, MT MSA",2024,1,99130,96352,2778,2.8
MT3014580000000,30,14580,"Bozeman, MT MSA",2024,1,77402,75655,1747,2.3
MT3024500000000,30,24500,"Great Falls, MT MSA",2024,1,39985,38773,1212,3
MT3025740000000,30,25740,"Helena, MT MSA",2024,1,47453,46108,1345,2.8
MT3033540000000,30,33540,"Missoula, MT MSA",2024,1,73964,71776,2188,3
MT3124260000000,31,24260,"Grand Island, NE MSA",2024,1,42751,41677,1074,2.5
MT3130700000000,31,30700,"Lincoln, NE MSA",2024,1,192260,187848,4412,2.3
MT3136540000000,31,36540,"Omaha, NE-IA MSA",2024,1,524233,509952,14281,2.7
MT3216180000000,32,16180,"Carson City, NV MSA",2024,1,28801,27590,1211,4.2
MT3229820000000,32,29820,"Las Vegas-Henderson-North Las Vegas, NV MSA",2024,1,1206982,1141003,65979,5.5
MT3239900000000,32,39900,"Reno, NV MSA",2024,1,296830,283758,13072,4.4
MT3331700000000,33,31700,"Manchester-Nashua, NH MSA",2024,1,239841,233832,6009,2.5
MT3412100000000,34,12100,"Atlantic City-Hammonton, NJ MSA",2024,1,179842,169077,10765,6
MT3445940000000,34,45940,"Trenton-Princeton, NJ MSA",2024,1,199181,190726,8455,4.2
MT3447220000000,34,47220,"Vineland, NJ MSA",2024,1,65370,60892,4478,6.9
MT3510740000000,35,10740,"Albuquerque, NM MSA",2024,1,460079,443938,16141,3.5
MT3522140000000,35,22140,"Farmington, NM MSA",2024,1,49606,47496,2110,4.3
MT3529740000000,35,29740,"Las Cruces, NM MSA",2024,1,101776,97260,4516,4.4
MT3542140000000,35,42140,"Santa Fe, NM MSA",2024,1,73776,71332,2444,3.3
MT3610580000000,36,10580,"Albany-Schenectady-Troy, NY MSA",2024,1,458077,442457,15620,3.4
MT3613780000000,36,13780,"Binghamton, NY MSA",2024,1,107352,103205,4147,3.9
MT3615380000000,36,15380,"Buffalo-Cheektowaga, NY MSA",2024,1,560263,538086,22177,4
MT3621300000000,36,21300,"Elmira, NY MSA",2024,1,35698,34346,1352,3.8
MT3624020000000,36,24020,"Glens Falls, NY MSA",2024,1,59609,57457,2152,3.6
MT3627060000000,36,27060,"Ithaca, NY MSA",2024,1,48321,46697,1624,3.4
MT3628740000000,36,28740,"Kingston, NY MSA",2024,1,87751,84530,3221,3.7
MT3628880000000,36,28880,"Kiryas Joel-Poughkeepsie-Newburgh, NY MSA",2024,1,341277,329100,12177,3.6
MT3635620000000,36,35620,"New York-Newark-Jersey City, NY-NJ MSA",2024,1,10163224,9727296,435928,4.3
MT3640380000000,36,40380,"Rochester, NY MSA",2024,1,514562,495223,19339,3.8
MT3645060000000,36,45060,"Syracuse, NY MSA",2024,1,310634,299116,11518,3.7
MT3646540000000,36,46540,"Utica-Rome, NY MSA",2024,1,128071,123201,4870,3.8
MT3648060000000,36,48060,"Watertown-Fort Drum, NY MSA",2024,1,44937,42904,2033,4.5
MT3711700000000,37,11700,"Asheville, NC MSA",2024,1,211866,205820,6046,2.9
MT3715500000000,37,15500,"Burlington, NC MSA",2024,1,86040,83030,3010,3.5
MT3716740000000,37,16740,"Charlotte-Concord-Gastonia, NC-SC MSA",2024,1,1476312,1424786,51526,3.5
MT3720500000000,37,20500,"Durham-Chapel Hill, NC MSA",2024,1,322089,311836,10253,3.2
MT3722180000000,37,22180,"Fayetteville, NC MSA",2024,1,155705,148829,6876,4.4
MT3724140000000,37,24140,"Goldsboro, NC MSA",2024,1,50523,48673,1850,3.7
MT3724660000000,37,24660,"Greensboro-High Point, NC MSA",2024,1,374015,359408,14607,3.9
MT3724780000000,37,24780,"Greenville, NC MSA",2024,1,84197,80707,3490,4.1
MT3725860000000,37,25860,"Hickory-Lenoir-Morganton, NC MSA",2024,1,171390,165610,5780,3.4
MT3727340000000,37,27340,"Jacksonville, NC MSA",2024,1,74456,71693,2763,3.7
MT3738240000000,37,38240,"Pinehurst-Southern Pines, NC MSA",2024,1,44763,43229,1534,3.4
MT3739580000000,37,39580,"Raleigh-Cary, NC MSA",2024,1,843219,816737,26482,3.1
MT3740580000000,37,40580,"Rocky Mount, NC MSA",2024,1,63585,60574,3011,4.7
MT3748900000000,37,48900,"Wilmington, NC MSA",2024,1,222465,214593,7872,3.5
MT3749180000000,37,49180,"Winston-Salem, NC MSA",2024,1,324384,312876,11508,3.5
MT3813900000000,38,13900,"Bismarck, ND MSA",2024,1,72587,71096,1491,2.1
MT3822020000000,38,22020,"Fargo, ND-MN MSA",2024,1,153207,150060,3147,2.1
MT3824220000000,38,24220,"Grand Forks, ND-MN MSA",2024,1,56017,54803,1214,2.2
MT3833500000000,38,33500,"Minot, ND MSA",2024,1,40255,39361,894,2.2
MT3910420000000,39,10420,"Akron, OH MSA",2024,1,359349,345011,14338,4
MT3915940000000,39,15940,"Canton-Massillon, OH MSA",2024,1,193758,185782,7976,4.1
MT3917140000000,39,17140,"Cincinnati, OH-KY-IN MSA",2024,1,1166106,1121491,44615,3.8
MT3917410000000,39,17410,"Cleveland, OH MSA",2024,1,1091425,1050619,40806,3.7
MT3918140000000,39,18140,"Columbus, OH MSA",2024,1,1147038,1105935,41103,3.6
MT3919430000000,39,19430,"Dayton-Kettering-Beavercreek, OH MSA",2024,1,393046,377692,15354,3.9
MT3930620000000,39,30620,"Lima, OH MSA",2024,1,47345,45508,1837,3.9
MT3931900000000,39,31900,"Mansfield, OH MSA",2024,1,53244,50835,2409,4.5
MT3941780000000,39,41780,"Sandusky, OH MSA",2024,1,56852,54190,2662,4.7
MT3944220000000,39,44220,"Springfield, OH MSA",2024,1,62117,59588,2529,4.1
MT3945780000000,39,45780,"Toledo, OH MSA",2024,1,295768,282403,13365,4.5
MT3948260000000,39,48260,"Weirton-Steubenville, WV-OH MSA",2024,1,51948,49180,2768,5.3
MT3949660000000,39,49660,"Youngstown-Warren, OH MSA",2024,1,192636,183657,8979,4.7
MT4021420000000,40,21420,"Enid, OK MSA",2024,1,28392,27419,973,3.4
MT4030020000000,40,30020,"Lawton, OK MSA",2024,1,52463,50482,1981,3.8
MT4036420000000,40,36420,"Oklahoma City, OK MSA",2024,1,772041,747773,24268,3.1
MT4046140000000,40,46140,"Tulsa, OK MSA",2024,1,523904,506037,17867,3.4
MT4110540000000,41,10540,"Albany, OR MSA",2024,1,61440,58664,2776,4.5
MT4113460000000,41,13460,"Bend, OR MSA",2024,1,132740,127222,5518,4.2
MT4118700000000,41,18700,"Corvallis, OR MSA",2024,1,49537,47748,1789,3.6
MT4121660000000,41,21660,"Eugene-Springfield, OR MSA",2024,1,187692,179724,7968,4.2
MT4124420000000,41,24420,"Grants Pass, OR MSA",2024,1,35134,33184,1950,5.6
MT4132780000000,41,32780,"Medford, OR MSA",2024,1,106224,101079,5145,4.8
MT4138900000000,41,38900,"Portland-Vancouver-Hillsboro, OR-WA MSA",2024,1,1381161,1326635,54526,3.9
MT4141420000000,41,41420,"Salem, OR MSA",2024,1,220380,211441,8939,4.1
MT4210900000000,42,10900,"Allentown-Bethlehem-Easton, PA-NJ MSA",2024,1,453476,435278,18198,4
MT4211020000000,42,11020,"Altoona, PA MSA",2024,1,57726,55727,1999,3.5
MT4216540000000,42,16540,"Chambersburg, PA MSA",2024,1,76555,74201,2354,3.1
MT4221500000000,42,21500,"Erie, PA MSA",2024,1,127482,122638,4844,3.8
MT4223900000000,42,23900,"Gettysburg, PA MSA",2024,1,52245,50660,1585,3
MT4225420000000,42,25420,"Harrisburg-Carlisle, PA MSA",2024,1,315734,305583,10151,3.2
MT4227780000000,42,27780,"Johnstown, PA MSA",2024,1,57375,54980,2395,4.2
MT4229540000000,42,29540,"Lancaster, PA MSA",2024,1,294216,285732,8484,2.9
MT4230140000000,42,30140,"Lebanon, PA MSA",2024,1,73794,71489,2305,3.1
MT4237980000000,42,37980,"Philadelphia-Camden-Wilmington, PA-NJ-DE-MD MSA",2024,1,3309385,3184202,125183,3.8
MT4238300000000,42,38300,"Pittsburgh, PA MSA",2024,1,1245878,1201973,43905,3.5
MT4239740000000,42,39740,"Reading, PA MSA",2024,1,220313,212035,8278,3.8
MT4242540000000,42,42540,"Scranton--Wilkes-Barre, PA MSA",2024,1,281916,269850,12066,4.3
MT4244300000000,42,44300,"State College, PA MSA",2024,1,77637,75425,2212,2.8
MT4248700000000,42,48700,"Williamsport, PA MSA",2024,1,53425,51368,2057,3.9
MT4249620000000,42,49620,"York-Hanover, PA MSA",2024,1,242307,234357,7950,3.3
MT4439300000000,44,39300,"Providence-Warwick, RI-MA MSA",2024,1,895694,859270,36424,4.1
MT4516700000000,45,16700,"Charleston-North Charleston, SC MSA",2024,1,439457,426507,12950,2.9
MT4517900000000,45,17900,"Columbia, SC MSA",2024,1,415275,401112,14163,3.4
MT4522500000000,45,22500,"Florence, SC MSA",2024,1,91736,88231,3505,3.8
MT4524860000000,45,24860,"Greenville-Anderson-Greer, SC MSA",2024,1,476479,461280,15199,3.2
MT4525940000000,45,25940,"Hilton Head Island-Bluffton-Port Royal, SC MSA",2024,1,97054,93937,3117,3.2
MT4534820000000,45,34820,"Myrtle Beach-Conway-North Myrtle Beach, SC MSA",2024,1,169742,162833,6909,4.1
MT4543900000000,45,43900,"Spartanburg, SC MSA",2024,1,175213,169013,6200,3.5
MT4544940000000,45,44940,"Sumter, SC MSA",2024,1,41473,39673,1800,4.3
MT4639660000000,46,39660,"Rapid City, SD MSA",2024,1,78881,77521,1360,1.7
MT4643620000000,46,43620,"Sioux Falls, SD-MN MSA",2024,1,172886,170092,2794,1.6
MT4716860000000,47,16860,"Chattanooga, TN-GA MSA",2024,1,288789,280383,8406,2.9
MT4717300000000,47,17300,"Clarksville, TN-KY MSA",2024,1,137119,131830,5289,3.9
MT4717420000000,47,17420,"Cleveland, TN MSA",2024,1,56391,54502,1889,3.3
MT4727180000000,47,27180,"Jackson, TN MSA",2024,1,78273,75585,2688,3.4
MT4727740000000,47,27740,"Johnson City, TN MSA",2024,1,96365,93343,3022,3.1
MT4728700000000,47,28700,"Kingsport-Bristol, TN-VA MSA",2024,1,132445,128104,4341,3.3
MT4728940000000,47,28940,"Knoxville, TN MSA",2024,1,448382,435289,13093,2.9
MT4732820000000,47,32820,"Memphis, TN-MS-AR MSA",2024,1,624171,600779,23392,3.7
MT4734100000000,47,34100,"Morristown, TN MSA",2024,1,52942,51232,1710,3.2
MT4734980000000,47,34980,"Nashville-Davidson--Murfreesboro--Franklin, TN MSA",2024,1,1151499,1121625,29874,2.6
MT4810180000000,48,10180,"Abilene, TX MSA",2024,1,85671,82809,2862,3.3
MT4811100000000,48,11100,"Amarillo, TX MSA",2024,1,136195,132069,4126,3
MT4812420000000,48,12420,"Austin-Round Rock-San Marcos, TX MSA",2024,1,1480630,1429979,50651,3.4
MT4813140000000,48,13140,"Beaumont-Port Arthur, TX MSA",2024,1,178246,169211,9035,5.1
MT4815180000000,48,15180,"Brownsville-Harlingen, TX MSA",2024,1,187218,177885,9333,5
MT4817780000000,48,17780,"College Station-Bryan, TX MSA",2024,1,148813,143817,4996,3.4
MT4818580000000,48,18580,"Corpus Christi, TX MSA",2024,1,208481,199810,8671,4.2
MT4819100000000,48,19100,"Dallas-Fort Worth-Arlington, TX MSA",2024,1,4433165,4265878,167287,3.8
MT4820580000000,48,20580,"Eagle Pass, TX MSA",2024,1,23599,21858,1741,7.4
MT4821340000000,48,21340,"El Paso, TX MSA",2024,1,407802,391088,16714,4.1
MT4826420000000,48,26420,"Houston-Pasadena-The Woodlands, TX MSA",2024,1,3785172,3628693,156479,4.1
MT4828660000000,48,28660,"Killeen-Temple, TX MSA",2024,1,200700,192447,8253,4.1
MT4829700000000,48,29700,"Laredo, TX MSA",2024,1,116850,112063,4787,4.1
MT4830980000000,48,30980,"Longview, TX MSA",2024,1,128744,122928,5816,4.5
MT4831180000000,48,31180,"Lubbock, TX MSA",2024,1,182939,176867,6072,3.3
MT4832580000000,48,32580,"McAllen-Edinburg-Mission, TX MSA",2024,1,391027,368720,22307,5.7
MT4833260000000,48,33260,"Midland, TX MSA",2024,1,102164,99363,2801,2.7
MT4836220000000,48,36220,"Odessa, TX MSA",2024,1,85008,82183,2825,3.3
MT4841660000000,48,41660,"San Angelo, TX MSA",2024,1,61417,59512,1905,3.1
MT4841700000000,48,41700,"San Antonio-New Braunfels, TX MSA",2024,1,1318575,1270987,47588,3.6
MT4843300000000,48,43300,"Sherman-Denison, TX MSA",2024,1,70800,68211,2589,3.7
MT4845500000000,48,45500,"Texarkana, TX-AR MSA",2024,1,61217,58783,2434,4
MT4846340000000,48,46340,"Tyler, TX MSA",2024,1,116649,112385,4264,3.7
MT4847020000000,48,47020,"Victoria, TX MSA",2024,1,44723,42971,1752,3.9
MT4847380000000,48,47380,"Waco, TX MSA",2024,1,144804,139514,5290,3.7
MT4848660000000,48,48660,"Wichita Falls, TX MSA",2024,1,66629,64205,2424,3.6
MT4930860000000,49,30860,"Logan, UT-ID MSA",2024,1,79106,77076,2030,2.6
MT4936260000000,49,36260,"Ogden, UT MSA",2024,1,349646,340062,9584,2.7
MT4939340000000,49,39340,"Provo-Orem-Lehi, UT MSA",2024,1,367513,356717,10796,2.9
MT4941100000000,49,41100,"St. George, UT MSA",2024,1,92286,89440,2846,3.1
MT4941620000000,49,41620,"Salt Lake City-Murray, UT MSA",2024,1,733354,711530,21824,3
MT5015540000000,50,15540,"Burlington-South Burlington, VT MSA",2024,1,130660,128409,2251,1.7
MT5113980000000,51,13980,"Blacksburg-Christiansburg-Radford, VA MSA",2024,1,94062,91426,2636,2.8
MT5116820000000,51,16820,"Charlottesville, VA MSA",2024,1,120394,117456,2938,2.4
MT5125500000000,51,25500,"Harrisonburg, VA MSA",2024,1,72770,70830,1940,2.7
MT5131340000000,51,31340,"Lynchburg, VA MSA",2024,1,128346,124323,4023,3.1
MT5140060000000,51,40060,"Richmond, VA MSA",2024,1,724928,704035,20893,2.9
MT5140220000000,51,40220,"Roanoke, VA MSA",2024,1,158398,153959,4439,2.8
MT5144420000000,51,44420,"Staunton-Stuarts Draft, VA MSA",2024,1,65684,64109,1575,2.4
MT5147260000000,51,47260,"Virginia Beach-Chesapeake-Norfolk, VA-NC MSA",2024,1,883503,857351,26152,3
MT5149020000000,51,49020,"Winchester, VA-WV MSA",2024,1,77496,75465,2031,2.6
MT5313380000000,53,13380,"Bellingham, WA MSA",2024,1,114271,109104,5167,4.5
MT5314740000000,53,14740,"Bremerton-Silverdale-Port Orchard, WA MSA",2024,1,122323,116676,5647,4.6
MT5328420000000,53,28420,"Kennewick-Richland, WA MSA",2024,1,145602,138374,7228,5
MT5331020000000,53,31020,"Longview-Kelso, WA MSA",2024,1,47143,44653,2490,5.3
MT5334580000000,53,34580,"Mount Vernon-Anacortes, WA MSA",2024,1,59146,56209,2937,5
MT5336500000000,53,36500,"Olympia-Lacey-Tumwater, WA MSA",2024,1,143146,136551,6595,4.6
MT5342660000000,53,42660,"Seattle-Tacoma-Bellevue, WA MSA",2024,1,2314262,2212903,101359,4.4
MT5344060000000,53,44060,"Spokane-Spokane Valley, WA MSA",2024,1,282115,269354,12761,4.5
MT5347460000000,53,47460,"Walla Walla, WA MSA",2024,1,29259,28002,1257,4.3
MT5348300000000,53,48300,"Wenatchee-East Wenatchee, WA MSA",2024,1,62205,59251,2954,4.7
MT5349420000000,53,49420,"Yakima, WA MSA",2024,1,126134,118717,7417,5.9
MT5413220000000,54,13220,"Beckley, WV MSA",2024,1,46247,44468,1779,3.8
MT5416620000000,54,16620,"Charleston, WV MSA",2024,1,91310,87741,3569,3.9
MT5426580000000,54,26580,"Huntington-Ashland, WV-KY-OH MSA",2024,1,156697,149149,7548,4.8
MT5434060000000,54,34060,"Morgantown, WV MSA",2024,1,71196,68708,2488,3.5
MT5437620000000,54,37620,"Parkersburg-Vienna, WV MSA",2024,1,39572,37845,1727,4.4
MT5448540000000,54,48540,"Wheeling, WV-OH MSA",2024,1,59432,56741,2691,4.5
MT5511540000000,55,11540,"Appleton, WI MSA",2024,1,137084,133902,3182,2.3
MT5520740000000,55,20740,"Eau Claire, WI MSA",2024,1,96074,93430,2644,2.8
MT5522540000000,55,22540,"Fond du Lac, WI MSA",2024,1,55759,54369,1390,2.5
MT5524580000000,55,24580,"Green Bay, WI MSA",2024,1,178481,173940,4541,2.5
MT5527500000000,55,27500,"Janesville-Beloit, WI MSA",2024,1,86836,84123,2713,3.1
MT5528450000000,55,28450,"Kenosha, WI MSA",2024,1,95841,92837,3004,3.1
MT5529100000000,55,29100,"La Crosse-Onalaska, WI-MN MSA",2024,1,90348,88146,2202,2.4
MT5531540000000,55,31540,"Madison, WI MSA",2024,1,409652,400879,8773,2.1
MT5533340000000,55,33340,"Milwaukee-Waukesha, WI MSA",2024,1,820242,794743,25499,3.1
MT5536780000000,55,36780,"Oshkosh-Neenah, WI MSA",2024,1,93399,91047,2352,2.5
MT5539540000000,55,39540,"Racine-Mount Pleasant, WI MSA",2024,1,101919,98597,3322,3.3
MT5543100000000,55,43100,"Sheboygan, WI MSA",2024,1,63427,61966,1461,2.3
MT5548140000000,55,48140,"Wausau, WI MSA",2024,1,75275,73367,1908,2.5
MT5616220000000,56,16220,"Casper, WY MSA",2024,1,42030,40821,1209,2.9
MT5616940000000,56,16940,"Cheyenne, WY MSA",2024,1,48885,47428,1457,3
MT7210380000000,72,10380,"Aguadilla, PR MSA",2024,1,89911,83656,6255,7
MT7211640000000,72,11640,"Arecibo, PR MSA",2024,1,67225,63412,3813,5.7
MT7225020000000,72,25020,"Guayama, PR MSA",2024,1,19247,17439,1808,9.4
MT7232420000000,72,32420,"Mayaguez, PR MSA",2024,1,67196,62525,4671,7
MT7238660000000,72,38660,"Ponce, PR MSA",2024,1,89769,81771,7998,8.9
MT7241980000000,72,41980,"San Juan-Bayamon-Caguas, PR MSA",2024,1,817118,777242,39876,4.9
MT0111500000000,1,11500,"Anniston-Oxford, AL MSA",2024,2,49174,47713,1461,3
MT0112220000000,1,12220,"Auburn-Opelika, AL MSA",2024,2,96363,93797,2566,2.7
MT0113820000000,1,13820,"Birmingham, AL MSA",2024,2,569254,554175,15079,2.6
MT0119300000000,1,19300,"Daphne-Fairhope-Foley, AL MSA",2024,2,115666,112811,2855,2.5
MT0119460000000,1,19460,"Decatur, AL MSA",2024,2,75201,73470,1731,2.3
MT0120020000000,1,20020,"Dothan, AL MSA",2024,2,67498,65572,1926,2.9
MT0122520000000,1,22520,"Florence-Muscle Shoals, AL MSA",2024,2,68398,66384,2014,2.9
MT0123460000000,1,23460,"Gadsden, AL MSA",2024,2,41791,40561,1230,2.9
MT0126620000000,1,26620,"Huntsville, AL MSA",2024,2,273719,267305,6414,2.3
MT0133660000000,1,33660,"Mobile, AL MSA",2024,2,184824,177816,7008,3.8
MT0133860000000,1,33860,"Montgomery, AL MSA",2024,2,177526,172366,5160,2.9
MT0146220000000,1,46220,"Tuscaloosa, AL MSA",2024,2,126075,122356,3719,2.9
MT0211260000000,2,11260,"Anchorage, AK MSA",2024,2,200080,192162,7918,4
MT0221820000000,2,21820,"Fairbanks-College, AK MSA",2024,2,45427,43729,1698,3.7
MT0422380000000,4,22380,"Flagstaff, AZ MSA",2024,2,75496,72822,2674,3.5
MT0429420000000,4,29420,"Lake Havasu City-Kingman, AZ MSA",2024,2,87436,83884,3552,4.1
MT0438060000000,4,38060,"Phoenix-Mesa-Chandler, AZ MSA",2024,2,2693016,2614246,78770,2.9
MT0439150000000,4,39150,"Prescott Valley-Prescott, AZ MSA",2024,2,106395,102955,3440,3.2
MT0443420000000,4,43420,"Sierra Vista-Douglas, AZ MSA",2024,2,48187,46227,1960,4.1
MT0446060000000,4,46060,"Tucson, AZ MSA",2024,2,491873,475651,16222,3.3
MT0449740000000,4,49740,"Yuma, AZ MSA",2024,2,98386,86739,11647,11.8
MT0522220000000,5,22220,"Fayetteville-Springdale-Rogers, AR MSA",2024,2,303114,295266,7848,2.6
MT0522900000000,5,22900,"Fort Smith, AR-OK MSA",2024,2,101310,97753,3557,3.5
MT0526300000000,5,26300,"Hot Springs, AR MSA",2024,2,43818,42270,1548,3.5
MT0527860000000,5,27860,"Jonesboro, AR MSA",2024,2,65794,63771,2023,3.1
MT0530780000000,5,30780,"Little Rock-North Little Rock-Conway, AR MSA",2024,2,377478,365443,12035,3.2
MT0612540000000,6,12540,"Bakersfield-Delano, CA MSA",2024,2,404820,370177,34643,8.6
MT0617020000000,6,17020,"Chico, CA MSA",2024,2,91183,86017,5166,5.7
MT0620940000000,6,20940,"El Centro, CA MSA",2024,2,72483,59289,13194,18.2
MT0623420000000,6,23420,"Fresno, CA MSA",2024,2,534354,492901,41453,7.8
MT0625260000000,6,25260,"Hanford-Corcoran, CA MSA",2024,2,57875,52818,5057,8.7
MT0631080000000,6,31080,"Los Angeles-Long Beach-Anaheim, CA MSA",2024,2,6699555,6368004,331551,4.9
MT0632900000000,6,32900,"Merced, CA MSA",2024,2,119328,107871,11457,9.6
MT0633700000000,6,33700,"Modesto, CA MSA",2024,2,250622,233849,16773,6.7
MT0634900000000,6,34900,"Napa, CA MSA",2024,2,73380,70655,2725,3.7
MT0637100000000,6,37100,"Oxnard-Thousand Oaks-Ventura, CA MSA",2024,2,419328,400602,18726,4.5
MT0639820000000,6,39820,"Redding, CA MSA",2024,2,78594,74563,4031,5.1
MT0640140000000,6,40140,"Riverside-San Bernardino-Ontario, CA MSA",2024,2,2196311,2085558,110753,5
MT0640900000000,6,40900,"Sacramento-Roseville-Folsom, CA MSA",2024,2,1174639,1121995,52644,4.5
MT0641500000000,6,41500,"Salinas, CA MSA",2024,2,219633,203559,16074,7.3
MT0641740000000,6,41740,"San Diego-Chula Vista-Carlsbad, CA MSA",2024,2,1644352,1576143,68209,4.1
MT0641860000000,6,41860,"San Francisco-Oakland-Fremont, CA MSA",2024,2,2504505,2403100,101405,4
MT0641940000000,6,41940,"San Jose-Sunnyvale-Santa Clara, CA MSA",2024,2,1055693,1012656,43037,4.1
MT0642020000000,6,42020,"San Luis Obispo-Paso Robles, CA MSA",2024,2,132330,127169,5161,3.9
MT0642100000000,6,42100,"Santa Cruz-Watsonville, CA MSA",2024,2,135712,127860,7852,5.8
MT0642200000000,6,42200,"Santa Maria-Santa Barbara, CA MSA",2024,2,220593,211006,9587,4.3
MT0642220000000,6,42220,"Santa Rosa-Petaluma, CA MSA",2024,2,247174,237477,9697,3.9
MT0644700000000,6,44700,"Stockton-Lodi, CA MSA",2024,2,365554,342633,22921,6.3
MT0646700000000,6,46700,"Vallejo, CA MSA",2024,2,216464,206260,10204,4.7
MT0647300000000,6,47300,"Visalia, CA MSA",2024,2,220880,198125,22755,10.3
MT0649700000000,6,49700,"Yuba City, CA MSA",2024,2,80589,74470,6119,7.6
MT0814500000000,8,14500,"Boulder, CO MSA",2024,2,193728,186669,7059,3.6
MT0817820000000,8,17820,"Colorado Springs, CO MSA",2024,2,393322,378345,14977,3.8
MT0819740000000,8,19740,"Denver-Aurora-Centennial, CO MSA",2024,2,1767081,1700727,66354,3.8
MT0822660000000,8,22660,"Fort Collins-Loveland, CO MSA",2024,2,208864,201386,7478,3.6
MT0824300000000,8,24300,"Grand Junction, CO MSA",2024,2,79384,76264,3120,3.9
MT0824540000000,8,24540,"Greeley, CO MSA",2024,2,176091,169081,7010,4
MT0839380000000,8,39380,"Pueblo, CO MSA",2024,2,73498,69630,3868,5.3
MT0914860000000,9,14860,"Bridgeport-Stamford-Danbury, CT MSA",2024,2,513134,497246,15888,3.1
MT0925540000000,9,25540,"Hartford-West Hartford-East Hartford, CT MSA",2024,2,608344,588814,19530,3.2
MT0935300000000,9,35300,"New Haven, CT MSA",2024,2,314886,304764,10122,3.2
MT0935980000000,9,35980,"Norwich-New London-Willimantic, CT MSA",2024,2,141794,137332,4462,3.1
MT0947930000000,9,47930,"Waterbury-Shelton, CT MSA",2024,2,239037,230272,8765,3.7
MT1020100000000,10,20100,"Dover, DE MSA",2024,2,85199,81755,3444,4
MT1147900000000,11,47900,"Washington-Arlington-Alexandria, DC-VA-MD-WV MSA",2024,2,3541345,3441274,100071,2.8
MT1215980000000,12,15980,"Cape Coral-Fort Myers, FL MSA",2024,2,375854,363118,12736,3.4
MT1218880000000,12,18880,"Crestview-Fort Walton Beach-Destin, FL MSA",2024,2,142049,137917,4132,2.9
MT1219660000000,12,19660,"Deltona-Daytona Beach-Ormond Beach, FL MSA",2024,2,322648,310938,11710,3.6
MT1223540000000,12,23540,"Gainesville, FL MSA",2024,2,168989,162863,6126,3.6
MT1226140000000,12,26140,"Homosassa Springs, FL MSA",2024,2,53640,51105,2535,4.7
MT1227260000000,12,27260,"Jacksonville, FL MSA",2024,2,854809,826387,28422,3.3
MT1229460000000,12,29460,"Lakeland-Winter Haven, FL MSA",2024,2,357146,342719,14427,4
MT1233100000000,12,33100,"Miami-Fort Lauderdale-West Palm Beach, FL MSA",2024,2,3308340,3218866,89474,2.7
MT1234940000000,12,34940,"Naples-Marco Island, FL MSA",2024,2,184736,178688,6048,3.3
MT1235840000000,12,35840,"North Port-Bradenton-Sarasota, FL MSA",2024,2,397869,384528,13341,3.4
MT1236100000000,12,36100,"Ocala, FL MSA",2024,2,158344,152089,6255,4
MT1236740000000,12,36740,"Orlando-Kissimmee-Sanford, FL MSA",2024,2,1530062,1481812,48250,3.2
MT1237340000000,12,37340,"Palm Bay-Melbourne-Titusville, FL MSA",2024,2,304829,294760,10069,3.3
MT1237460000000,12,37460,"Panama City-Panama City Beach, FL MSA",2024,2,101235,97973,3262,3.2
MT1237860000000,12,37860,"Pensacola-Ferry Pass-Brent, FL MSA",2024,2,240568,232417,8151,3.4
MT1238940000000,12,38940,"Port St. Lucie, FL MSA",2024,2,238122,229305,8817,3.7
MT1239460000000,12,39460,"Punta Gorda, FL MSA",2024,2,77213,74256,2957,3.8
MT1242680000000,12,42680,"Sebastian-Vero Beach-West Vero Corridor, FL MSA",2024,2,67985,65289,2696,4
MT1242700000000,12,42700,"Sebring, FL MSA",2024,2,36388,34688,1700,4.7
MT1245220000000,12,45220,"Tallahassee, FL MSA",2024,2,207095,200256,6839,3.3
MT1245300000000,12,45300,"Tampa-St. Petersburg-Clearwater, FL MSA",2024,2,1702366,1646770,55596,3.3
MT1248680000000,12,48680,"Wildwood-The Villages, FL MSA",2024,2,33913,32008,1905,5.6
MT1310500000000,13,10500,"Albany, GA MSA",2024,2,62148,59700,2448,3.9
MT1312020000000,13,12020,"Athens-Clarke County, GA MSA",2024,2,108530,105145,3385,3.1
MT1312060000000,13,12060,"Atlanta-Sandy Springs-Roswell, GA MSA",2024,2,3298156,3190415,107741,3.3
MT1312260000000,13,12260,"Augusta-Richmond County, GA-SC MSA",2024,2,267342,256794,10548,3.9
MT1315260000000,13,15260,"Brunswick-St. Simons, GA MSA",2024,2,55361,53757,1604,2.9
MT1317980000000,13,17980,"Columbus, GA-AL MSA",2024,2,128700,123850,4850,3.8
MT1319140000000,13,19140,"Dalton, GA MSA",2024,2,67736,65390,2346,3.5
MT1323580000000,13,23580,"Gainesville, GA MSA",2024,2,109025,106151,2874,2.6
MT1325980000000,13,25980,"Hinesville, GA MSA",2024,2,31032,29839,1193,3.8
MT1331420000000,13,31420,"Macon-Bibb County, GA MSA",2024,2,97107,93314,3793,3.9
MT1340660000000,13,40660,"Rome, GA MSA",2024,2,47885,46343,1542,3.2
MT1342340000000,13,42340,"Savannah, GA MSA",2024,2,210392,204286,6106,2.9
MT1346660000000,13,46660,"Valdosta, GA MSA",2024,2,61440,59228,2212,3.6
MT1347580000000,13,47580,"Warner Robins, GA MSA",2024,2,89820,87138,2682,3
MT1527980000000,15,27980,"Kahului-Wailuku, HI MSA",2024,2,81893,77725,4168,5.1
MT1546520000000,15,46520,"Urban Honolulu, HI MSA",2024,2,468794,457112,11682,2.5
MT1614260000000,16,14260,"Boise City, ID MSA",2024,2,442901,428352,14549,3.3
MT1617660000000,16,17660,"Coeur d'Alene, ID MSA",2024,2,89158,85456,3702,4.2
MT1626820000000,16,26820,"Idaho Falls, ID MSA",2024,2,83999,81538,2461,2.9
MT1630300000000,16,30300,"Lewiston, ID-WA MSA",2024,2,31100,30084,1016,3.3
MT1638540000000,16,38540,"Pocatello, ID MSA",2024,2,40793,39297,1496,3.7
MT1646300000000,16,46300,"Twin Falls, ID MSA",2024,2,59265,57324,1941,3.3
MT1714010000000,17,14010,"Bloomington, IL MSA",2024,2,97116,93469,3647,3.8
MT1716580000000,17,16580,"Champaign-Urbana, IL MSA",2024,2,124638,119235,5403,4.3
MT1716980000000,17,16980,"Chicago-Naperville-Elgin, IL-IN MSA",2024,2,4966288,4724304,241984,4.9
MT1719340000000,17,19340,"Davenport-Moline-Rock Island, IA-IL MSA",2024,2,189745,181932,7813,4.1
MT1719500000000,17,19500,"Decatur, IL MSA",2024,2,44873,42216,2657,5.9
MT1728100000000,17,28100,"Kankakee, IL MSA",2024,2,51218,48187,3031,5.9
MT1737900000000,17,37900,"Peoria, IL MSA",2024,2,177429,168704,8725,4.9
MT1740420000000,17,40420,"Rockford, IL MSA",2024,2,160795,151294,9501,5.9
MT1744100000000,17,44100,"Springfield, IL MSA",2024,2,104329,99917,4412,4.2
MT1814020000000,18,14020,"Bloomington, IN MSA",2024,2,84873,81842,3031,3.6
MT1818020000000,18,18020,"Columbus, IN MSA",2024,2,39718,38258,1460,3.7
MT1821140000000,18,21140,"Elkhart-Goshen, IN MSA",2024,2,98153,93542,4611,4.7
MT1821780000000,18,21780,"Evansville, IN MSA",2024,2,134724,129900,4824,3.6
MT1823060000000,18,23060,"Fort Wayne, IN MSA",2024,2,230715,222824,7891,3.4
MT1826900000000,18,26900,"Indianapolis-Carmel-Greenwood, IN MSA",2024,2,1131336,1091488,39848,3.5
MT1829020000000,18,29020,"Kokomo, IN MSA",2024,2,35704,33886,1818,5.1
MT1829200000000,18,29200,"Lafayette-West Lafayette, IN MSA",2024,2,119882,115859,4023,3.4
MT1833140000000,18,33140,"Michigan City-La Porte, IN MSA",2024,2,51607,49423,2184,4.2
MT1834620000000,18,34620,"Muncie, IN MSA",2024,2,52189,49882,2307,4.4
MT1843780000000,18,43780,"South Bend-Mishawaka, IN-MI MSA",2024,2,153012,146093,6919,4.5
MT1845460000000,18,45460,"Terre Haute, IN MSA",2024,2,76925,73848,3077,4
MT1911180000000,19,11180,"Ames, IA MSA",2024,2,69475,67900,1575,2.3
MT1916300000000,19,16300,"Cedar Rapids, IA MSA",2024,2,146524,141993,4531,3.1
MT1919780000000,19,19780,"Des Moines-West Des Moines, IA MSA",2024,2,412399,401559,10840,2.6
MT1920220000000,19,20220,"Dubuque, IA MSA",2024,2,53401,51920,1481,2.8
MT1926980000000,19,26980,"Iowa City, IA MSA",2024,2,99500,97251,2249,2.3
MT1943580000000,19,43580,"Sioux City, IA-NE-SD MSA",2024,2,76565,74508,2057,2.7
MT1947940000000,19,47940,"Waterloo-Cedar Falls, IA MSA",2024,2,87983,85482,2501,2.8
MT2029940000000,20,29940,"Lawrence, KS MSA",2024,2,70682,68614,2068,2.9
MT2031740000000,20,31740,"Manhattan, KS MSA",2024,2,63745,61812,1933,3
MT2045820000000,20,45820,"Topeka, KS MSA",2024,2,118115,114307,3808,3.2
MT2048620000000,20,48620,"Wichita, KS MSA",2024,2,334095,322709,11386,3.4
MT2114540000000,21,14540,"Bowling Green, KY MSA",2024,2,91740,87642,4098,4.5
MT2121060000000,21,21060,"Elizabethtown, KY MSA",2024,2,55585,53015,2570,4.6
MT2130460000000,21,30460,"Lexington-Fayette, KY MSA",2024,2,276118,265172,10946,4
MT2131140000000,21,31140,"Louisville/Jefferson County, KY-IN MSA",2024,2,694351,665748,28603,4.1
MT2136980000000,21,36980,"Owensboro, KY MSA",2024,2,51588,49188,2400,4.7
MT2137140000000,21,37140,"Paducah, KY-IL MSA",2024,2,45905,43739,2166,4.7
MT2210780000000,22,10780,"Alexandria, LA MSA",2024,2,64325,61699,2626,4.1
MT2212940000000,22,12940,"Baton Rouge, LA MSA",2024,2,429179,412138,17041,4
MT2225220000000,22,25220,"Hammond, LA MSA",2024,2,60802,57972,2830,4.7
MT2226380000000,22,26380,"Houma-Bayou Cane-Thibodaux, LA MSA",2024,2,88042,84817,3225,3.7
MT2229180000000,22,29180,"Lafayette, LA MSA",2024,2,197918,190637,7281,3.7
MT2229340000000,22,29340,"Lake Charles, LA MSA",2024,2,98417,94173,4244,4.3
MT2233740000000,22,33740,"Monroe, LA MSA",2024,2,96042,91477,4565,4.8
MT2235380000000,22,35380,"New Orleans-Metairie, LA MSA",2024,2,467347,447205,20142,4.3
MT2243340000000,22,43340,"Shreveport-Bossier City, LA MSA",2024,2,168164,160825,7339,4.4
MT2243640000000,22,43640,"Slidell-Mandeville-Covington, LA MSA",2024,2,129198,124330,4868,3.8
MT2312620000000,23,12620,"Bangor, ME MSA",2024,2,75225,72991,2234,3
MT2330340000000,23,30340,"Lewiston-Auburn, ME MSA",2024,2,55239,53674,1565,2.8
MT2338860000000,23,38860,"Portland-South Portland, ME MSA",2024,2,312054,304836,7218,2.3
MT2412580000000,24,12580,"Baltimore-Columbia-Towson, MD MSA",2024,2,1496717,1454345,42372,2.8
MT2425180000000,24,25180,"Hagerstown-Martinsburg, MD-WV MSA",2024,2,143930,139333,4597,3.2
MT2430500000000,24,30500,"Lexington Park, MD MSA",2024,2,108865,106150,2715,2.5
MT2441540000000,24,41540,"Salisbury, MD MSA",2024,2,64354,62347,2007,3.1
MT2511200000000,25,11200,"Amherst Town-Northampton, MA MSA",2024,2,85314,82313,3001,3.5
MT2512700000000,25,12700,"Barnstable Town, MA MSA",2024,2,115791,110445,5346,4.6
MT2514460000000,25,14460,"Boston-Cambridge-Newton, MA-NH MSA",2024,2,2816396,2719242,97154,3.4
MT2538340000000,25,38340,"Pittsfield, MA MSA",2024,2,64314,61887,2427,3.8
MT2544140000000,25,44140,"Springfield, MA MSA",2024,2,223589,212773,10816,4.8
MT2549340000000,25,49340,"Worcester, MA MSA",2024,2,463760,445832,17928,3.9
MT2611460000000,26,11460,"Ann Arbor, MI MSA",2024,2,206792,199963,6829,3.3
MT2612980000000,26,12980,"Battle Creek, MI MSA",2024,2,62952,60105,2847,4.5
MT2613020000000,26,13020,"Bay City, MI MSA",2024,2,50162,47682,2480,4.9
MT2619820000000,26,19820,"Detroit-Warren-Dearborn, MI MSA",2024,2,2182617,2099161,83456,3.8
MT2622420000000,26,22420,"Flint, MI MSA",2024,2,187648,178173,9475,5
MT2624340000000,26,24340,"Grand Rapids-Wyoming-Kentwood, MI MSA",2024,2,627689,606385,21304,3.4
MT2627100000000,26,27100,"Jackson, MI MSA",2024,2,74810,71661,3149,4.2
MT2628020000000,26,28020,"Kalamazoo-Portage, MI MSA",2024,2,139852,134771,5081,3.6
MT2629620000000,26,29620,"Lansing-East Lansing, MI MSA",2024,2,253437,243515,9922,3.9
MT2633220000000,26,33220,"Midland, MI MSA",2024,2,42661,41036,1625,3.8
MT2633780000000,26,33780,"Monroe, MI MSA",2024,2,78977,75600,3377,4.3
MT2634740000000,26,34740,"Muskegon-Norton Shores, MI MSA",2024,2,84570,80850,3720,4.4
MT2635660000000,26,35660,"Niles, MI MSA",2024,2,76710,73407,3303,4.3
MT2640980000000,26,40980,"Saginaw, MI MSA",2024,2,84839,80406,4433,5.2
MT2645900000000,26,45900,"Traverse City, MI MSA",2024,2,81242,78240,3002,3.7
MT2720260000000,27,20260,"Duluth, MN-WI MSA",2024,2,140192,135413,4779,3.4
MT2731860000000,27,31860,"Mankato, MN MSA",2024,2,60306,58814,1492,2.5
MT2733460000000,27,33460,"Minneapolis-St. Paul-Bloomington, MN-WI MSA",2024,2,2065783,2008774,57009,2.8
MT2740340000000,27,40340,"Rochester, MN MSA",2024,2,126299,123378,2921,2.3
MT2741060000000,27,41060,"St. Cloud, MN MSA",2024,2,109858,106661,3197,2.9
MT2825060000000,28,25060,"Gulfport-Biloxi, MS MSA",2024,2,185470,180770,4700,2.5
MT2825620000000,28,25620,"Hattiesburg, MS MSA",2024,2,69886,68113,1773,2.5
MT2827140000000,28,27140,"Jackson, MS MSA",2024,2,278120,271244,6876,2.5
MT2916020000000,29,16020,"Cape Girardeau, MO-IL MSA",2024,2,49154,47546,1608,3.3
MT2917860000000,29,17860,"Columbia, MO MSA",2024,2,112664,109291,3373,3
MT2927620000000,29,27620,"Jefferson City, MO MSA",2024,2,76000,73718,2282,3
MT2927900000000,29,27900,"Joplin, MO-KS MSA",2024,2,97782,94361,3421,3.5
MT2928140000000,29,28140,"Kansas City, MO-KS MSA",2024,2,1193325,1152441,40884,3.4
MT2941140000000,29,41140,"St. Joseph, MO-KS MSA",2024,2,54116,52219,1897,3.5
MT2941180000000,29,41180,"St. Louis, MO-IL MSA",2024,2,1480785,1426961,53824,3.6
MT2944180000000,29,44180,"Springfield, MO MSA",2024,2,241879,234156,7723,3.2
MT3013740000000,30,13740,"Billings, MT MSA",2024,2,99063,96298,2765,2.8
MT3014580000000,30,14580,"Bozeman, MT MSA",2024,2,77685,75939,1746,2.2
MT3024500000000,30,24500,"Great Falls, MT MSA",2024,2,39966,38769,1197,3
MT3025740000000,30,25740,"Helena, MT MSA",2024,2,47582,46247,1335,2.8
MT3033540000000,30,33540,"Missoula, MT MSA",2024,2,73957,71788,2169,2.9
MT3124260000000,31,24260,"Grand Island, NE MSA",2024,2,42826,41738,1088,2.5
MT3130700000000,31,30700,"Lincoln, NE MSA",2024,2,192522,188093,4429,2.3
MT3136540000000,31,36540,"Omaha, NE-IA MSA",2024,2,524909,510496,14413,2.7
MT3216180000000,32,16180,"Carson City, NV MSA",2024,2,28851,27618,1233,4.3
MT3229820000000,32,29820,"Las Vegas-Henderson-North Las Vegas, NV MSA",2024,2,1209718,1143199,66519,5.5
MT3239900000000,32,39900,"Reno, NV MSA",2024,2,296939,283701,13238,4.5
MT3331700000000,33,31700,"Manchester-Nashua, NH MSA",2024,2,239988,233938,6050,2.5
MT3412100000000,34,12100,"Atlantic City-Hammonton, NJ MSA",2024,2,179912,169191,10721,6
MT3445940000000,34,45940,"Trenton-Princeton, NJ MSA",2024,2,199346,190933,8413,4.2
MT3447220000000,34,47220,"Vineland, NJ MSA",2024,2,65262,60813,4449,6.8
MT3510740000000,35,10740,"Albuquerque, NM MSA",2024,2,460596,444358,16238,3.5
MT3522140000000,35,22140,"Farmington, NM MSA",2024,2,49697,47553,2144,4.3
MT3529740000000,35,29740,"Las Cruces, NM MSA",2024,2,102001,97373,4628,4.5
MT3542140000000,35,42140,"Santa Fe, NM MSA",2024,2,73791,71363,2428,3.3
MT3610580000000,36,10580,"Albany-Schenectady-Troy, NY MSA",2024,2,457534,442084,15450,3.4
MT3613780000000,36,13780,"Binghamton, NY MSA",2024,2,107123,103030,4093,3.8
MT3615380000000,36,15380,"Buffalo-Cheektowaga, NY MSA",2024,2,559948,537993,21955,3.9
MT3621300000000,36,21300,"Elmira, NY MSA",2024,2,35559,34237,1322,3.7
MT3624020000000,36,24020,"Glens Falls, NY MSA",2024,2,59524,57392,2132,3.6
MT3627060000000,36,27060,"Ithaca, NY MSA",2024,2,48253,46659,1594,3.3
MT3628740000000,36,28740,"Kingston, NY MSA",2024,2,87529,84359,3170,3.6
MT3628880000000,36,28880,"Kiryas Joel-Poughkeepsie-Newburgh, NY MSA",2024,2,340710,328692,12018,3.5
MT3635620000000,36,35620,"New York-Newark-Jersey City, NY-NJ MSA",2024,2,10171809,9737010,434799,4.3
MT3640380000000,36,40380,"Rochester, NY MSA",2024,2,513891,494730,19161,3.7
MT3645060000000,36,45060,"Syracuse, NY MSA",2024,2,310267,298889,11378,3.7
MT3646540000000,36,46540,"Utica-Rome, NY MSA",2024,2,127923,123083,4840,3.8
MT3648060000000,36,48060,"Watertown-Fort Drum, NY MSA",2024,2,44883,42864,2019,4.5
MT3711700000000,37,11700,"Asheville, NC MSA",2024,2,211920,205901,6019,2.8
MT3715500000000,37,15500,"Burlington, NC MSA",2024,2,86031,83011,3020,3.5
MT3716740000000,37,16740,"Charlotte-Concord-Gastonia, NC-SC MSA",2024,2,1476621,1424832,51789,3.5
MT3720500000000,37,20500,"Durham-Chapel Hill, NC MSA",2024,2,322310,312041,10269,3.2
MT3722180000000,37,22180,"Fayetteville, NC MSA",2024,2,155229,148345,6884,4.4
MT3724140000000,37,24140,"Goldsboro, NC MSA",2024,2,50564,48720,1844,3.6
MT3724660000000,37,24660,"Greensboro-High Point, NC MSA",2024,2,374057,359387,14670,3.9
MT3724780000000,37,24780,"Greenville, NC MSA",2024,2,84184,80712,3472,4.1
MT3725860000000,37,25860,"Hickory-Lenoir-Morganton, NC MSA",2024,2,171096,165311,5785,3.4
MT3727340000000,37,27340,"Jacksonville, NC MSA",2024,2,74379,71609,2770,3.7
MT3738240000000,37,38240,"Pinehurst-Southern Pines, NC MSA",2024,2,44840,43319,1521,3.4
MT3739580000000,37,39580,"Raleigh-Cary, NC MSA",2024,2,844118,817648,26470,3.1
MT3740580000000,37,40580,"Rocky Mount, NC MSA",2024,2,63683,60688,2995,4.7
MT3748900000000,37,48900,"Wilmington, NC MSA",2024,2,222483,214650,7833,3.5
MT3749180000000,37,49180,"Winston-Salem, NC MSA",2024,2,324273,312755,11518,3.6
MT3813900000000,38,13900,"Bismarck, ND MSA",2024,2,72659,71142,1517,2.1
MT3822020000000,38,22020,"Fargo, ND-MN MSA",2024,2,153417,150193,3224,2.1
MT3824220000000,38,24220,"Grand Forks, ND-MN MSA",2024,2,56146,54915,1231,2.2
MT3833500000000,38,33500,"Minot, ND MSA",2024,2,40325,39426,899,2.2
MT3910420000000,39,10420,"Akron, OH MSA",2024,2,360027,345386,14641,4.1
MT3915940000000,39,15940,"Canton-Massillon, OH MSA",2024,2,194160,186052,8108,4.2
MT3917140000000,39,17140,"Cincinnati, OH-KY-IN MSA",2024,2,1167342,1121680,45662,3.9
MT3917410000000,39,17410,"Cleveland, OH MSA",2024,2,1092590,1051747,40843,3.7
MT3918140000000,39,18140,"Columbus, OH MSA",2024,2,1149777,1107577,42200,3.7
MT3919430000000,39,19430,"Dayton-Kettering-Beavercreek, OH MSA",2024,2,393986,378316,15670,4
MT3930620000000,39,30620,"Lima, OH MSA",2024,2,47423,45534,1889,4
MT3931900000000,39,31900,"Mansfield, OH MSA",2024,2,53380,50898,2482,4.6
MT3941780000000,39,41780,"Sandusky, OH MSA",2024,2,57030,54319,2711,4.8
MT3944220000000,39,44220,"Springfield, OH MSA",2024,2,62155,59583,2572,4.1
MT3945780000000,39,45780,"Toledo, OH MSA",2024,2,296184,282563,13621,4.6
MT3948260000000,39,48260,"Weirton-Steubenville, WV-OH MSA",2024,2,51981,49196,2785,5.4
MT3949660000000,39,49660,"Youngstown-Warren, OH MSA",2024,2,192845,183727,9118,4.7
MT4021420000000,40,21420,"Enid, OK MSA",2024,2,28352,27385,967,3.4
MT4030020000000,40,30020,"Lawton, OK MSA",2024,2,52481,50540,1941,3.7
MT4036420000000,40,36420,"Oklahoma City, OK MSA",2024,2,773032,749046,23986,3.1
MT4046140000000,40,46140,"Tulsa, OK MSA",2024,2,524233,506633,17600,3.4
MT4110540000000,41,10540,"Albany, OR MSA",2024,2,61421,58638,2783,4.5
MT4113460000000,41,13460,"Bend, OR MSA",2024,2,133219,127675,5544,4.2
MT4118700000000,41,18700,"Corvallis, OR MSA",2024,2,49653,47883,1770,3.6
MT4121660000000,41,21660,"Eugene-Springfield, OR MSA",2024,2,188050,180140,7910,4.2
MT4124420000000,41,24420,"Grants Pass, OR MSA",2024,2,35183,33249,1934,5.5
MT4132780000000,41,32780,"Medford, OR MSA",2024,2,106298,101165,5133,4.8
MT4138900000000,41,38900,"Portland-Vancouver-Hillsboro, OR-WA MSA",2024,2,1381136,1326859,54277,3.9
MT4141420000000,41,41420,"Salem, OR MSA",2024,2,220631,211749,8882,4
MT4210900000000,42,10900,"Allentown-Bethlehem-Easton, PA-NJ MSA",2024,2,453242,435433,17809,3.9
MT4211020000000,42,11020,"Altoona, PA MSA",2024,2,57721,55746,1975,3.4
MT4216540000000,42,16540,"Chambersburg, PA MSA",2024,2,76610,74274,2336,3
MT4221500000000,42,21500,"Erie, PA MSA",2024,2,127565,122757,4808,3.8
MT4223900000000,42,23900,"Gettysburg, PA MSA",2024,2,52081,50502,1579,3
MT4225420000000,42,25420,"Harrisburg-Carlisle, PA MSA",2024,2,315247,305132,10115,3.2
MT4227780000000,42,27780,"Johnstown, PA MSA",2024,2,57284,54916,2368,4.1
MT4229540000000,42,29540,"Lancaster, PA MSA",2024,2,293762,285364,8398,2.9
MT4230140000000,42,30140,"Lebanon, PA MSA",2024,2,73614,71328,2286,3.1
MT4237980000000,42,37980,"Philadelphia-Camden-Wilmington, PA-NJ-DE-MD MSA",2024,2,3308443,3184089,124354,3.8
MT4238300000000,42,38300,"Pittsburgh, PA MSA",2024,2,1245964,1202277,43687,3.5
MT4239740000000,42,39740,"Reading, PA MSA",2024,2,219944,211757,8187,3.7
MT4242540000000,42,42540,"Scranton--Wilkes-Barre, PA MSA",2024,2,281992,269996,11996,4.3
MT4244300000000,42,44300,"State College, PA MSA",2024,2,77512,75307,2205,2.8
MT4248700000000,42,48700,"Williamsport, PA MSA",2024,2,53375,51333,2042,3.8
MT4249620000000,42,49620,"York-Hanover, PA MSA",2024,2,241930,233993,7937,3.3
MT4439300000000,44,39300,"Providence-Warwick, RI-MA MSA",2024,2,897920,860631,37289,4.2
MT4516700000000,45,16700,"Charleston-North Charleston, SC MSA",2024,2,440233,426830,13403,3
MT4517900000000,45,17900,"Columbia, SC MSA",2024,2,416201,401457,14744,3.5
MT4522500000000,45,22500,"Florence, SC MSA",2024,2,91880,88228,3652,4
MT4524860000000,45,24860,"Greenville-Anderson-Greer, SC MSA",2024,2,477439,461713,15726,3.3
MT4525940000000,45,25940,"Hilton Head Island-Bluffton-Port Royal, SC MSA",2024,2,97158,93922,3236,3.3
MT4534820000000,45,34820,"Myrtle Beach-Conway-North Myrtle Beach, SC MSA",2024,2,170068,162919,7149,4.2
MT4543900000000,45,43900,"Spartanburg, SC MSA",2024,2,175537,169123,6414,3.7
MT4544940000000,45,44940,"Sumter, SC MSA",2024,2,41580,39725,1855,4.5
MT4639660000000,46,39660,"Rapid City, SD MSA",2024,2,78849,77502,1347,1.7
MT4643620000000,46,43620,"Sioux Falls, SD-MN MSA",2024,2,173104,170338,2766,1.6
MT4716860000000,47,16860,"Chattanooga, TN-GA MSA",2024,2,289480,281073,8407,2.9
MT4717300000000,47,17300,"Clarksville, TN-KY MSA",2024,2,137468,132222,5246,3.8
MT4717420000000,47,17420,"Cleveland, TN MSA",2024,2,56368,54485,1883,3.3
MT4727180000000,47,27180,"Jackson, TN MSA",2024,2,78264,75586,2678,3.4
MT4727740000000,47,27740,"Johnson City, TN MSA",2024,2,96431,93443,2988,3.1
MT4728700000000,47,28700,"Kingsport-Bristol, TN-VA MSA",2024,2,132450,128157,4293,3.2
MT4728940000000,47,28940,"Knoxville, TN MSA",2024,2,449058,436062,12996,2.9
MT4732820000000,47,32820,"Memphis, TN-MS-AR MSA",2024,2,624523,601280,23243,3.7
MT4734100000000,47,34100,"Morristown, TN MSA",2024,2,53063,51375,1688,3.2
MT4734980000000,47,34980,"Nashville-Davidson--Murfreesboro--Franklin, TN MSA",2024,2,1153360,1123784,29576,2.6
MT4810180000000,48,10180,"Abilene, TX MSA",2024,2,85915,83025,2890,3.4
MT4811100000000,48,11100,"Amarillo, TX MSA",2024,2,136434,132263,4171,3.1
MT4812420000000,48,12420,"Austin-Round Rock-San Marcos, TX MSA",2024,2,1485057,1434156,50901,3.4
MT4813140000000,48,13140,"Beaumont-Port Arthur, TX MSA",2024,2,179250,170073,9177,5.1
MT4815180000000,48,15180,"Brownsville-Harlingen, TX MSA",2024,2,187502,178089,9413,5
MT4817780000000,48,17780,"College Station-Bryan, TX MSA",2024,2,149336,144291,5045,3.4
MT4818580000000,48,18580,"Corpus Christi, TX MSA",2024,2,208550,199776,8774,4.2
MT4819100000000,48,19100,"Dallas-Fort Worth-Arlington, TX MSA",2024,2,4443437,4275099,168338,3.8
MT4820580000000,48,20580,"Eagle Pass, TX MSA",2024,2,23608,21843,1765,7.5
MT4821340000000,48,21340,"El Paso, TX MSA",2024,2,409413,392632,16781,4.1
MT4826420000000,48,26420,"Houston-Pasadena-The Woodlands, TX MSA",2024,2,3794097,3636854,157243,4.1
MT4828660000000,48,28660,"Killeen-Temple, TX MSA",2024,2,201262,192940,8322,4.1
MT4829700000000,48,29700,"Laredo, TX MSA",2024,2,117231,112374,4857,4.1
MT4830980000000,48,30980,"Longview, TX MSA",2024,2,128918,123077,5841,4.5
MT4831180000000,48,31180,"Lubbock, TX MSA",2024,2,183422,177287,6135,3.3
MT4832580000000,48,32580,"McAllen-Edinburg-Mission, TX MSA",2024,2,391564,369118,22446,5.7
MT4833260000000,48,33260,"Midland, TX MSA",2024,2,102666,99820,2846,2.8
MT4836220000000,48,36220,"Odessa, TX MSA",2024,2,85401,82554,2847,3.3
MT4841660000000,48,41660,"San Angelo, TX MSA",2024,2,61586,59661,1925,3.1
MT4841700000000,48,41700,"San Antonio-New Braunfels, TX MSA",2024,2,1321283,1273217,48066,3.6
MT4843300000000,48,43300,"Sherman-Denison, TX MSA",2024,2,70897,68287,2610,3.7
MT4845500000000,48,45500,"Texarkana, TX-AR MSA",2024,2,61376,58907,2469,4
MT4846340000000,48,46340,"Tyler, TX MSA",2024,2,116980,112629,4351,3.7
MT4847020000000,48,47020,"Victoria, TX MSA",2024,2,44808,43051,1757,3.9
MT4847380000000,48,47380,"Waco, TX MSA",2024,2,145077,139719,5358,3.7
MT4848660000000,48,48660,"Wichita Falls, TX MSA",2024,2,66697,64237,2460,3.7
MT4930860000000,49,30860,"Logan, UT-ID MSA",2024,2,79195,77145,2050,2.6
MT4936260000000,49,36260,"Ogden, UT MSA",2024,2,349973,340177,9796,2.8
MT4939340000000,49,39340,"Provo-Orem-Lehi, UT MSA",2024,2,368151,357152,10999,3
MT4941100000000,49,41100,"St. George, UT MSA",2024,2,92542,89660,2882,3.1
MT4941620000000,49,41620,"Salt Lake City-Murray, UT MSA",2024,2,734414,712242,22172,3
MT5015540000000,50,15540,"Burlington-South Burlington, VT MSA",2024,2,130768,128466,2302,1.8
MT5113980000000,51,13980,"Blacksburg-Christiansburg-Radford, VA MSA",2024,2,93726,91094,2632,2.8
MT5116820000000,51,16820,"Charlottesville, VA MSA",2024,2,120553,117619,2934,2.4
MT5125500000000,51,25500,"Harrisonburg, VA MSA",2024,2,72787,70840,1947,2.7
MT5131340000000,51,31340,"Lynchburg, VA MSA",2024,2,128185,124176,4009,3.1
MT5140060000000,51,40060,"Richmond, VA MSA",2024,2,725795,704984,20811,2.9
MT5140220000000,51,40220,"Roanoke, VA MSA",2024,2,158434,153987,4447,2.8
MT5144420000000,51,44420,"Staunton-Stuarts Draft, VA MSA",2024,2,65725,64153,1572,2.4
MT5147260000000,51,47260,"Virginia Beach-Chesapeake-Norfolk, VA-NC MSA",2024,2,883288,857195,26093,3
MT5149020000000,51,49020,"Winchester, VA-WV MSA",2024,2,77548,75533,2015,2.6
MT5313380000000,53,13380,"Bellingham, WA MSA",2024,2,114243,109147,5096,4.5
MT5314740000000,53,14740,"Bremerton-Silverdale-Port Orchard, WA MSA",2024,2,122245,116698,5547,4.5
MT5328420000000,53,28420,"Kennewick-Richland, WA MSA",2024,2,145775,138612,7163,4.9
MT5331020000000,53,31020,"Longview-Kelso, WA MSA",2024,2,47095,44637,2458,5.2
MT5334580000000,53,34580,"Mount Vernon-Anacortes, WA MSA",2024,2,59189,56287,2902,4.9
MT5336500000000,53,36500,"Olympia-Lacey-Tumwater, WA MSA",2024,2,143188,136670,6518,4.6
MT5342660000000,53,42660,"Seattle-Tacoma-Bellevue, WA MSA",2024,2,2314657,2213471,101186,4.4
MT5344060000000,53,44060,"Spokane-Spokane Valley, WA MSA",2024,2,282128,269557,12571,4.5
MT5347460000000,53,47460,"Walla Walla, WA MSA",2024,2,29370,28114,1256,4.3
MT5348300000000,53,48300,"Wenatchee-East Wenatchee, WA MSA",2024,2,62322,59389,2933,4.7
MT5349420000000,53,49420,"Yakima, WA MSA",2024,2,126225,118888,7337,5.8
MT5413220000000,54,13220,"Beckley, WV MSA",2024,2,46291,44523,1768,3.8
MT5416620000000,54,16620,"Charleston, WV MSA",2024,2,91290,87754,3536,3.9
MT5426580000000,54,26580,"Huntington-Ashland, WV-KY-OH MSA",2024,2,156869,149294,7575,4.8
MT5434060000000,54,34060,"Morgantown, WV MSA",2024,2,71189,68732,2457,3.5
MT5437620000000,54,37620,"Parkersburg-Vienna, WV MSA",2024,2,39506,37800,1706,4.3
MT5448540000000,54,48540,"Wheeling, WV-OH MSA",2024,2,59506,56828,2678,4.5
MT5511540000000,55,11540,"Appleton, WI MSA",2024,2,137187,133994,3193,2.3
MT5520740000000,55,20740,"Eau Claire, WI MSA",2024,2,96198,93564,2634,2.7
MT5522540000000,55,22540,"Fond du Lac, WI MSA",2024,2,55784,54389,1395,2.5
MT5524580000000,55,24580,"Green Bay, WI MSA",2024,2,178547,174010,4537,2.5
MT5527500000000,55,27500,"Janesville-Beloit, WI MSA",2024,2,86849,84140,2709,3.1
MT5528450000000,55,28450,"Kenosha, WI MSA",2024,2,95822,92822,3000,3.1
MT5529100000000,55,29100,"La Crosse-Onalaska, WI-MN MSA",2024,2,90308,88104,2204,2.4
MT5531540000000,55,31540,"Madison, WI MSA",2024,2,409794,400947,8847,2.2
MT5533340000000,55,33340,"Milwaukee-Waukesha, WI MSA",2024,2,818779,793190,25589,3.1
MT5536780000000,55,36780,"Oshkosh-Neenah, WI MSA",2024,2,93368,90994,2374,2.5
MT5539540000000,55,39540,"Racine-Mount Pleasant, WI MSA",2024,2,101891,98532,3359,3.3
MT5543100000000,55,43100,"Sheboygan, WI MSA",2024,2,63494,62023,1471,2.3
MT5548140000000,55,48140,"Wausau, WI MSA",2024,2,75403,73489,1914,2.5
MT5616220000000,56,16220,"Casper, WY MSA",2024,2,42018,40801,1217,2.9
MT5616940000000,56,16940,"Cheyenne, WY MSA",2024,2,48923,47437,1486,3
MT7210380000000,72,10380,"Aguadilla, PR MSA",2024,2,90179,83868,6311,7
MT7211640000000,72,11640,"Arecibo, PR MSA",2024,2,67355,63535,3820,5.7
MT7225020000000,72,25020,"Guayama, PR MSA",2024,2,19217,17369,1848,9.6
MT7232420000000,72,32420,"Mayaguez, PR MSA",2024,2,67122,62412,4710,7
MT7238660000000,72,38660,"Ponce, PR MSA",2024,2,89590,81486,8104,9
MT7241980000000,72,41980,"San Juan-Bayamon-Caguas, PR MSA",2024,2,813813,774057,39756,4.9
MT0111500000000,1,11500,"Anniston-Oxford, AL MSA",2024,3,49205,47748,1457,3
MT0112220000000,1,12220,"Auburn-Opelika, AL MSA",2024,3,96485,93855,2630,2.7
MT0113820000000,1,13820,"Birmingham, AL MSA",2024,3,570049,554894,15155,2.7
MT0119300000000,1,19300,"Daphne-Fairhope-Foley, AL MSA",2024,3,115584,112671,2913,2.5
MT0119460000000,1,19460,"Decatur, AL MSA",2024,3,75256,73498,1758,2.3
MT0120020000000,1,20020,"Dothan, AL MSA",2024,3,67467,65544,1923,2.9
MT0122520000000,1,22520,"Florence-Muscle Shoals, AL MSA",2024,3,68537,66507,2030,3
MT0123460000000,1,23460,"Gadsden, AL MSA",2024,3,41866,40631,1235,2.9
MT0126620000000,1,26620,"Huntsville, AL MSA",2024,3,274235,267789,6446,2.4
MT0133660000000,1,33660,"Mobile, AL MSA",2024,3,184878,177991,6887,3.7
MT0133860000000,1,33860,"Montgomery, AL MSA",2024,3,177777,172598,5179,2.9
MT0146220000000,1,46220,"Tuscaloosa, AL MSA",2024,3,126147,122400,3747,3
MT0211260000000,2,11260,"Anchorage, AK MSA",2024,3,200069,192106,7963,4
MT0221820000000,2,21820,"Fairbanks-College, AK MSA",2024,3,45492,43782,1710,3.8
MT0422380000000,4,22380,"Flagstaff, AZ MSA",2024,3,75574,72923,2651,3.5
MT0429420000000,4,29420,"Lake Havasu City-Kingman, AZ MSA",2024,3,87407,83811,3596,4.1
MT0438060000000,4,38060,"Phoenix-Mesa-Chandler, AZ MSA",2024,3,2697312,2618327,78985,2.9
MT0439150000000,4,39150,"Prescott Valley-Prescott, AZ MSA",2024,3,106403,102938,3465,3.3
MT0443420000000,4,43420,"Sierra Vista-Douglas, AZ MSA",2024,3,48215,46253,1962,4.1
MT0446060000000,4,46060,"Tucson, AZ MSA",2024,3,491044,474845,16199,3.3
MT0449740000000,4,49740,"Yuma, AZ MSA",2024,3,98383,86748,11635,11.8
MT0522220000000,5,22220,"Fayetteville-Springdale-Rogers, AR MSA",2024,3,303765,295862,7903,2.6
MT0522900000000,5,22900,"Fort Smith, AR-OK MSA",2024,3,101123,97601,3522,3.5
MT0526300000000,5,26300,"Hot Springs, AR MSA",2024,3,43741,42191,1550,3.5
MT0527860000000,5,27860,"Jonesboro, AR MSA",2024,3,65967,63933,2034,3.1
MT0530780000000,5,30780,"Little Rock-North Little Rock-Conway, AR MSA",2024,3,377964,365887,12077,3.2
MT0612540000000,6,12540,"Bakersfield-Delano, CA MSA",2024,3,404920,370169,34751,8.6
MT0617020000000,6,17020,"Chico, CA MSA",2024,3,91238,86020,5218,5.7
MT0620940000000,6,20940,"El Centro, CA MSA",2024,3,72557,59414,13143,18.1
MT0623420000000,6,23420,"Fresno, CA MSA",2024,3,535175,493399,41776,7.8
MT0625260000000,6,25260,"Hanford-Corcoran, CA MSA",2024,3,57926,52850,5076,8.8
MT0631080000000,6,31080,"Los Angeles-Long Beach-Anaheim, CA MSA",2024,3,6704966,6369648,335318,5
MT0632900000000,6,32900,"Merced, CA MSA",2024,3,119505,107937,11568,9.7
MT0633700000000,6,33700,"Modesto, CA MSA",2024,3,250864,233969,16895,6.7
MT0634900000000,6,34900,"Napa, CA MSA",2024,3,73516,70738,2778,3.8
MT0637100000000,6,37100,"Oxnard-Thousand Oaks-Ventura, CA MSA",2024,3,419836,401106,18730,4.5
MT0639820000000,6,39820,"Redding, CA MSA",2024,3,78646,74581,4065,5.2
MT0640140000000,6,40140,"Riverside-San Bernardino-Ontario, CA MSA",2024,3,2196370,2085504,110866,5
MT0640900000000,6,40900,"Sacramento-Roseville-Folsom, CA MSA",2024,3,1175353,1122665,52688,4.5
MT0641500000000,6,41500,"Salinas, CA MSA",2024,3,219807,203754,16053,7.3
MT0641740000000,6,41740,"San Diego-Chula Vista-Carlsbad, CA MSA",2024,3,1644752,1576540,68212,4.1
MT0641860000000,6,41860,"San Francisco-Oakland-Fremont, CA MSA",2024,3,2502892,2401781,101111,4
MT0641940000000,6,41940,"San Jose-Sunnyvale-Santa Clara, CA MSA",2024,3,1055887,1012963,42924,4.1
MT0642020000000,6,42020,"San Luis Obispo-Paso Robles, CA MSA",2024,3,132359,127188,5171,3.9
MT0642100000000,6,42100,"Santa Cruz-Watsonville, CA MSA",2024,3,135748,127903,7845,5.8
MT0642200000000,6,42200,"Santa Maria-Santa Barbara, CA MSA",2024,3,220814,211200,9614,4.4
MT0642220000000,6,42220,"Santa Rosa-Petaluma, CA MSA",2024,3,247032,237275,9757,3.9
MT0644700000000,6,44700,"Stockton-Lodi, CA MSA",2024,3,365667,342711,22956,6.3
MT0646700000000,6,46700,"Vallejo, CA MSA",2024,3,216439,206194,10245,4.7
MT0647300000000,6,47300,"Visalia, CA MSA",2024,3,220619,197918,22701,10.3
MT0649700000000,6,49700,"Yuba City, CA MSA",2024,3,80693,74523,6170,7.6
MT0814500000000,8,14500,"Boulder, CO MSA",2024,3,193705,186440,7265,3.8
MT0817820000000,8,17820,"Colorado Springs, CO MSA",2024,3,393594,378392,15202,3.9
MT0819740000000,8,19740,"Denver-Aurora-Centennial, CO MSA",2024,3,1767532,1700037,67495,3.8
MT0822660000000,8,22660,"Fort Collins-Loveland, CO MSA",2024,3,208696,201070,7626,3.7
MT0824300000000,8,24300,"Grand Junction, CO MSA",2024,3,79447,76273,3174,4
MT0824540000000,8,24540,"Greeley, CO MSA",2024,3,176694,169543,7151,4
MT0839380000000,8,39380,"Pueblo, CO MSA",2024,3,73461,69548,3913,5.3
MT0914860000000,9,14860,"Bridgeport-Stamford-Danbury, CT MSA",2024,3,514329,498654,15675,3
MT0925540000000,9,25540,"Hartford-West Hartford-East Hartford, CT MSA",2024,3,609578,590293,19285,3.2
MT0935300000000,9,35300,"New Haven, CT MSA",2024,3,315358,305367,9991,3.2
MT0935980000000,9,35980,"Norwich-New London-Willimantic, CT MSA",2024,3,142051,137661,4390,3.1
MT0947930000000,9,47930,"Waterbury-Shelton, CT MSA",2024,3,239287,230692,8595,3.6
MT1020100000000,10,20100,"Dover, DE MSA",2024,3,85149,81703,3446,4
MT1147900000000,11,47900,"Washington-Arlington-Alexandria, DC-VA-MD-WV MSA",2024,3,3544986,3443546,101440,2.9
MT1215980000000,12,15980,"Cape Coral-Fort Myers, FL MSA",2024,3,376140,363311,12829,3.4
MT1218880000000,12,18880,"Crestview-Fort Walton Beach-Destin, FL MSA",2024,3,142149,137947,4202,3
MT1219660000000,12,19660,"Deltona-Daytona Beach-Ormond Beach, FL MSA",2024,3,322644,310802,11842,3.7
MT1223540000000,12,23540,"Gainesville, FL MSA",2024,3,168979,162771,6208,3.7
MT1226140000000,12,26140,"Homosassa Springs, FL MSA",2024,3,53543,50984,2559,4.8
MT1227260000000,12,27260,"Jacksonville, FL MSA",2024,3,854856,826192,28664,3.4
MT1229460000000,12,29460,"Lakeland-Winter Haven, FL MSA",2024,3,357099,342491,14608,4.1
MT1233100000000,12,33100,"Miami-Fort Lauderdale-West Palm Beach, FL MSA",2024,3,3309455,3218213,91242,2.8
MT1234940000000,12,34940,"Naples-Marco Island, FL MSA",2024,3,185411,179295,6116,3.3
MT1235840000000,12,35840,"North Port-Bradenton-Sarasota, FL MSA",2024,3,398787,385304,13483,3.4
MT1236100000000,12,36100,"Ocala, FL MSA",2024,3,158413,152075,6338,4
MT1236740000000,12,36740,"Orlando-Kissimmee-Sanford, FL MSA",2024,3,1531713,1483059,48654,3.2
MT1237340000000,12,37340,"Palm Bay-Melbourne-Titusville, FL MSA",2024,3,304702,294516,10186,3.3
MT1237460000000,12,37460,"Panama City-Panama City Beach, FL MSA",2024,3,101438,98129,3309,3.3
MT1237860000000,12,37860,"Pensacola-Ferry Pass-Brent, FL MSA",2024,3,240492,232241,8251,3.4
MT1238940000000,12,38940,"Port St. Lucie, FL MSA",2024,3,238379,229470,8909,3.7
MT1239460000000,12,39460,"Punta Gorda, FL MSA",2024,3,77395,74393,3002,3.9
MT1242680000000,12,42680,"Sebastian-Vero Beach-West Vero Corridor, FL MSA",2024,3,67975,65275,2700,4
MT1242700000000,12,42700,"Sebring, FL MSA",2024,3,36405,34681,1724,4.7
MT1245220000000,12,45220,"Tallahassee, FL MSA",2024,3,207228,200285,6943,3.4
MT1245300000000,12,45300,"Tampa-St. Petersburg-Clearwater, FL MSA",2024,3,1702201,1646124,56077,3.3
MT1248680000000,12,48680,"Wildwood-The Villages, FL MSA",2024,3,33960,32049,1911,5.6
MT1310500000000,13,10500,"Albany, GA MSA",2024,3,62251,59749,2502,4
MT1312020000000,13,12020,"Athens-Clarke County, GA MSA",2024,3,108487,105032,3455,3.2
MT1312060000000,13,12060,"Atlanta-Sandy Springs-Roswell, GA MSA",2024,3,3303034,3193603,109431,3.3
MT1312260000000,13,12260,"Augusta-Richmond County, GA-SC MSA",2024,3,268188,257328,10860,4
MT1315260000000,13,15260,"Brunswick-St. Simons, GA MSA",2024,3,55476,53826,1650,3
MT1317980000000,13,17980,"Columbus, GA-AL MSA",2024,3,128586,123641,4945,3.8
MT1319140000000,13,19140,"Dalton, GA MSA",2024,3,67594,65157,2437,3.6
MT1323580000000,13,23580,"Gainesville, GA MSA",2024,3,109047,106083,2964,2.7
MT1325980000000,13,25980,"Hinesville, GA MSA",2024,3,31111,29884,1227,3.9
MT1331420000000,13,31420,"Macon-Bibb County, GA MSA",2024,3,97145,93244,3901,4
MT1340660000000,13,40660,"Rome, GA MSA",2024,3,47752,46151,1601,3.4
MT1342340000000,13,42340,"Savannah, GA MSA",2024,3,210571,204324,6247,3
MT1346660000000,13,46660,"Valdosta, GA MSA",2024,3,61465,59193,2272,3.7
MT1347580000000,13,47580,"Warner Robins, GA MSA",2024,3,89833,87068,2765,3.1
MT1527980000000,15,27980,"Kahului-Wailuku, HI MSA",2024,3,81770,77883,3887,4.8
MT1546520000000,15,46520,"Urban Honolulu, HI MSA",2024,3,469153,457346,11807,2.5
MT1614260000000,16,14260,"Boise City, ID MSA",2024,3,443467,428586,14881,3.4
MT1617660000000,16,17660,"Coeur d'Alene, ID MSA",2024,3,89248,85486,3762,4.2
MT1626820000000,16,26820,"Idaho Falls, ID MSA",2024,3,84102,81555,2547,3
MT1630300000000,16,30300,"Lewiston, ID-WA MSA",2024,3,31128,30084,1044,3.4
MT1638540000000,16,38540,"Pocatello, ID MSA",2024,3,40854,39316,1538,3.8
MT1646300000000,16,46300,"Twin Falls, ID MSA",2024,3,59365,57383,1982,3.3
MT1714010000000,17,14010,"Bloomington, IL MSA",2024,3,97275,93535,3740,3.8
MT1716580000000,17,16580,"Champaign-Urbana, IL MSA",2024,3,124846,119386,5460,4.4
MT1716980000000,17,16980,"Chicago-Naperville-Elgin, IL-IN MSA",2024,3,4977802,4728534,249268,5
MT1719340000000,17,19340,"Davenport-Moline-Rock Island, IA-IL MSA",2024,3,189441,181474,7967,4.2
MT1719500000000,17,19500,"Decatur, IL MSA",2024,3,44922,42256,2666,5.9
MT1728100000000,17,28100,"Kankakee, IL MSA",2024,3,51244,48203,3041,5.9
MT1737900000000,17,37900,"Peoria, IL MSA",2024,3,177628,168763,8865,5
MT1740420000000,17,40420,"Rockford, IL MSA",2024,3,160837,151426,9411,5.9
MT1744100000000,17,44100,"Springfield, IL MSA",2024,3,104395,99902,4493,4.3
MT1814020000000,18,14020,"Bloomington, IN MSA",2024,3,85241,82103,3138,3.7
MT1818020000000,18,18020,"Columbus, IN MSA",2024,3,39805,38302,1503,3.8
MT1821140000000,18,21140,"Elkhart-Goshen, IN MSA",2024,3,97990,93249,4741,4.8
MT1821780000000,18,21780,"Evansville, IN MSA",2024,3,134834,129882,4952,3.7
MT1823060000000,18,23060,"Fort Wayne, IN MSA",2024,3,231031,222936,8095,3.5
MT1826900000000,18,26900,"Indianapolis-Carmel-Greenwood, IN MSA",2024,3,1133428,1092414,41014,3.6
MT1829020000000,18,29020,"Kokomo, IN MSA",2024,3,35999,34119,1880,5.2
MT1829200000000,18,29200,"Lafayette-West Lafayette, IN MSA",2024,3,119947,115745,4202,3.5
MT1833140000000,18,33140,"Michigan City-La Porte, IN MSA",2024,3,51603,49367,2236,4.3
MT1834620000000,18,34620,"Muncie, IN MSA",2024,3,52340,49960,2380,4.5
MT1843780000000,18,43780,"South Bend-Mishawaka, IN-MI MSA",2024,3,153205,146025,7180,4.7
MT1845460000000,18,45460,"Terre Haute, IN MSA",2024,3,77184,74003,3181,4.1
MT1911180000000,19,11180,"Ames, IA MSA",2024,3,69440,67867,1573,2.3
MT1916300000000,19,16300,"Cedar Rapids, IA MSA",2024,3,146361,141747,4614,3.2
MT1919780000000,19,19780,"Des Moines-West Des Moines, IA MSA",2024,3,412546,401548,10998,2.7
MT1920220000000,19,20220,"Dubuque, IA MSA",2024,3,53284,51785,1499,2.8
MT1926980000000,19,26980,"Iowa City, IA MSA",2024,3,99460,97193,2267,2.3
MT1943580000000,19,43580,"Sioux City, IA-NE-SD MSA",2024,3,76496,74448,2048,2.7
MT1947940000000,19,47940,"Waterloo-Cedar Falls, IA MSA",2024,3,87881,85323,2558,2.9
MT2029940000000,20,29940,"Lawrence, KS MSA",2024,3,70839,68680,2159,3
MT2031740000000,20,31740,"Manhattan, KS MSA",2024,3,63858,61856,2002,3.1
MT2045820000000,20,45820,"Topeka, KS MSA",2024,3,118309,114338,3971,3.4
MT2048620000000,20,48620,"Wichita, KS MSA",2024,3,334720,322865,11855,3.5
MT2114540000000,21,14540,"Bowling Green, KY MSA",2024,3,91966,87814,4152,4.5
MT2121060000000,21,21060,"Elizabethtown, KY MSA",2024,3,55508,52884,2624,4.7
MT2130460000000,21,30460,"Lexington-Fayette, KY MSA",2024,3,276657,265544,11113,4
MT2131140000000,21,31140,"Louisville/Jefferson County, KY-IN MSA",2024,3,695599,666311,29288,4.2
MT2136980000000,21,36980,"Owensboro, KY MSA",2024,3,51702,49282,2420,4.7
MT2137140000000,21,37140,"Paducah, KY-IL MSA",2024,3,45917,43711,2206,4.8
MT2210780000000,22,10780,"Alexandria, LA MSA",2024,3,64221,61647,2574,4
MT2212940000000,22,12940,"Baton Rouge, LA MSA",2024,3,429650,412817,16833,3.9
MT2225220000000,22,25220,"Hammond, LA MSA",2024,3,60851,58032,2819,4.6
MT2226380000000,22,26380,"Houma-Bayou Cane-Thibodaux, LA MSA",2024,3,87774,84594,3180,3.6
MT2229180000000,22,29180,"Lafayette, LA MSA",2024,3,197700,190507,7193,3.6
MT2229340000000,22,29340,"Lake Charles, LA MSA",2024,3,98453,94271,4182,4.2
MT2233740000000,22,33740,"Monroe, LA MSA",2024,3,95964,91437,4527,4.7
MT2235380000000,22,35380,"New Orleans-Metairie, LA MSA",2024,3,467127,447106,20021,4.3
MT2243340000000,22,43340,"Shreveport-Bossier City, LA MSA",2024,3,167836,160577,7259,4.3
MT2243640000000,22,43640,"Slidell-Mandeville-Covington, LA MSA",2024,3,129022,124210,4812,3.7
MT2312620000000,23,12620,"Bangor, ME MSA",2024,3,75350,73147,2203,2.9
MT2330340000000,23,30340,"Lewiston-Auburn, ME MSA",2024,3,55284,53711,1573,2.8
MT2338860000000,23,38860,"Portland-South Portland, ME MSA",2024,3,312535,305243,7292,2.3
MT2412580000000,24,12580,"Baltimore-Columbia-Towson, MD MSA",2024,3,1497980,1454757,43223,2.9
MT2425180000000,24,25180,"Hagerstown-Martinsburg, MD-WV MSA",2024,3,144197,139576,4621,3.2
MT2430500000000,24,30500,"Lexington Park, MD MSA",2024,3,109066,106301,2765,2.5
MT2441540000000,24,41540,"Salisbury, MD MSA",2024,3,64353,62268,2085,3.2
MT2511200000000,25,11200,"Amherst Town-Northampton, MA MSA",2024,3,85515,82455,3060,3.6
MT2512700000000,25,12700,"Barnstable Town, MA MSA",2024,3,116134,110710,5424,4.7
MT2514460000000,25,14460,"Boston-Cambridge-Newton, MA-NH MSA",2024,3,2822335,2723385,98950,3.5
MT2538340000000,25,38340,"Pittsfield, MA MSA",2024,3,64322,61854,2468,3.8
MT2544140000000,25,44140,"Springfield, MA MSA",2024,3,224028,213081,10947,4.9
MT2549340000000,25,49340,"Worcester, MA MSA",2024,3,464534,446358,18176,3.9
MT2611460000000,26,11460,"Ann Arbor, MI MSA",2024,3,207177,200136,7041,3.4
MT2612980000000,26,12980,"Battle Creek, MI MSA",2024,3,63169,60218,2951,4.7
MT2613020000000,26,13020,"Bay City, MI MSA",2024,3,50191,47645,2546,5.1
MT2619820000000,26,19820,"Detroit-Warren-Dearborn, MI MSA",2024,3,2182632,2096324,86308,4
MT2622420000000,26,22420,"Flint, MI MSA",2024,3,188244,178474,9770,5.2
MT2624340000000,26,24340,"Grand Rapids-Wyoming-Kentwood, MI MSA",2024,3,628273,606090,22183,3.5
MT2627100000000,26,27100,"Jackson, MI MSA",2024,3,74883,71651,3232,4.3
MT2628020000000,26,28020,"Kalamazoo-Portage, MI MSA",2024,3,140118,134877,5241,3.7
MT2629620000000,26,29620,"Lansing-East Lansing, MI MSA",2024,3,254071,243780,10291,4.1
MT2633220000000,26,33220,"Midland, MI MSA",2024,3,42712,41022,1690,4
MT2633780000000,26,33780,"Monroe, MI MSA",2024,3,79159,75661,3498,4.4
MT2634740000000,26,34740,"Muskegon-Norton Shores, MI MSA",2024,3,84842,80997,3845,4.5
MT2635660000000,26,35660,"Niles, MI MSA",2024,3,76973,73533,3440,4.5
MT2640980000000,26,40980,"Saginaw, MI MSA",2024,3,84936,80385,4551,5.4
MT2645900000000,26,45900,"Traverse City, MI MSA",2024,3,81452,78353,3099,3.8
MT2720260000000,27,20260,"Duluth, MN-WI MSA",2024,3,140381,135452,4929,3.5
MT2731860000000,27,31860,"Mankato, MN MSA",2024,3,60463,58912,1551,2.6
MT2733460000000,27,33460,"Minneapolis-St. Paul-Bloomington, MN-WI MSA",2024,3,2069000,2010196,58804,2.8
MT2740340000000,27,40340,"Rochester, MN MSA",2024,3,126687,123663,3024,2.4
MT2741060000000,27,41060,"St. Cloud, MN MSA",2024,3,110181,106857,3324,3
MT2825060000000,28,25060,"Gulfport-Biloxi, MS MSA",2024,3,185967,181245,4722,2.5
MT2825620000000,28,25620,"Hattiesburg, MS MSA",2024,3,69979,68199,1780,2.5
MT2827140000000,28,27140,"Jackson, MS MSA",2024,3,278954,272069,6885,2.5
MT2916020000000,29,16020,"Cape Girardeau, MO-IL MSA",2024,3,49192,47525,1667,3.4
MT2917860000000,29,17860,"Columbia, MO MSA",2024,3,112670,109190,3480,3.1
MT2927620000000,29,27620,"Jefferson City, MO MSA",2024,3,76177,73837,2340,3.1
MT2927900000000,29,27900,"Joplin, MO-KS MSA",2024,3,97909,94402,3507,3.6
MT2928140000000,29,28140,"Kansas City, MO-KS MSA",2024,3,1195429,1153549,41880,3.5
MT2941140000000,29,41140,"St. Joseph, MO-KS MSA",2024,3,54289,52326,1963,3.6
MT2941180000000,29,41180,"St. Louis, MO-IL MSA",2024,3,1482597,1427722,54875,3.7
MT2944180000000,29,44180,"Springfield, MO MSA",2024,3,242379,234394,7985,3.3
MT3013740000000,30,13740,"Billings, MT MSA",2024,3,99061,96298,2763,2.8
MT3014580000000,30,14580,"Bozeman, MT MSA",2024,3,77950,76191,1759,2.3
MT3024500000000,30,24500,"Great Falls, MT MSA",2024,3,39973,38790,1183,3
MT3025740000000,30,25740,"Helena, MT MSA",2024,3,47714,46385,1329,2.8
MT3033540000000,30,33540,"Missoula, MT MSA",2024,3,74009,71856,2153,2.9
MT3124260000000,31,24260,"Grand Island, NE MSA",2024,3,42889,41782,1107,2.6
MT3130700000000,31,30700,"Lincoln, NE MSA",2024,3,192826,188307,4519,2.3
MT3136540000000,31,36540,"Omaha, NE-IA MSA",2024,3,525627,510886,14741,2.8
MT3216180000000,32,16180,"Carson City, NV MSA",2024,3,28950,27672,1278,4.4
MT3229820000000,32,29820,"Las Vegas-Henderson-North Las Vegas, NV MSA",2024,3,1212422,1144912,67510,5.6
MT3239900000000,32,39900,"Reno, NV MSA",2024,3,297260,283654,13606,4.6
MT3331700000000,33,31700,"Manchester-Nashua, NH MSA",2024,3,240170,234044,6126,2.6
MT3412100000000,34,12100,"Atlantic City-Hammonton, NJ MSA",2024,3,180054,169254,10800,6
MT3445940000000,34,45940,"Trenton-Princeton, NJ MSA",2024,3,199567,191106,8461,4.2
MT3447220000000,34,47220,"Vineland, NJ MSA",2024,3,65235,60772,4463,6.8
MT3510740000000,35,10740,"Albuquerque, NM MSA",2024,3,461330,444756,16574,3.6
MT3522140000000,35,22140,"Farmington, NM MSA",2024,3,49778,47580,2198,4.4
MT3529740000000,35,29740,"Las Cruces, NM MSA",2024,3,102164,97389,4775,4.7
MT3542140000000,35,42140,"Santa Fe, NM MSA",2024,3,73829,71364,2465,3.3
MT3610580000000,36,10580,"Albany-Schenectady-Troy, NY MSA",2024,3,457218,441842,15376,3.4
MT3613780000000,36,13780,"Binghamton, NY MSA",2024,3,106879,102789,4090,3.8
MT3615380000000,36,15380,"Buffalo-Cheektowaga, NY MSA",2024,3,559886,538017,21869,3.9
MT3621300000000,36,21300,"Elmira, NY MSA",2024,3,35431,34125,1306,3.7
MT3624020000000,36,24020,"Glens Falls, NY MSA",2024,3,59487,57358,2129,3.6
MT3627060000000,36,27060,"Ithaca, NY MSA",2024,3,48226,46645,1581,3.3
MT3628740000000,36,28740,"Kingston, NY MSA",2024,3,87333,84187,3146,3.6
MT3628880000000,36,28880,"Kiryas Joel-Poughkeepsie-Newburgh, NY MSA",2024,3,340163,328232,11931,3.5
MT3635620000000,36,35620,"New York-Newark-Jersey City, NY-NJ MSA",2024,3,10183409,9743875,439534,4.3
MT3640380000000,36,40380,"Rochester, NY MSA",2024,3,513603,494543,19060,3.7
MT3645060000000,36,45060,"Syracuse, NY MSA",2024,3,310215,298875,11340,3.7
MT3646540000000,36,46540,"Utica-Rome, NY MSA",2024,3,127757,122903,4854,3.8
MT3648060000000,36,48060,"Watertown-Fort Drum, NY MSA",2024,3,44865,42851,2014,4.5
MT3711700000000,37,11700,"Asheville, NC MSA",2024,3,212027,205975,6052,2.9
MT3715500000000,37,15500,"Burlington, NC MSA",2024,3,86067,83014,3053,3.5
MT3716740000000,37,16740,"Charlotte-Concord-Gastonia, NC-SC MSA",2024,3,1477685,1425315,52370,3.5
MT3720500000000,37,20500,"Durham-Chapel Hill, NC MSA",2024,3,322629,312282,10347,3.2
MT3722180000000,37,22180,"Fayetteville, NC MSA",2024,3,154745,147819,6926,4.5
MT3724140000000,37,24140,"Goldsboro, NC MSA",2024,3,50645,48787,1858,3.7
MT3724660000000,37,24660,"Greensboro-High Point, NC MSA",2024,3,373926,359095,14831,4
MT3724780000000,37,24780,"Greenville, NC MSA",2024,3,84171,80719,3452,4.1
MT3725860000000,37,25860,"Hickory-Lenoir-Morganton, NC MSA",2024,3,170952,165082,5870,3.4
MT3727340000000,37,27340,"Jacksonville, NC MSA",2024,3,74326,71538,2788,3.8
MT3738240000000,37,38240,"Pinehurst-Southern Pines, NC MSA",2024,3,44913,43393,1520,3.4
MT3739580000000,37,39580,"Raleigh-Cary, NC MSA",2024,3,844962,818445,26517,3.1
MT3740580000000,37,40580,"Rocky Mount, NC MSA",2024,3,63832,60843,2989,4.7
MT3748900000000,37,48900,"Wilmington, NC MSA",2024,3,222694,214856,7838,3.5
MT3749180000000,37,49180,"Winston-Salem, NC MSA",2024,3,324362,312724,11638,3.6
MT3813900000000,38,13900,"Bismarck, ND MSA",2024,3,72762,71193,1569,2.2
MT3822020000000,38,22020,"Fargo, ND-MN MSA",2024,3,153663,150340,3323,2.2
MT3824220000000,38,24220,"Grand Forks, ND-MN MSA",2024,3,56297,55026,1271,2.3
MT3833500000000,38,33500,"Minot, ND MSA",2024,3,40345,39430,915,2.3
MT3910420000000,39,10420,"Akron, OH MSA",2024,3,360616,345522,15094,4.2
MT3915940000000,39,15940,"Canton-Massillon, OH MSA",2024,3,194614,186276,8338,4.3
MT3917140000000,39,17140,"Cincinnati, OH-KY-IN MSA",2024,3,1168995,1122014,46981,4
MT3917410000000,39,17410,"Cleveland, OH MSA",2024,3,1093505,1052338,41167,3.8
MT3918140000000,39,18140,"Columbus, OH MSA",2024,3,1153085,1109461,43624,3.8
MT3919430000000,39,19430,"Dayton-Kettering-Beavercreek, OH MSA",2024,3,394856,378679,16177,4.1
MT3930620000000,39,30620,"Lima, OH MSA",2024,3,47516,45553,1963,4.1
MT3931900000000,39,31900,"Mansfield, OH MSA",2024,3,53522,50957,2565,4.8
MT3941780000000,39,41780,"Sandusky, OH MSA",2024,3,57239,54414,2825,4.9
MT3944220000000,39,44220,"Springfield, OH MSA",2024,3,62241,59593,2648,4.3
MT3945780000000,39,45780,"Toledo, OH MSA",2024,3,296487,282557,13930,4.7
MT3948260000000,39,48260,"Weirton-Steubenville, WV-OH MSA",2024,3,51985,49160,2825,5.4
MT3949660000000,39,49660,"Youngstown-Warren, OH MSA",2024,3,192972,183652,9320,4.8
MT4021420000000,40,21420,"Enid, OK MSA",2024,3,28324,27365,959,3.4
MT4030020000000,40,30020,"Lawton, OK MSA",2024,3,52470,50551,1919,3.7
MT4036420000000,40,36420,"Oklahoma City, OK MSA",2024,3,773673,749846,23827,3.1
MT4046140000000,40,46140,"Tulsa, OK MSA",2024,3,524306,506899,17407,3.3
MT4110540000000,41,10540,"Albany, OR MSA",2024,3,61390,58608,2782,4.5
MT4113460000000,41,13460,"Bend, OR MSA",2024,3,133521,127946,5575,4.2
MT4118700000000,41,18700,"Corvallis, OR MSA",2024,3,49703,47963,1740,3.5
MT4121660000000,41,21660,"Eugene-Springfield, OR MSA",2024,3,188430,180604,7826,4.2
MT4124420000000,41,24420,"Grants Pass, OR MSA",2024,3,35234,33302,1932,5.5
MT4132780000000,41,32780,"Medford, OR MSA",2024,3,106327,101224,5103,4.8
MT4138900000000,41,38900,"Portland-Vancouver-Hillsboro, OR-WA MSA",2024,3,1381536,1327595,53941,3.9
MT4141420000000,41,41420,"Salem, OR MSA",2024,3,220687,211890,8797,4
MT4210900000000,42,10900,"Allentown-Bethlehem-Easton, PA-NJ MSA",2024,3,452983,435467,17516,3.9
MT4211020000000,42,11020,"Altoona, PA MSA",2024,3,57709,55735,1974,3.4
MT4216540000000,42,16540,"Chambersburg, PA MSA",2024,3,76785,74449,2336,3
MT4221500000000,42,21500,"Erie, PA MSA",2024,3,127592,122802,4790,3.8
MT4223900000000,42,23900,"Gettysburg, PA MSA",2024,3,51959,50381,1578,3
MT4225420000000,42,25420,"Harrisburg-Carlisle, PA MSA",2024,3,314605,304454,10151,3.2
MT4227780000000,42,27780,"Johnstown, PA MSA",2024,3,57158,54791,2367,4.1
MT4229540000000,42,29540,"Lancaster, PA MSA",2024,3,293369,285026,8343,2.8
MT4230140000000,42,30140,"Lebanon, PA MSA",2024,3,73499,71218,2281,3.1
MT4237980000000,42,37980,"Philadelphia-Camden-Wilmington, PA-NJ-DE-MD MSA",2024,3,3306930,3182704,124226,3.8
MT4238300000000,42,38300,"Pittsburgh, PA MSA",2024,3,1245159,1201295,43864,3.5
MT4239740000000,42,39740,"Reading, PA MSA",2024,3,219653,211533,8120,3.7
MT4242540000000,42,42540,"Scranton--Wilkes-Barre, PA MSA",2024,3,281910,269956,11954,4.2
MT4244300000000,42,44300,"State College, PA MSA",2024,3,77319,75121,2198,2.8
MT4248700000000,42,48700,"Williamsport, PA MSA",2024,3,53299,51256,2043,3.8
MT4249620000000,42,49620,"York-Hanover, PA MSA",2024,3,241485,233530,7955,3.3
MT4439300000000,44,39300,"Providence-Warwick, RI-MA MSA",2024,3,900175,861984,38191,4.2
MT4516700000000,45,16700,"Charleston-North Charleston, SC MSA",2024,3,441048,427081,13967,3.2
MT4517900000000,45,17900,"Columbia, SC MSA",2024,3,417191,401787,15404,3.7
MT4522500000000,45,22500,"Florence, SC MSA",2024,3,92056,88226,3830,4.2
MT4524860000000,45,24860,"Greenville-Anderson-Greer, SC MSA",2024,3,478197,461754,16443,3.4
MT4525940000000,45,25940,"Hilton Head Island-Bluffton-Port Royal, SC MSA",2024,3,97381,93986,3395,3.5
MT4534820000000,45,34820,"Myrtle Beach-Conway-North Myrtle Beach, SC MSA",2024,3,170398,162966,7432,4.4
MT4543900000000,45,43900,"Spartanburg, SC MSA",2024,3,175937,169224,6713,3.8
MT4544940000000,45,44940,"Sumter, SC MSA",2024,3,41712,39787,1925,4.6
MT4639660000000,46,39660,"Rapid City, SD MSA",2024,3,78913,77555,1358,1.7
MT4643620000000,46,43620,"Sioux Falls, SD-MN MSA",2024,3,173460,170675,2785,1.6
MT4716860000000,47,16860,"Chattanooga, TN-GA MSA",2024,3,290327,281803,8524,2.9
MT4717300000000,47,17300,"Clarksville, TN-KY MSA",2024,3,137863,132600,5263,3.8
MT4717420000000,47,17420,"Cleveland, TN MSA",2024,3,56387,54480,1907,3.4
MT4727180000000,47,27180,"Jackson, TN MSA",2024,3,78222,75516,2706,3.5
MT4727740000000,47,27740,"Johnson City, TN MSA",2024,3,96584,93572,3012,3.1
MT4728700000000,47,28700,"Kingsport-Bristol, TN-VA MSA",2024,3,132504,128183,4321,3.3
MT4728940000000,47,28940,"Knoxville, TN MSA",2024,3,449910,436856,13054,2.9
MT4732820000000,47,32820,"Memphis, TN-MS-AR MSA",2024,3,624885,601556,23329,3.7
MT4734100000000,47,34100,"Morristown, TN MSA",2024,3,53236,51534,1702,3.2
MT4734980000000,47,34980,"Nashville-Davidson--Murfreesboro--Franklin, TN MSA",2024,3,1155690,1126009,29681,2.6
MT4810180000000,48,10180,"Abilene, TX MSA",2024,3,86156,83229,2927,3.4
MT4811100000000,48,11100,"Amarillo, TX MSA",2024,3,136707,132478,4229,3.1
MT4812420000000,48,12420,"Austin-Round Rock-San Marcos, TX MSA",2024,3,1489687,1438217,51470,3.5
MT4813140000000,48,13140,"Beaumont-Port Arthur, TX MSA",2024,3,180346,170914,9432,5.2
MT4815180000000,48,15180,"Brownsville-Harlingen, TX MSA",2024,3,187966,178383,9583,5.1
MT4817780000000,48,17780,"College Station-Bryan, TX MSA",2024,3,149908,144813,5095,3.4
MT4818580000000,48,18580,"Corpus Christi, TX MSA",2024,3,208474,199538,8936,4.3
MT4819100000000,48,19100,"Dallas-Fort Worth-Arlington, TX MSA",2024,3,4454423,4284206,170217,3.8
MT4820580000000,48,20580,"Eagle Pass, TX MSA",2024,3,23673,21871,1802,7.6
MT4821340000000,48,21340,"El Paso, TX MSA",2024,3,411098,394158,16940,4.1
MT4826420000000,48,26420,"Houston-Pasadena-The Woodlands, TX MSA",2024,3,3803890,3644669,159221,4.2
MT4828660000000,48,28660,"Killeen-Temple, TX MSA",2024,3,201716,193255,8461,4.2
MT4829700000000,48,29700,"Laredo, TX MSA",2024,3,117660,112741,4919,4.2
MT4830980000000,48,30980,"Longview, TX MSA",2024,3,129012,123151,5861,4.5
MT4831180000000,48,31180,"Lubbock, TX MSA",2024,3,183813,177592,6221,3.4
MT4832580000000,48,32580,"McAllen-Edinburg-Mission, TX MSA",2024,3,392459,369663,22796,5.8
MT4833260000000,48,33260,"Midland, TX MSA",2024,3,103069,100172,2897,2.8
MT4836220000000,48,36220,"Odessa, TX MSA",2024,3,85777,82900,2877,3.4
MT4841660000000,48,41660,"San Angelo, TX MSA",2024,3,61735,59787,1948,3.2
MT4841700000000,48,41700,"San Antonio-New Braunfels, TX MSA",2024,3,1324429,1275631,48798,3.7
MT4843300000000,48,43300,"Sherman-Denison, TX MSA",2024,3,71014,68359,2655,3.7
MT4845500000000,48,45500,"Texarkana, TX-AR MSA",2024,3,61538,59027,2511,4.1
MT4846340000000,48,46340,"Tyler, TX MSA",2024,3,117304,112857,4447,3.8
MT4847020000000,48,47020,"Victoria, TX MSA",2024,3,44867,43097,1770,3.9
MT4847380000000,48,47380,"Waco, TX MSA",2024,3,145397,139956,5441,3.7
MT4848660000000,48,48660,"Wichita Falls, TX MSA",2024,3,66744,64240,2504,3.8
MT4930860000000,49,30860,"Logan, UT-ID MSA",2024,3,79352,77242,2110,2.7
MT4936260000000,49,36260,"Ogden, UT MSA",2024,3,350457,340351,10106,2.9
MT4939340000000,49,39340,"Provo-Orem-Lehi, UT MSA",2024,3,368851,357511,11340,3.1
MT4941100000000,49,41100,"St. George, UT MSA",2024,3,92845,89887,2958,3.2
MT4941620000000,49,41620,"Salt Lake City-Murray, UT MSA",2024,3,735545,712925,22620,3.1
MT5015540000000,50,15540,"Burlington-South Burlington, VT MSA",2024,3,130962,128592,2370,1.8
MT5113980000000,51,13980,"Blacksburg-Christiansburg-Radford, VA MSA",2024,3,93495,90824,2671,2.9
MT5116820000000,51,16820,"Charlottesville, VA MSA",2024,3,120735,117780,2955,2.4
MT5125500000000,51,25500,"Harrisonburg, VA MSA",2024,3,72767,70797,1970,2.7
MT5131340000000,51,31340,"Lynchburg, VA MSA",2024,3,127994,123972,4022,3.1
MT5140060000000,51,40060,"Richmond, VA MSA",2024,3,726829,705911,20918,2.9
MT5140220000000,51,40220,"Roanoke, VA MSA",2024,3,158492,154003,4489,2.8
MT5144420000000,51,44420,"Staunton-Stuarts Draft, VA MSA",2024,3,65736,64146,1590,2.4
MT5147260000000,51,47260,"Virginia Beach-Chesapeake-Norfolk, VA-NC MSA",2024,3,883192,856881,26311,3
MT5149020000000,51,49020,"Winchester, VA-WV MSA",2024,3,77598,75571,2027,2.6
MT5313380000000,53,13380,"Bellingham, WA MSA",2024,3,114290,109215,5075,4.4
MT5314740000000,53,14740,"Bremerton-Silverdale-Port Orchard, WA MSA",2024,3,122297,116819,5478,4.5
MT5328420000000,53,28420,"Kennewick-Richland, WA MSA",2024,3,146017,138822,7195,4.9
MT5331020000000,53,31020,"Longview-Kelso, WA MSA",2024,3,47144,44700,2444,5.2
MT5334580000000,53,34580,"Mount Vernon-Anacortes, WA MSA",2024,3,59273,56374,2899,4.9
MT5336500000000,53,36500,"Olympia-Lacey-Tumwater, WA MSA",2024,3,143378,136915,6463,4.5
MT5342660000000,53,42660,"Seattle-Tacoma-Bellevue, WA MSA",2024,3,2314996,2214314,100682,4.3
MT5344060000000,53,44060,"Spokane-Spokane Valley, WA MSA",2024,3,282457,269913,12544,4.4
MT5347460000000,53,47460,"Walla Walla, WA MSA",2024,3,29480,28216,1264,4.3
MT5348300000000,53,48300,"Wenatchee-East Wenatchee, WA MSA",2024,3,62393,59451,2942,4.7
MT5349420000000,53,49420,"Yakima, WA MSA",2024,3,126135,118772,7363,5.8
MT5413220000000,54,13220,"Beckley, WV MSA",2024,3,46357,44566,1791,3.9
MT5416620000000,54,16620,"Charleston, WV MSA",2024,3,91285,87736,3549,3.9
MT5426580000000,54,26580,"Huntington-Ashland, WV-KY-OH MSA",2024,3,157106,149481,7625,4.9
MT5434060000000,54,34060,"Morgantown, WV MSA",2024,3,71153,68714,2439,3.4
MT5437620000000,54,37620,"Parkersburg-Vienna, WV MSA",2024,3,39472,37781,1691,4.3
MT5448540000000,54,48540,"Wheeling, WV-OH MSA",2024,3,59613,56901,2712,4.5
MT5511540000000,55,11540,"Appleton, WI MSA",2024,3,137289,134029,3260,2.4
MT5520740000000,55,20740,"Eau Claire, WI MSA",2024,3,96279,93622,2657,2.8
MT5522540000000,55,22540,"Fond du Lac, WI MSA",2024,3,55814,54391,1423,2.5
MT5524580000000,55,24580,"Green Bay, WI MSA",2024,3,178622,174028,4594,2.6
MT5527500000000,55,27500,"Janesville-Beloit, WI MSA",2024,3,86895,84155,2740,3.2
MT5528450000000,55,28450,"Kenosha, WI MSA",2024,3,95746,92736,3010,3.1
MT5529100000000,55,29100,"La Crosse-Onalaska, WI-MN MSA",2024,3,90308,88048,2260,2.5
MT5531540000000,55,31540,"Madison, WI MSA",2024,3,410002,400892,9110,2.2
MT5533340000000,55,33340,"Milwaukee-Waukesha, WI MSA",2024,3,817682,791863,25819,3.2
MT5536780000000,55,36780,"Oshkosh-Neenah, WI MSA",2024,3,93292,90875,2417,2.6
MT5539540000000,55,39540,"Racine-Mount Pleasant, WI MSA",2024,3,101821,98387,3434,3.4
MT5543100000000,55,43100,"Sheboygan, WI MSA",2024,3,63520,62019,1501,2.4
MT5548140000000,55,48140,"Wausau, WI MSA",2024,3,75480,73543,1937,2.6
MT5616220000000,56,16220,"Casper, WY MSA",2024,3,42027,40788,1239,2.9
MT5616940000000,56,16940,"Cheyenne, WY MSA",2024,3,48953,47424,1529,3.1
MT7210380000000,72,10380,"Aguadilla, PR MSA",2024,3,90365,84041,6324,7
MT7211640000000,72,11640,"Arecibo, PR MSA",2024,3,67459,63633,3826,5.7
MT7225020000000,72,25020,"Guayama, PR MSA",2024,3,19163,17289,1874,9.8
MT7232420000000,72,32420,"Mayaguez, PR MSA",2024,3,66959,62220,4739,7.1
MT7238660000000,72,38660,"Ponce, PR MSA",2024,3,89374,81216,8158,9.1
MT7241980000000,72,41980,"San Juan-Bayamon-Caguas, PR MSA",2024,3,810905,771377,39528,4.9
MT0111500000000,1,11500,"Anniston-Oxford, AL MSA",2024,4,49269,47804,1465,3
MT0112220000000,1,12220,"Auburn-Opelika, AL MSA",2024,4,96515,93812,2703,2.8
MT0113820000000,1,13820,"Birmingham, AL MSA",2024,4,570796,555535,15261,2.7
MT0119300000000,1,19300,"Daphne-Fairhope-Foley, AL MSA",2024,4,115466,112479,2987,2.6
MT0119460000000,1,19460,"Decatur, AL MSA",2024,4,75318,73515,1803,2.4
MT0120020000000,1,20020,"Dothan, AL MSA",2024,4,67503,65574,1929,2.9
MT0122520000000,1,22520,"Florence-Muscle Shoals, AL MSA",2024,4,68677,66607,2070,3
MT0123460000000,1,23460,"Gadsden, AL MSA",2024,4,41930,40679,1251,3
MT0126620000000,1,26620,"Huntsville, AL MSA",2024,4,274784,268271,6513,2.4
MT0133660000000,1,33660,"Mobile, AL MSA",2024,4,184918,178189,6729,3.6
MT0133860000000,1,33860,"Montgomery, AL MSA",2024,4,177952,172752,5200,2.9
MT0146220000000,1,46220,"Tuscaloosa, AL MSA",2024,4,126288,122489,3799,3
MT0211260000000,2,11260,"Anchorage, AK MSA",2024,4,200249,192155,8094,4
MT0221820000000,2,21820,"Fairbanks-College, AK MSA",2024,4,45569,43821,1748,3.8
MT0422380000000,4,22380,"Flagstaff, AZ MSA",2024,4,75625,72938,2687,3.6
MT0429420000000,4,29420,"Lake Havasu City-Kingman, AZ MSA",2024,4,87408,83712,3696,4.2
MT0438060000000,4,38060,"Phoenix-Mesa-Chandler, AZ MSA",2024,4,2702080,2621239,80841,3
MT0439150000000,4,39150,"Prescott Valley-Prescott, AZ MSA",2024,4,106346,102806,3540,3.3
MT0443420000000,4,43420,"Sierra Vista-Douglas, AZ MSA",2024,4,48205,46227,1978,4.1
MT0446060000000,4,46060,"Tucson, AZ MSA",2024,4,490810,474328,16482,3.4
MT0449740000000,4,49740,"Yuma, AZ MSA",2024,4,98425,86754,11671,11.9
MT0522220000000,5,22220,"Fayetteville-Springdale-Rogers, AR MSA",2024,4,304453,296464,7989,2.6
MT0522900000000,5,22900,"Fort Smith, AR-OK MSA",2024,4,101032,97515,3517,3.5
MT0526300000000,5,26300,"Hot Springs, AR MSA",2024,4,43662,42107,1555,3.6
MT0527860000000,5,27860,"Jonesboro, AR MSA",2024,4,66125,64072,2053,3.1
MT0530780000000,5,30780,"Little Rock-North Little Rock-Conway, AR MSA",2024,4,378597,366448,12149,3.2
MT0612540000000,6,12540,"Bakersfield-Delano, CA MSA",2024,4,405361,370370,34991,8.6
MT0617020000000,6,17020,"Chico, CA MSA",2024,4,91297,86015,5282,5.8
MT0620940000000,6,20940,"El Centro, CA MSA",2024,4,72703,59546,13157,18.1
MT0623420000000,6,23420,"Fresno, CA MSA",2024,4,536298,494131,42167,7.9
MT0625260000000,6,25260,"Hanford-Corcoran, CA MSA",2024,4,58035,52921,5114,8.8
MT0631080000000,6,31080,"Los Angeles-Long Beach-Anaheim, CA MSA",2024,4,6713654,6370960,342694,5.1
MT0632900000000,6,32900,"Merced, CA MSA",2024,4,119807,108120,11687,9.8
MT0633700000000,6,33700,"Modesto, CA MSA",2024,4,251362,234271,17091,6.8
MT0634900000000,6,34900,"Napa, CA MSA",2024,4,73751,70917,2834,3.8
MT0637100000000,6,37100,"Oxnard-Thousand Oaks-Ventura, CA MSA",2024,4,420471,401612,18859,4.5
MT0639820000000,6,39820,"Redding, CA MSA",2024,4,78736,74618,4118,5.2
MT0640140000000,6,40140,"Riverside-San Bernardino-Ontario, CA MSA",2024,4,2198524,2086732,111792,5.1
MT0640900000000,6,40900,"Sacramento-Roseville-Folsom, CA MSA",2024,4,1176700,1123577,53123,4.5
MT0641500000000,6,41500,"Salinas, CA MSA",2024,4,219988,203954,16034,7.3
MT0641740000000,6,41740,"San Diego-Chula Vista-Carlsbad, CA MSA",2024,4,1645439,1576818,68621,4.2
MT0641860000000,6,41860,"San Francisco-Oakland-Fremont, CA MSA",2024,4,2501881,2400491,101390,4.1
MT0641940000000,6,41940,"San Jose-Sunnyvale-Santa Clara, CA MSA",2024,4,1056364,1013244,43120,4.1
MT0642020000000,6,42020,"San Luis Obispo-Paso Robles, CA MSA",2024,4,132417,127205,5212,3.9
MT0642100000000,6,42100,"Santa Cruz-Watsonville, CA MSA",2024,4,135811,127928,7883,5.8
MT0642200000000,6,42200,"Santa Maria-Santa Barbara, CA MSA",2024,4,221035,211353,9682,4.4
MT0642220000000,6,42220,"Santa Rosa-Petaluma, CA MSA",2024,4,246879,237022,9857,4
MT0644700000000,6,44700,"Stockton-Lodi, CA MSA",2024,4,366127,342968,23159,6.3
MT0646700000000,6,46700,"Vallejo, CA MSA",2024,4,216445,206087,10358,4.8
MT0647300000000,6,47300,"Visalia, CA MSA",2024,4,220295,197604,22691,10.3
MT0649700000000,6,49700,"Yuba City, CA MSA",2024,4,80818,74572,6246,7.7
MT0814500000000,8,14500,"Boulder, CO MSA",2024,4,193755,186199,7556,3.9
MT0817820000000,8,17820,"Colorado Springs, CO MSA",2024,4,394056,378486,15570,4
MT0819740000000,8,19740,"Denver-Aurora-Centennial, CO MSA",2024,4,1768610,1699374,69236,3.9
MT0822660000000,8,22660,"Fort Collins-Loveland, CO MSA",2024,4,208531,200686,7845,3.8
MT0824300000000,8,24300,"Grand Junction, CO MSA",2024,4,79531,76266,3265,4.1
MT0824540000000,8,24540,"Greeley, CO MSA",2024,4,177405,170041,7364,4.2
MT0839380000000,8,39380,"Pueblo, CO MSA",2024,4,73462,69465,3997,5.4
MT0914860000000,9,14860,"Bridgeport-Stamford-Danbury, CT MSA",2024,4,515362,499774,15588,3
MT0925540000000,9,25540,"Hartford-West Hartford-East Hartford, CT MSA",2024,4,611041,591894,19147,3.1
MT0935300000000,9,35300,"New Haven, CT MSA",2024,4,315774,305869,9905,3.1
MT0935980000000,9,35980,"Norwich-New London-Willimantic, CT MSA",2024,4,142337,137990,4347,3.1
MT0947930000000,9,47930,"Waterbury-Shelton, CT MSA",2024,4,239587,231094,8493,3.5
MT1020100000000,10,20100,"Dover, DE MSA",2024,4,85236,81763,3473,4.1
MT1147900000000,11,47900,"Washington-Arlington-Alexandria, DC-VA-MD-WV MSA",2024,4,3548589,3445228,103361,2.9
MT1215980000000,12,15980,"Cape Coral-Fort Myers, FL MSA",2024,4,376464,363480,12984,3.4
MT1218880000000,12,18880,"Crestview-Fort Walton Beach-Destin, FL MSA",2024,4,142345,138043,4302,3
MT1219660000000,12,19660,"Deltona-Daytona Beach-Ormond Beach, FL MSA",2024,4,322537,310466,12071,3.7
MT1223540000000,12,23540,"Gainesville, FL MSA",2024,4,169061,162757,6304,3.7
MT1226140000000,12,26140,"Homosassa Springs, FL MSA",2024,4,53536,50938,2598,4.9
MT1227260000000,12,27260,"Jacksonville, FL MSA",2024,4,854846,825837,29009,3.4
MT1229460000000,12,29460,"Lakeland-Winter Haven, FL MSA",2024,4,357292,342442,14850,4.2
MT1233100000000,12,33100,"Miami-Fort Lauderdale-West Palm Beach, FL MSA",2024,4,3310327,3217050,93277,2.8
MT1234940000000,12,34940,"Naples-Marco Island, FL MSA",2024,4,186198,180028,6170,3.3
MT1235840000000,12,35840,"North Port-Bradenton-Sarasota, FL MSA",2024,4,399599,385929,13670,3.4
MT1236100000000,12,36100,"Ocala, FL MSA",2024,4,158528,152061,6467,4.1
MT1236740000000,12,36740,"Orlando-Kissimmee-Sanford, FL MSA",2024,4,1532921,1483615,49306,3.2
MT1237340000000,12,37340,"Palm Bay-Melbourne-Titusville, FL MSA",2024,4,304655,294271,10384,3.4
MT1237460000000,12,37460,"Panama City-Panama City Beach, FL MSA",2024,4,101672,98302,3370,3.3
MT1237860000000,12,37860,"Pensacola-Ferry Pass-Brent, FL MSA",2024,4,240440,232073,8367,3.5
MT1238940000000,12,38940,"Port St. Lucie, FL MSA",2024,4,238908,229884,9024,3.8
MT1239460000000,12,39460,"Punta Gorda, FL MSA",2024,4,77514,74463,3051,3.9
MT1242680000000,12,42680,"Sebastian-Vero Beach-West Vero Corridor, FL MSA",2024,4,67997,65291,2706,4
MT1242700000000,12,42700,"Sebring, FL MSA",2024,4,36460,34710,1750,4.8
MT1245220000000,12,45220,"Tallahassee, FL MSA",2024,4,207365,200288,7077,3.4
MT1245300000000,12,45300,"Tampa-St. Petersburg-Clearwater, FL MSA",2024,4,1702172,1645344,56828,3.3
MT1248680000000,12,48680,"Wildwood-The Villages, FL MSA",2024,4,34012,32098,1914,5.6
MT1310500000000,13,10500,"Albany, GA MSA",2024,4,62378,59812,2566,4.1
MT1312020000000,13,12020,"Athens-Clarke County, GA MSA",2024,4,108420,104881,3539,3.3
MT1312060000000,13,12060,"Atlanta-Sandy Springs-Roswell, GA MSA",2024,4,3307553,3195844,111709,3.4
MT1312260000000,13,12260,"Augusta-Richmond County, GA-SC MSA",2024,4,268936,257715,11221,4.2
MT1315260000000,13,15260,"Brunswick-St. Simons, GA MSA",2024,4,55575,53870,1705,3.1
MT1317980000000,13,17980,"Columbus, GA-AL MSA",2024,4,128584,123530,5054,3.9
MT1319140000000,13,19140,"Dalton, GA MSA",2024,4,67465,64931,2534,3.8
MT1323580000000,13,23580,"Gainesville, GA MSA",2024,4,109127,106051,3076,2.8
MT1325980000000,13,25980,"Hinesville, GA MSA",2024,4,31200,29938,1262,4
MT1331420000000,13,31420,"Macon-Bibb County, GA MSA",2024,4,97172,93148,4024,4.1
MT1340660000000,13,40660,"Rome, GA MSA",2024,4,47672,46011,1661,3.5
MT1342340000000,13,42340,"Savannah, GA MSA",2024,4,210631,204209,6422,3
MT1346660000000,13,46660,"Valdosta, GA MSA",2024,4,61520,59169,2351,3.8
MT1347580000000,13,47580,"Warner Robins, GA MSA",2024,4,89852,86988,2864,3.2
MT1527980000000,15,27980,"Kahului-Wailuku, HI MSA",2024,4,81644,77972,3672,4.5
MT1546520000000,15,46520,"Urban Honolulu, HI MSA",2024,4,469673,457680,11993,2.6
MT1614260000000,16,14260,"Boise City, ID MSA",2024,4,444406,429128,15278,3.4
MT1617660000000,16,17660,"Coeur d'Alene, ID MSA",2024,4,89415,85578,3837,4.3
MT1626820000000,16,26820,"Idaho Falls, ID MSA",2024,4,84260,81632,2628,3.1
MT1630300000000,16,30300,"Lewiston, ID-WA MSA",2024,4,31144,30059,1085,3.5
MT1638540000000,16,38540,"Pocatello, ID MSA",2024,4,40905,39316,1589,3.9
MT1646300000000,16,46300,"Twin Falls, ID MSA",2024,4,59595,57561,2034,3.4
MT1714010000000,17,14010,"Bloomington, IL MSA",2024,4,97288,93452,3836,3.9
MT1716580000000,17,16580,"Champaign-Urbana, IL MSA",2024,4,125032,119520,5512,4.4
MT1716980000000,17,16980,"Chicago-Naperville-Elgin, IL-IN MSA",2024,4,4989899,4732952,256947,5.1
MT1719340000000,17,19340,"Davenport-Moline-Rock Island, IA-IL MSA",2024,4,189214,180993,8221,4.3
MT1719500000000,17,19500,"Decatur, IL MSA",2024,4,44924,42241,2683,6
MT1728100000000,17,28100,"Kankakee, IL MSA",2024,4,51254,48201,3053,6
MT1737900000000,17,37900,"Peoria, IL MSA",2024,4,177890,168914,8976,5
MT1740420000000,17,40420,"Rockford, IL MSA",2024,4,160790,151444,9346,5.8
MT1744100000000,17,44100,"Springfield, IL MSA",2024,4,104292,99715,4577,4.4
MT1814020000000,18,14020,"Bloomington, IN MSA",2024,4,85666,82424,3242,3.8
MT1818020000000,18,18020,"Columbus, IN MSA",2024,4,39887,38335,1552,3.9
MT1821140000000,18,21140,"Elkhart-Goshen, IN MSA",2024,4,97888,93037,4851,5
MT1821780000000,18,21780,"Evansville, IN MSA",2024,4,135022,129934,5088,3.8
MT1823060000000,18,23060,"Fort Wayne, IN MSA",2024,4,231404,223066,8338,3.6
MT1826900000000,18,26900,"Indianapolis-Carmel-Greenwood, IN MSA",2024,4,1135635,1093388,42247,3.7
MT1829020000000,18,29020,"Kokomo, IN MSA",2024,4,36221,34270,1951,5.4
MT1829200000000,18,29200,"Lafayette-West Lafayette, IN MSA",2024,4,120083,115694,4389,3.7
MT1833140000000,18,33140,"Michigan City-La Porte, IN MSA",2024,4,51611,49313,2298,4.5
MT1834620000000,18,34620,"Muncie, IN MSA",2024,4,52512,50060,2452,4.7
MT1843780000000,18,43780,"South Bend-Mishawaka, IN-MI MSA",2024,4,153536,146097,7439,4.8
MT1845460000000,18,45460,"Terre Haute, IN MSA",2024,4,77433,74147,3286,4.2
MT1911180000000,19,11180,"Ames, IA MSA",2024,4,69434,67855,1579,2.3
MT1916300000000,19,16300,"Cedar Rapids, IA MSA",2024,4,146210,141482,4728,3.2
MT1919780000000,19,19780,"Des Moines-West Des Moines, IA MSA",2024,4,412703,401355,11348,2.7
MT1920220000000,19,20220,"Dubuque, IA MSA",2024,4,53230,51691,1539,2.9
MT1926980000000,19,26980,"Iowa City, IA MSA",2024,4,99413,97126,2287,2.3
MT1943580000000,19,43580,"Sioux City, IA-NE-SD MSA",2024,4,76464,74400,2064,2.7
MT1947940000000,19,47940,"Waterloo-Cedar Falls, IA MSA",2024,4,87835,85179,2656,3
MT2029940000000,20,29940,"Lawrence, KS MSA",2024,4,70997,68750,2247,3.2
MT2031740000000,20,31740,"Manhattan, KS MSA",2024,4,64019,61950,2069,3.2
MT2045820000000,20,45820,"Topeka, KS MSA",2024,4,118531,114385,4146,3.5
MT2048620000000,20,48620,"Wichita, KS MSA",2024,4,335639,323263,12376,3.7
MT2114540000000,21,14540,"Bowling Green, KY MSA",2024,4,92265,88049,4216,4.6
MT2121060000000,21,21060,"Elizabethtown, KY MSA",2024,4,55466,52769,2697,4.9
MT2130460000000,21,30460,"Lexington-Fayette, KY MSA",2024,4,277118,265819,11299,4.1
MT2131140000000,21,31140,"Louisville/Jefferson County, KY-IN MSA",2024,4,697376,667147,30229,4.3
MT2136980000000,21,36980,"Owensboro, KY MSA",2024,4,51843,49382,2461,4.7
MT2137140000000,21,37140,"Paducah, KY-IL MSA",2024,4,45958,43702,2256,4.9
MT2210780000000,22,10780,"Alexandria, LA MSA",2024,4,64140,61622,2518,3.9
MT2212940000000,22,12940,"Baton Rouge, LA MSA",2024,4,429630,412975,16655,3.9
MT2225220000000,22,25220,"Hammond, LA MSA",2024,4,60851,58037,2814,4.6
MT2226380000000,22,26380,"Houma-Bayou Cane-Thibodaux, LA MSA",2024,4,87617,84465,3152,3.6
MT2229180000000,22,29180,"Lafayette, LA MSA",2024,4,197531,190416,7115,3.6
MT2229340000000,22,29340,"Lake Charles, LA MSA",2024,4,98399,94258,4141,4.2
MT2233740000000,22,33740,"Monroe, LA MSA",2024,4,95894,91397,4497,4.7
MT2235380000000,22,35380,"New Orleans-Metairie, LA MSA",2024,4,467050,447138,19912,4.3
MT2243340000000,22,43340,"Shreveport-Bossier City, LA MSA",2024,4,167579,160401,7178,4.3
MT2243640000000,22,43640,"Slidell-Mandeville-Covington, LA MSA",2024,4,128943,124176,4767,3.7
MT2312620000000,23,12620,"Bangor, ME MSA",2024,4,75520,73303,2217,2.9
MT2330340000000,23,30340,"Lewiston-Auburn, ME MSA",2024,4,55367,53767,1600,2.9
MT2338860000000,23,38860,"Portland-South Portland, ME MSA",2024,4,313163,305676,7487,2.4
MT2412580000000,24,12580,"Baltimore-Columbia-Towson, MD MSA",2024,4,1498498,1454248,44250,3
MT2425180000000,24,25180,"Hagerstown-Martinsburg, MD-WV MSA",2024,4,144351,139675,4676,3.2
MT2430500000000,24,30500,"Lexington Park, MD MSA",2024,4,109265,106438,2827,2.6
MT2441540000000,24,41540,"Salisbury, MD MSA",2024,4,64366,62201,2165,3.4
MT2511200000000,25,11200,"Amherst Town-Northampton, MA MSA",2024,4,85649,82525,3124,3.6
MT2512700000000,25,12700,"Barnstable Town, MA MSA",2024,4,116525,111001,5524,4.7
MT2514460000000,25,14460,"Boston-Cambridge-Newton, MA-NH MSA",2024,4,2827425,2726449,100976,3.6
MT2538340000000,25,38340,"Pittsfield, MA MSA",2024,4,64301,61777,2524,3.9
MT2544140000000,25,44140,"Springfield, MA MSA",2024,4,224510,213395,11115,5
MT2549340000000,25,49340,"Worcester, MA MSA",2024,4,465474,446965,18509,4
MT2611460000000,26,11460,"Ann Arbor, MI MSA",2024,4,207681,200362,7319,3.5
MT2612980000000,26,12980,"Battle Creek, MI MSA",2024,4,63445,60358,3087,4.9
MT2613020000000,26,13020,"Bay City, MI MSA",2024,4,50264,47629,2635,5.2
MT2619820000000,26,19820,"Detroit-Warren-Dearborn, MI MSA",2024,4,2182597,2092373,90224,4.1
MT2622420000000,26,22420,"Flint, MI MSA",2024,4,188985,178848,10137,5.4
MT2624340000000,26,24340,"Grand Rapids-Wyoming-Kentwood, MI MSA",2024,4,629313,605940,23373,3.7
MT2627100000000,26,27100,"Jackson, MI MSA",2024,4,75010,71660,3350,4.5
MT2628020000000,26,28020,"Kalamazoo-Portage, MI MSA",2024,4,140475,135024,5451,3.9
MT2629620000000,26,29620,"Lansing-East Lansing, MI MSA",2024,4,254659,243924,10735,4.2
MT2633220000000,26,33220,"Midland, MI MSA",2024,4,42814,41036,1778,4.2
MT2633780000000,26,33780,"Monroe, MI MSA",2024,4,79368,75645,3723,4.7
MT2634740000000,26,34740,"Muskegon-Norton Shores, MI MSA",2024,4,85190,81174,4016,4.7
MT2635660000000,26,35660,"Niles, MI MSA",2024,4,77198,73588,3610,4.7
MT2640980000000,26,40980,"Saginaw, MI MSA",2024,4,85112,80407,4705,5.5
MT2645900000000,26,45900,"Traverse City, MI MSA",2024,4,81713,78463,3250,4
MT2720260000000,27,20260,"Duluth, MN-WI MSA",2024,4,140422,135335,5087,3.6
MT2731860000000,27,31860,"Mankato, MN MSA",2024,4,60583,58969,1614,2.7
MT2733460000000,27,33460,"Minneapolis-St. Paul-Bloomington, MN-WI MSA",2024,4,2070924,2010226,60698,2.9
MT2740340000000,27,40340,"Rochester, MN MSA",2024,4,127065,123914,3151,2.5
MT2741060000000,27,41060,"St. Cloud, MN MSA",2024,4,110566,107088,3478,3.1
MT2825060000000,28,25060,"Gulfport-Biloxi, MS MSA",2024,4,186540,181733,4807,2.6
MT2825620000000,28,25620,"Hattiesburg, MS MSA",2024,4,70098,68289,1809,2.6
MT2827140000000,28,27140,"Jackson, MS MSA",2024,4,279864,272890,6974,2.5
MT2916020000000,29,16020,"Cape Girardeau, MO-IL MSA",2024,4,49227,47495,1732,3.5
MT2917860000000,29,17860,"Columbia, MO MSA",2024,4,112694,109092,3602,3.2
MT2927620000000,29,27620,"Jefferson City, MO MSA",2024,4,76353,73946,2407,3.2
MT2927900000000,29,27900,"Joplin, MO-KS MSA",2024,4,98014,94427,3587,3.7
MT2928140000000,29,28140,"Kansas City, MO-KS MSA",2024,4,1197680,1154943,42737,3.6
MT2941140000000,29,41140,"St. Joseph, MO-KS MSA",2024,4,54462,52423,2039,3.7
MT2941180000000,29,41180,"St. Louis, MO-IL MSA",2024,4,1484942,1428960,55982,3.8
MT2944180000000,29,44180,"Springfield, MO MSA",2024,4,242915,234652,8263,3.4
MT3013740000000,30,13740,"Billings, MT MSA",2024,4,99129,96346,2783,2.8
MT3014580000000,30,14580,"Bozeman, MT MSA",2024,4,78191,76402,1789,2.3
MT3024500000000,30,24500,"Great Falls, MT MSA",2024,4,39995,38816,1179,2.9
MT3025740000000,30,25740,"Helena, MT MSA",2024,4,47831,46501,1330,2.8
MT3033540000000,30,33540,"Missoula, MT MSA",2024,4,74109,71957,2152,2.9
MT3124260000000,31,24260,"Grand Island, NE MSA",2024,4,42935,41805,1130,2.6
MT3130700000000,31,30700,"Lincoln, NE MSA",2024,4,193135,188466,4669,2.4
MT3136540000000,31,36540,"Omaha, NE-IA MSA",2024,4,526290,511101,15189,2.9
MT3216180000000,32,16180,"Carson City, NV MSA",2024,4,29079,27745,1334,4.6
MT3229820000000,32,29820,"Las Vegas-Henderson-North Las Vegas, NV MSA",2024,4,1214944,1146179,68765,5.7
MT3239900000000,32,39900,"Reno, NV MSA",2024,4,297693,283631,14062,4.7
MT3331700000000,33,31700,"Manchester-Nashua, NH MSA",2024,4,240387,234157,6230,2.6
MT3412100000000,34,12100,"Atlantic City-Hammonton, NJ MSA",2024,4,180206,169223,10983,6.1
MT3445940000000,34,45940,"Trenton-Princeton, NJ MSA",2024,4,199767,191194,8573,4.3
MT3447220000000,34,47220,"Vineland, NJ MSA",2024,4,65313,60795,4518,6.9
MT3510740000000,35,10740,"Albuquerque, NM MSA",2024,4,462162,445069,17093,3.7
MT3522140000000,35,22140,"Farmington, NM MSA",2024,4,49835,47576,2259,4.5
MT3529740000000,35,29740,"Las Cruces, NM MSA",2024,4,102295,97369,4926,4.8
MT3542140000000,35,42140,"Santa Fe, NM MSA",2024,4,73925,71378,2547,3.4
MT3610580000000,36,10580,"Albany-Schenectady-Troy, NY MSA",2024,4,457213,441816,15397,3.4
MT3613780000000,36,13780,"Binghamton, NY MSA",2024,4,106690,102557,4133,3.9
MT3615380000000,36,15380,"Buffalo-Cheektowaga, NY MSA",2024,4,559734,537828,21906,3.9
MT3621300000000,36,21300,"Elmira, NY MSA",2024,4,35330,34023,1307,3.7
MT3624020000000,36,24020,"Glens Falls, NY MSA",2024,4,59501,57359,2142,3.6
MT3627060000000,36,27060,"Ithaca, NY MSA",2024,4,48226,46642,1584,3.3
MT3628740000000,36,28740,"Kingston, NY MSA",2024,4,87189,84042,3147,3.6
MT3628880000000,36,28880,"Kiryas Joel-Poughkeepsie-Newburgh, NY MSA",2024,4,339735,327824,11911,3.5
MT3635620000000,36,35620,"New York-Newark-Jersey City, NY-NJ MSA",2024,4,10197239,9748274,448965,4.4
MT3640380000000,36,40380,"Rochester, NY MSA",2024,4,513657,494633,19024,3.7
MT3645060000000,36,45060,"Syracuse, NY MSA",2024,4,310477,299085,11392,3.7
MT3646540000000,36,46540,"Utica-Rome, NY MSA",2024,4,127583,122683,4900,3.8
MT3648060000000,36,48060,"Watertown-Fort Drum, NY MSA",2024,4,44864,42849,2015,4.5
MT3711700000000,37,11700,"Asheville, NC MSA",2024,4,212161,206038,6123,2.9
MT3715500000000,37,15500,"Burlington, NC MSA",2024,4,86141,83044,3097,3.6
MT3716740000000,37,16740,"Charlotte-Concord-Gastonia, NC-SC MSA",2024,4,1479411,1426167,53244,3.6
MT3720500000000,37,20500,"Durham-Chapel Hill, NC MSA",2024,4,322984,312522,10462,3.2
MT3722180000000,37,22180,"Fayetteville, NC MSA",2024,4,154353,147358,6995,4.5
MT3724140000000,37,24140,"Goldsboro, NC MSA",2024,4,50758,48874,1884,3.7
MT3724660000000,37,24660,"Greensboro-High Point, NC MSA",2024,4,373578,358531,15047,4
MT3724780000000,37,24780,"Greenville, NC MSA",2024,4,84140,80707,3433,4.1
MT3725860000000,37,25860,"Hickory-Lenoir-Morganton, NC MSA",2024,4,170934,164937,5997,3.5
MT3727340000000,37,27340,"Jacksonville, NC MSA",2024,4,74290,71479,2811,3.8
MT3738240000000,37,38240,"Pinehurst-Southern Pines, NC MSA",2024,4,44977,43449,1528,3.4
MT3739580000000,37,39580,"Raleigh-Cary, NC MSA",2024,4,845738,819124,26614,3.1
MT3740580000000,37,40580,"Rocky Mount, NC MSA",2024,4,63994,60993,3001,4.7
MT3748900000000,37,48900,"Wilmington, NC MSA",2024,4,223053,215170,7883,3.5
MT3749180000000,37,49180,"Winston-Salem, NC MSA",2024,4,324579,312750,11829,3.6
MT3813900000000,38,13900,"Bismarck, ND MSA",2024,4,72886,71251,1635,2.2
MT3822020000000,38,22020,"Fargo, ND-MN MSA",2024,4,153910,150480,3430,2.2
MT3824220000000,38,24220,"Grand Forks, ND-MN MSA",2024,4,56469,55143,1326,2.3
MT3833500000000,38,33500,"Minot, ND MSA",2024,4,40312,39371,941,2.3
MT3910420000000,39,10420,"Akron, OH MSA",2024,4,360959,345378,15581,4.3
MT3915940000000,39,15940,"Canton-Massillon, OH MSA",2024,4,195047,186438,8609,4.4
MT3917140000000,39,17140,"Cincinnati, OH-KY-IN MSA",2024,4,1170800,1122480,48320,4.1
MT3917410000000,39,17410,"Cleveland, OH MSA",2024,4,1095528,1053913,41615,3.8
MT3918140000000,39,18140,"Columbus, OH MSA",2024,4,1156516,1111428,45088,3.9
MT3919430000000,39,19430,"Dayton-Kettering-Beavercreek, OH MSA",2024,4,395524,378766,16758,4.2
MT3930620000000,39,30620,"Lima, OH MSA",2024,4,47598,45559,2039,4.3
MT3931900000000,39,31900,"Mansfield, OH MSA",2024,4,53633,50995,2638,4.9
MT3941780000000,39,41780,"Sandusky, OH MSA",2024,4,57368,54401,2967,5.2
MT3944220000000,39,44220,"Springfield, OH MSA",2024,4,62335,59591,2744,4.4
MT3945780000000,39,45780,"Toledo, OH MSA",2024,4,296566,282388,14178,4.8
MT3948260000000,39,48260,"Weirton-Steubenville, WV-OH MSA",2024,4,51926,49045,2881,5.5
MT3949660000000,39,49660,"Youngstown-Warren, OH MSA",2024,4,193025,183481,9544,4.9
MT4021420000000,40,21420,"Enid, OK MSA",2024,4,28318,27368,950,3.4
MT4030020000000,40,30020,"Lawton, OK MSA",2024,4,52449,50535,1914,3.6
MT4036420000000,40,36420,"Oklahoma City, OK MSA",2024,4,773900,750133,23767,3.1
MT4046140000000,40,46140,"Tulsa, OK MSA",2024,4,524188,506879,17309,3.3
MT4110540000000,41,10540,"Albany, OR MSA",2024,4,61396,58612,2784,4.5
MT4113460000000,41,13460,"Bend, OR MSA",2024,4,133574,127961,5613,4.2
MT4118700000000,41,18700,"Corvallis, OR MSA",2024,4,49668,47960,1708,3.4
MT4121660000000,41,21660,"Eugene-Springfield, OR MSA",2024,4,188686,180935,7751,4.1
MT4124420000000,41,24420,"Grants Pass, OR MSA",2024,4,35278,33330,1948,5.5
MT4132780000000,41,32780,"Medford, OR MSA",2024,4,106343,101263,5080,4.8
MT4138900000000,41,38900,"Portland-Vancouver-Hillsboro, OR-WA MSA",2024,4,1382321,1328611,53710,3.9
MT4141420000000,41,41420,"Salem, OR MSA",2024,4,220616,211886,8730,4
MT4210900000000,42,10900,"Allentown-Bethlehem-Easton, PA-NJ MSA",2024,4,452816,435473,17343,3.8
MT4211020000000,42,11020,"Altoona, PA MSA",2024,4,57677,55686,1991,3.5
MT4216540000000,42,16540,"Chambersburg, PA MSA",2024,4,77035,74689,2346,3
MT4221500000000,42,21500,"Erie, PA MSA",2024,4,127520,122750,4770,3.7
MT4223900000000,42,23900,"Gettysburg, PA MSA",2024,4,51900,50322,1578,3
MT4225420000000,42,25420,"Harrisburg-Carlisle, PA MSA",2024,4,313982,303765,10217,3.3
MT4227780000000,42,27780,"Johnstown, PA MSA",2024,4,57012,54629,2383,4.2
MT4229540000000,42,29540,"Lancaster, PA MSA",2024,4,293079,284757,8322,2.8
MT4230140000000,42,30140,"Lebanon, PA MSA",2024,4,73469,71189,2280,3.1
MT4237980000000,42,37980,"Philadelphia-Camden-Wilmington, PA-NJ-DE-MD MSA",2024,4,3304985,3180239,124746,3.8
MT4238300000000,42,38300,"Pittsburgh, PA MSA",2024,4,1243524,1199233,44291,3.6
MT4239740000000,42,39740,"Reading, PA MSA",2024,4,219461,211381,8080,3.7
MT4242540000000,42,42540,"Scranton--Wilkes-Barre, PA MSA",2024,4,281632,269693,11939,4.2
MT4244300000000,42,44300,"State College, PA MSA",2024,4,77026,74836,2190,2.8
MT4248700000000,42,48700,"Williamsport, PA MSA",2024,4,53201,51141,2060,3.9
MT4249620000000,42,49620,"York-Hanover, PA MSA",2024,4,241097,233111,7986,3.3
MT4439300000000,44,39300,"Providence-Warwick, RI-MA MSA",2024,4,902313,863167,39146,4.3
MT4516700000000,45,16700,"Charleston-North Charleston, SC MSA",2024,4,442059,427358,14701,3.3
MT4517900000000,45,17900,"Columbia, SC MSA",2024,4,418332,402149,16183,3.9
MT4522500000000,45,22500,"Florence, SC MSA",2024,4,92228,88190,4038,4.4
MT4524860000000,45,24860,"Greenville-Anderson-Greer, SC MSA",2024,4,478909,461513,17396,3.6
MT4525940000000,45,25940,"Hilton Head Island-Bluffton-Port Royal, SC MSA",2024,4,97683,94077,3606,3.7
MT4534820000000,45,34820,"Myrtle Beach-Conway-North Myrtle Beach, SC MSA",2024,4,170701,162924,7777,4.6
MT4543900000000,45,43900,"Spartanburg, SC MSA",2024,4,176449,169338,7111,4
MT4544940000000,45,44940,"Sumter, SC MSA",2024,4,41833,39814,2019,4.8
MT4639660000000,46,39660,"Rapid City, SD MSA",2024,4,79071,77687,1384,1.8
MT4643620000000,46,43620,"Sioux Falls, SD-MN MSA",2024,4,173963,171123,2840,1.6
MT4716860000000,47,16860,"Chattanooga, TN-GA MSA",2024,4,291175,282438,8737,3
MT4717300000000,47,17300,"Clarksville, TN-KY MSA",2024,4,138306,132956,5350,3.9
MT4717420000000,47,17420,"Cleveland, TN MSA",2024,4,56397,54446,1951,3.5
MT4727180000000,47,27180,"Jackson, TN MSA",2024,4,78139,75369,2770,3.5
MT4727740000000,47,27740,"Johnson City, TN MSA",2024,4,96764,93673,3091,3.2
MT4728700000000,47,28700,"Kingsport-Bristol, TN-VA MSA",2024,4,132598,128177,4421,3.3
MT4728940000000,47,28940,"Knoxville, TN MSA",2024,4,450837,437553,13284,2.9
MT4732820000000,47,32820,"Memphis, TN-MS-AR MSA",2024,4,625121,601460,23661,3.8
MT4734100000000,47,34100,"Morristown, TN MSA",2024,4,53442,51691,1751,3.3
MT4734980000000,47,34980,"Nashville-Davidson--Murfreesboro--Franklin, TN MSA",2024,4,1158306,1128076,30230,2.6
MT4810180000000,48,10180,"Abilene, TX MSA",2024,4,86369,83406,2963,3.4
MT4811100000000,48,11100,"Amarillo, TX MSA",2024,4,137001,132719,4282,3.1
MT4812420000000,48,12420,"Austin-Round Rock-San Marcos, TX MSA",2024,4,1494488,1442314,52174,3.5
MT4813140000000,48,13140,"Beaumont-Port Arthur, TX MSA",2024,4,181405,171665,9740,5.4
MT4815180000000,48,15180,"Brownsville-Harlingen, TX MSA",2024,4,188548,178752,9796,5.2
MT4817780000000,48,17780,"College Station-Bryan, TX MSA",2024,4,150453,145312,5141,3.4
MT4818580000000,48,18580,"Corpus Christi, TX MSA",2024,4,208410,199297,9113,4.4
MT4819100000000,48,19100,"Dallas-Fort Worth-Arlington, TX MSA",2024,4,4465733,4293306,172427,3.9
MT4820580000000,48,20580,"Eagle Pass, TX MSA",2024,4,23787,21942,1845,7.8
MT4821340000000,48,21340,"El Paso, TX MSA",2024,4,412708,395589,17119,4.1
MT4826420000000,48,26420,"Houston-Pasadena-The Woodlands, TX MSA",2024,4,3814261,3652127,162134,4.3
MT4828660000000,48,28660,"Killeen-Temple, TX MSA",2024,4,202054,193407,8647,4.3
MT4829700000000,48,29700,"Laredo, TX MSA",2024,4,118085,113130,4955,4.2
MT4830980000000,48,30980,"Longview, TX MSA",2024,4,129029,123150,5879,4.6
MT4831180000000,48,31180,"Lubbock, TX MSA",2024,4,184098,177791,6307,3.4
MT4832580000000,48,32580,"McAllen-Edinburg-Mission, TX MSA",2024,4,393711,370445,23266,5.9
MT4833260000000,48,33260,"Midland, TX MSA",2024,4,103332,100388,2944,2.8
MT4836220000000,48,36220,"Odessa, TX MSA",2024,4,86115,83203,2912,3.4
MT4841660000000,48,41660,"San Angelo, TX MSA",2024,4,61859,59894,1965,3.2
MT4841700000000,48,41700,"San Antonio-New Braunfels, TX MSA",2024,4,1328005,1278429,49576,3.7
MT4843300000000,48,43300,"Sherman-Denison, TX MSA",2024,4,71142,68428,2714,3.8
MT4845500000000,48,45500,"Texarkana, TX-AR MSA",2024,4,61688,59140,2548,4.1
MT4846340000000,48,46340,"Tyler, TX MSA",2024,4,117607,113078,4529,3.9
MT4847020000000,48,47020,"Victoria, TX MSA",2024,4,44907,43117,1790,4
MT4847380000000,48,47380,"Waco, TX MSA",2024,4,145748,140230,5518,3.8
MT4848660000000,48,48660,"Wichita Falls, TX MSA",2024,4,66769,64226,2543,3.8
MT4930860000000,49,30860,"Logan, UT-ID MSA",2024,4,79568,77369,2199,2.8
MT4936260000000,49,36260,"Ogden, UT MSA",2024,4,351029,340573,10456,3
MT4939340000000,49,39340,"Provo-Orem-Lehi, UT MSA",2024,4,369565,357793,11772,3.2
MT4941100000000,49,41100,"St. George, UT MSA",2024,4,93201,90138,3063,3.3
MT4941620000000,49,41620,"Salt Lake City-Murray, UT MSA",2024,4,736726,713599,23127,3.1
MT5015540000000,50,15540,"Burlington-South Burlington, VT MSA",2024,4,131214,128762,2452,1.9
MT5113980000000,51,13980,"Blacksburg-Christiansburg-Radford, VA MSA",2024,4,93322,90586,2736,2.9
MT5116820000000,51,16820,"Charlottesville, VA MSA",2024,4,120927,117933,2994,2.5
MT5125500000000,51,25500,"Harrisonburg, VA MSA",2024,4,72705,70704,2001,2.8
MT5131340000000,51,31340,"Lynchburg, VA MSA",2024,4,127762,123707,4055,3.2
MT5140060000000,51,40060,"Richmond, VA MSA",2024,4,727802,706622,21180,2.9
MT5140220000000,51,40220,"Roanoke, VA MSA",2024,4,158549,153990,4559,2.9
MT5144420000000,51,44420,"Staunton-Stuarts Draft, VA MSA",2024,4,65708,64081,1627,2.5
MT5147260000000,51,47260,"Virginia Beach-Chesapeake-Norfolk, VA-NC MSA",2024,4,883162,856461,26701,3
MT5149020000000,51,49020,"Winchester, VA-WV MSA",2024,4,77620,75559,2061,2.7
MT5313380000000,53,13380,"Bellingham, WA MSA",2024,4,114460,109349,5111,4.5
MT5314740000000,53,14740,"Bremerton-Silverdale-Port Orchard, WA MSA",2024,4,122462,117006,5456,4.5
MT5328420000000,53,28420,"Kennewick-Richland, WA MSA",2024,4,146365,139065,7300,5
MT5331020000000,53,31020,"Longview-Kelso, WA MSA",2024,4,47279,44828,2451,5.2
MT5334580000000,53,34580,"Mount Vernon-Anacortes, WA MSA",2024,4,59410,56480,2930,4.9
MT5336500000000,53,36500,"Olympia-Lacey-Tumwater, WA MSA",2024,4,143692,137243,6449,4.5
MT5342660000000,53,42660,"Seattle-Tacoma-Bellevue, WA MSA",2024,4,2316910,2217056,99854,4.3
MT5344060000000,53,44060,"Spokane-Spokane Valley, WA MSA",2024,4,283007,270320,12687,4.5
MT5347460000000,53,47460,"Walla Walla, WA MSA",2024,4,29504,28227,1277,4.3
MT5348300000000,53,48300,"Wenatchee-East Wenatchee, WA MSA",2024,4,62355,59377,2978,4.8
MT5349420000000,53,49420,"Yakima, WA MSA",2024,4,125762,118274,7488,6
MT5413220000000,54,13220,"Beckley, WV MSA",2024,4,46419,44582,1837,4
MT5416620000000,54,16620,"Charleston, WV MSA",2024,4,91260,87666,3594,3.9
MT5426580000000,54,26580,"Huntington-Ashland, WV-KY-OH MSA",2024,4,157327,149642,7685,4.9
MT5434060000000,54,34060,"Morgantown, WV MSA",2024,4,71068,68635,2433,3.4
MT5437620000000,54,37620,"Parkersburg-Vienna, WV MSA",2024,4,39470,37786,1684,4.3
MT5448540000000,54,48540,"Wheeling, WV-OH MSA",2024,4,59710,56928,2782,4.7
MT5511540000000,55,11540,"Appleton, WI MSA",2024,4,137343,134003,3340,2.4
MT5520740000000,55,20740,"Eau Claire, WI MSA",2024,4,96318,93628,2690,2.8
MT5522540000000,55,22540,"Fond du Lac, WI MSA",2024,4,55802,54334,1468,2.6
MT5524580000000,55,24580,"Green Bay, WI MSA",2024,4,178723,174061,4662,2.6
MT5527500000000,55,27500,"Janesville-Beloit, WI MSA",2024,4,86938,84156,2782,3.2
MT5528450000000,55,28450,"Kenosha, WI MSA",2024,4,95671,92652,3019,3.2
MT5529100000000,55,29100,"La Crosse-Onalaska, WI-MN MSA",2024,4,90355,88019,2336,2.6
MT5531540000000,55,31540,"Madison, WI MSA",2024,4,410265,400831,9434,2.3
MT5533340000000,55,33340,"Milwaukee-Waukesha, WI MSA",2024,4,817218,791217,26001,3.2
MT5536780000000,55,36780,"Oshkosh-Neenah, WI MSA",2024,4,93198,90743,2455,2.6
MT5539540000000,55,39540,"Racine-Mount Pleasant, WI MSA",2024,4,101729,98224,3505,3.4
MT5543100000000,55,43100,"Sheboygan, WI MSA",2024,4,63462,61927,1535,2.4
MT5548140000000,55,48140,"Wausau, WI MSA",2024,4,75497,73539,1958,2.6
MT5616220000000,56,16220,"Casper, WY MSA",2024,4,42057,40784,1273,3
MT5616940000000,56,16940,"Cheyenne, WY MSA",2024,4,48978,47400,1578,3.2
MT7210380000000,72,10380,"Aguadilla, PR MSA",2024,4,90495,84169,6326,7
MT7211640000000,72,11640,"Arecibo, PR MSA",2024,4,67543,63709,3834,5.7
MT7225020000000,72,25020,"Guayama, PR MSA",2024,4,19101,17212,1889,9.9
MT7232420000000,72,32420,"Mayaguez, PR MSA",2024,4,66753,61969,4784,7.2
MT7238660000000,72,38660,"Ponce, PR MSA",2024,4,89175,81023,8152,9.1
MT7241980000000,72,41980,"San Juan-Bayamon-Caguas, PR MSA",2024,4,809139,769860,39279,4.9
MT0111500000000,1,11500,"Anniston-Oxford, AL MSA",2024,5,49371,47883,1488,3
MT0112220000000,1,12220,"Auburn-Opelika, AL MSA",2024,5,96478,93703,2775,2.9
MT0113820000000,1,13820,"Birmingham, AL MSA",2024,5,571534,556103,15431,2.7
MT0119300000000,1,19300,"Daphne-Fairhope-Foley, AL MSA",2024,5,115455,112383,3072,2.7
MT0119460000000,1,19460,"Decatur, AL MSA",2024,5,75430,73568,1862,2.5
MT0120020000000,1,20020,"Dothan, AL MSA",2024,5,67603,65649,1954,2.9
MT0122520000000,1,22520,"Florence-Muscle Shoals, AL MSA",2024,5,68816,66689,2127,3.1
MT0123460000000,1,23460,"Gadsden, AL MSA",2024,5,41985,40706,1279,3
MT0126620000000,1,26620,"Huntsville, AL MSA",2024,5,275433,268803,6630,2.4
MT0133660000000,1,33660,"Mobile, AL MSA",2024,5,185046,178445,6601,3.6
MT0133860000000,1,33860,"Montgomery, AL MSA",2024,5,178142,172903,5239,2.9
MT0146220000000,1,46220,"Tuscaloosa, AL MSA",2024,5,126470,122591,3879,3.1
MT0211260000000,2,11260,"Anchorage, AK MSA",2024,5,200603,192330,8273,4.1
MT0221820000000,2,21820,"Fairbanks-College, AK MSA",2024,5,45655,43854,1801,3.9
MT0422380000000,4,22380,"Flagstaff, AZ MSA",2024,5,75669,72907,2762,3.7
MT0429420000000,4,29420,"Lake Havasu City-Kingman, AZ MSA",2024,5,87440,83625,3815,4.4
MT0438060000000,4,38060,"Phoenix-Mesa-Chandler, AZ MSA",2024,5,2706630,2623039,83591,3.1
MT0439150000000,4,39150,"Prescott Valley-Prescott, AZ MSA",2024,5,106295,102661,3634,3.4
MT0443420000000,4,43420,"Sierra Vista-Douglas, AZ MSA",2024,5,48161,46158,2003,4.2
MT0446060000000,4,46060,"Tucson, AZ MSA",2024,5,491205,474262,16943,3.4
MT0449740000000,4,49740,"Yuma, AZ MSA",2024,5,98526,86765,11761,11.9
MT0522220000000,5,22220,"Fayetteville-Springdale-Rogers, AR MSA",2024,5,305186,297118,8068,2.6
MT0522900000000,5,22900,"Fort Smith, AR-OK MSA",2024,5,101056,97528,3528,3.5
MT0526300000000,5,26300,"Hot Springs, AR MSA",2024,5,43592,42032,1560,3.6
MT0527860000000,5,27860,"Jonesboro, AR MSA",2024,5,66241,64172,2069,3.1
MT0530780000000,5,30780,"Little Rock-North Little Rock-Conway, AR MSA",2024,5,379395,367184,12211,3.2
MT0612540000000,6,12540,"Bakersfield-Delano, CA MSA",2024,5,406072,370790,35282,8.7
MT0617020000000,6,17020,"Chico, CA MSA",2024,5,91348,86000,5348,5.9
MT0620940000000,6,20940,"El Centro, CA MSA",2024,5,72876,59651,13225,18.1
MT0623420000000,6,23420,"Fresno, CA MSA",2024,5,537609,495058,42551,7.9
MT0625260000000,6,25260,"Hanford-Corcoran, CA MSA",2024,5,58181,53014,5167,8.9
MT0631080000000,6,31080,"Los Angeles-Long Beach-Anaheim, CA MSA",2024,5,6725773,6373295,352478,5.2
MT0632900000000,6,32900,"Merced, CA MSA",2024,5,120137,108340,11797,9.8
MT0633700000000,6,33700,"Modesto, CA MSA",2024,5,252038,234721,17317,6.9
MT0634900000000,6,34900,"Napa, CA MSA",2024,5,74021,71139,2882,3.9
MT0637100000000,6,37100,"Oxnard-Thousand Oaks-Ventura, CA MSA",2024,5,421209,402139,19070,4.5
MT0639820000000,6,39820,"Redding, CA MSA",2024,5,78869,74686,4183,5.3
MT0640140000000,6,40140,"Riverside-San Bernardino-Ontario, CA MSA",2024,5,2202670,2089348,113322,5.1
MT0640900000000,6,40900,"Sacramento-Roseville-Folsom, CA MSA",2024,5,1178726,1124823,53903,4.6
MT0641500000000,6,41500,"Salinas, CA MSA",2024,5,220110,204073,16037,7.3
MT0641740000000,6,41740,"San Diego-Chula Vista-Carlsbad, CA MSA",2024,5,1646556,1577138,69418,4.2
MT0641860000000,6,41860,"San Francisco-Oakland-Fremont, CA MSA",2024,5,2501681,2399434,102247,4.1
MT0641940000000,6,41940,"San Jose-Sunnyvale-Santa Clara, CA MSA",2024,5,1057064,1013469,43595,4.1
MT0642020000000,6,42020,"San Luis Obispo-Paso Robles, CA MSA",2024,5,132477,127199,5278,4
MT0642100000000,6,42100,"Santa Cruz-Watsonville, CA MSA",2024,5,135899,127937,7962,5.9
MT0642200000000,6,42200,"Santa Maria-Santa Barbara, CA MSA",2024,5,221214,211434,9780,4.4
MT0642220000000,6,42220,"Santa Rosa-Petaluma, CA MSA",2024,5,246719,236736,9983,4
MT0644700000000,6,44700,"Stockton-Lodi, CA MSA",2024,5,366807,343337,23470,6.4
MT0646700000000,6,46700,"Vallejo, CA MSA",2024,5,216488,205958,10530,4.9
MT0647300000000,6,47300,"Visalia, CA MSA",2024,5,220058,197332,22726,10.3
MT0649700000000,6,49700,"Yuba City, CA MSA",2024,5,80954,74618,6336,7.8
MT0814500000000,8,14500,"Boulder, CO MSA",2024,5,193849,185955,7894,4.1
MT0817820000000,8,17820,"Colorado Springs, CO MSA",2024,5,394780,378706,16074,4.1
MT0819740000000,8,19740,"Denver-Aurora-Centennial, CO MSA",2024,5,1771015,1699479,71536,4
MT0822660000000,8,22660,"Fort Collins-Loveland, CO MSA",2024,5,208355,200234,8121,3.9
MT0824300000000,8,24300,"Grand Junction, CO MSA",2024,5,79669,76285,3384,4.2
MT0824540000000,8,24540,"Greeley, CO MSA",2024,5,178120,170489,7631,4.3
MT0839380000000,8,39380,"Pueblo, CO MSA",2024,5,73524,69404,4120,5.6
MT0914860000000,9,14860,"Bridgeport-Stamford-Danbury, CT MSA",2024,5,516198,500596,15602,3
MT0925540000000,9,25540,"Hartford-West Hartford-East Hartford, CT MSA",2024,5,612570,593442,19128,3.1
MT0935300000000,9,35300,"New Haven, CT MSA",2024,5,316096,306228,9868,3.1
MT0935980000000,9,35980,"Norwich-New London-Willimantic, CT MSA",2024,5,142660,138333,4327,3
MT0947930000000,9,47930,"Waterbury-Shelton, CT MSA",2024,5,239971,231502,8469,3.5
MT1020100000000,10,20100,"Dover, DE MSA",2024,5,85417,81914,3503,4.1
MT1147900000000,11,47900,"Washington-Arlington-Alexandria, DC-VA-MD-WV MSA",2024,5,3552711,3447294,105417,3
MT1215980000000,12,15980,"Cape Coral-Fort Myers, FL MSA",2024,5,376751,363587,13164,3.5
MT1218880000000,12,18880,"Crestview-Fort Walton Beach-Destin, FL MSA",2024,5,142574,138170,4404,3.1
MT1219660000000,12,19660,"Deltona-Daytona Beach-Ormond Beach, FL MSA",2024,5,322390,310043,12347,3.8
MT1223540000000,12,23540,"Gainesville, FL MSA",2024,5,169225,162841,6384,3.8
MT1226140000000,12,26140,"Homosassa Springs, FL MSA",2024,5,53634,50989,2645,4.9
MT1227260000000,12,27260,"Jacksonville, FL MSA",2024,5,854897,825531,29366,3.4
MT1229460000000,12,29460,"Lakeland-Winter Haven, FL MSA",2024,5,357722,342623,15099,4.2
MT1233100000000,12,33100,"Miami-Fort Lauderdale-West Palm Beach, FL MSA",2024,5,3311831,3216689,95142,2.9
MT1234940000000,12,34940,"Naples-Marco Island, FL MSA",2024,5,186983,180783,6200,3.3
MT1235840000000,12,35840,"North Port-Bradenton-Sarasota, FL MSA",2024,5,400198,386319,13879,3.5
MT1236100000000,12,36100,"Ocala, FL MSA",2024,5,158696,152078,6618,4.2
MT1236740000000,12,36740,"Orlando-Kissimmee-Sanford, FL MSA",2024,5,1533583,1483527,50056,3.3
MT1237340000000,12,37340,"Palm Bay-Melbourne-Titusville, FL MSA",2024,5,304710,294093,10617,3.5
MT1237460000000,12,37460,"Panama City-Panama City Beach, FL MSA",2024,5,101871,98443,3428,3.4
MT1237860000000,12,37860,"Pensacola-Ferry Pass-Brent, FL MSA",2024,5,240378,231910,8468,3.5
MT1238940000000,12,38940,"Port St. Lucie, FL MSA",2024,5,239674,230537,9137,3.8
MT1239460000000,12,39460,"Punta Gorda, FL MSA",2024,5,77580,74481,3099,4
MT1242680000000,12,42680,"Sebastian-Vero Beach-West Vero Corridor, FL MSA",2024,5,68061,65349,2712,4
MT1242700000000,12,42700,"Sebring, FL MSA",2024,5,36549,34774,1775,4.9
MT1245220000000,12,45220,"Tallahassee, FL MSA",2024,5,207536,200343,7193,3.5
MT1245300000000,12,45300,"Tampa-St. Petersburg-Clearwater, FL MSA",2024,5,1702143,1644434,57709,3.4
MT1248680000000,12,48680,"Wildwood-The Villages, FL MSA",2024,5,34073,32159,1914,5.6
MT1310500000000,13,10500,"Albany, GA MSA",2024,5,62503,59881,2622,4.2
MT1312020000000,13,12020,"Athens-Clarke County, GA MSA",2024,5,108372,104739,3633,3.4
MT1312060000000,13,12060,"Atlanta-Sandy Springs-Roswell, GA MSA",2024,5,3311171,3197287,113884,3.4
MT1312260000000,13,12260,"Augusta-Richmond County, GA-SC MSA",2024,5,269472,257885,11587,4.3
MT1315260000000,13,15260,"Brunswick-St. Simons, GA MSA",2024,5,55659,53905,1754,3.2
MT1317980000000,13,17980,"Columbus, GA-AL MSA",2024,5,128663,123515,5148,4
MT1319140000000,13,19140,"Dalton, GA MSA",2024,5,67406,64781,2625,3.9
MT1323580000000,13,23580,"Gainesville, GA MSA",2024,5,109242,106062,3180,2.9
MT1325980000000,13,25980,"Hinesville, GA MSA",2024,5,31288,30002,1286,4.1
MT1331420000000,13,31420,"Macon-Bibb County, GA MSA",2024,5,97190,93058,4132,4.3
MT1340660000000,13,40660,"Rome, GA MSA",2024,5,47651,45940,1711,3.6
MT1342340000000,13,42340,"Savannah, GA MSA",2024,5,210615,204042,6573,3.1
MT1346660000000,13,46660,"Valdosta, GA MSA",2024,5,61606,59178,2428,3.9
MT1347580000000,13,47580,"Warner Robins, GA MSA",2024,5,89899,86953,2946,3.3
MT1527980000000,15,27980,"Kahului-Wailuku, HI MSA",2024,5,81539,78023,3516,4.3
MT1546520000000,15,46520,"Urban Honolulu, HI MSA",2024,5,470333,458057,12276,2.6
MT1614260000000,16,14260,"Boise City, ID MSA",2024,5,445667,430018,15649,3.5
MT1617660000000,16,17660,"Coeur d'Alene, ID MSA",2024,5,89640,85720,3920,4.4
MT1626820000000,16,26820,"Idaho Falls, ID MSA",2024,5,84452,81768,2684,3.2
MT1630300000000,16,30300,"Lewiston, ID-WA MSA",2024,5,31140,30012,1128,3.6
MT1638540000000,16,38540,"Pocatello, ID MSA",2024,5,40951,39318,1633,4
MT1646300000000,16,46300,"Twin Falls, ID MSA",2024,5,59929,57841,2088,3.5
MT1714010000000,17,14010,"Bloomington, IL MSA",2024,5,97172,93264,3908,4
MT1716580000000,17,16580,"Champaign-Urbana, IL MSA",2024,5,125137,119608,5529,4.4
MT1716980000000,17,16980,"Chicago-Naperville-Elgin, IL-IN MSA",2024,5,5002200,4738999,263201,5.3
MT1719340000000,17,19340,"Davenport-Moline-Rock Island, IA-IL MSA",2024,5,189077,180571,8506,4.5
MT1719500000000,17,19500,"Decatur, IL MSA",2024,5,44881,42192,2689,6
MT1728100000000,17,28100,"Kankakee, IL MSA",2024,5,51250,48195,3055,6
MT1737900000000,17,37900,"Peoria, IL MSA",2024,5,178163,169153,9010,5.1
MT1740420000000,17,40420,"Rockford, IL MSA",2024,5,160685,151411,9274,5.8
MT1744100000000,17,44100,"Springfield, IL MSA",2024,5,104070,99445,4625,4.4
MT1814020000000,18,14020,"Bloomington, IN MSA",2024,5,86059,82740,3319,3.9
MT1818020000000,18,18020,"Columbus, IN MSA",2024,5,39963,38365,1598,4
MT1821140000000,18,21140,"Elkhart-Goshen, IN MSA",2024,5,97889,92954,4935,5
MT1821780000000,18,21780,"Evansville, IN MSA",2024,5,135325,130113,5212,3.9
MT1823060000000,18,23060,"Fort Wayne, IN MSA",2024,5,231803,223230,8573,3.7
MT1826900000000,18,26900,"Indianapolis-Carmel-Greenwood, IN MSA",2024,5,1138125,1094772,43353,3.8
MT1829020000000,18,29020,"Kokomo, IN MSA",2024,5,36359,34329,2030,5.6
MT1829200000000,18,29200,"Lafayette-West Lafayette, IN MSA",2024,5,120300,115756,4544,3.8
MT1833140000000,18,33140,"Michigan City-La Porte, IN MSA",2024,5,51641,49276,2365,4.6
MT1834620000000,18,34620,"Muncie, IN MSA",2024,5,52691,50185,2506,4.8
MT1843780000000,18,43780,"South Bend-Mishawaka, IN-MI MSA",2024,5,153988,146334,7654,5
MT1845460000000,18,45460,"Terre Haute, IN MSA",2024,5,77658,74284,3374,4.3
MT1911180000000,19,11180,"Ames, IA MSA",2024,5,69444,67854,1590,2.3
MT1916300000000,19,16300,"Cedar Rapids, IA MSA",2024,5,146044,141219,4825,3.3
MT1919780000000,19,19780,"Des Moines-West Des Moines, IA MSA",2024,5,412877,401089,11788,2.9
MT1920220000000,19,20220,"Dubuque, IA MSA",2024,5,53235,51658,1577,3
MT1926980000000,19,26980,"Iowa City, IA MSA",2024,5,99397,97099,2298,2.3
MT1943580000000,19,43580,"Sioux City, IA-NE-SD MSA",2024,5,76473,74372,2101,2.7
MT1947940000000,19,47940,"Waterloo-Cedar Falls, IA MSA",2024,5,87880,85079,2801,3.2
MT2029940000000,20,29940,"Lawrence, KS MSA",2024,5,71141,68824,2317,3.3
MT2031740000000,20,31740,"Manhattan, KS MSA",2024,5,64212,62089,2123,3.3
MT2045820000000,20,45820,"Topeka, KS MSA",2024,5,118746,114456,4290,3.6
MT2048620000000,20,48620,"Wichita, KS MSA",2024,5,336595,323756,12839,3.8
MT2114540000000,21,14540,"Bowling Green, KY MSA",2024,5,92634,88344,4290,4.6
MT2121060000000,21,21060,"Elizabethtown, KY MSA",2024,5,55501,52718,2783,5
MT2130460000000,21,30460,"Lexington-Fayette, KY MSA",2024,5,277575,266077,11498,4.1
MT2131140000000,21,31140,"Louisville/Jefferson County, KY-IN MSA",2024,5,699480,668232,31248,4.5
MT2136980000000,21,36980,"Owensboro, KY MSA",2024,5,52035,49517,2518,4.8
MT2137140000000,21,37140,"Paducah, KY-IL MSA",2024,5,46031,43723,2308,5
MT2210780000000,22,10780,"Alexandria, LA MSA",2024,5,64112,61634,2478,3.9
MT2212940000000,22,12940,"Baton Rouge, LA MSA",2024,5,429155,412554,16601,3.9
MT2225220000000,22,25220,"Hammond, LA MSA",2024,5,60826,58000,2826,4.6
MT2226380000000,22,26380,"Houma-Bayou Cane-Thibodaux, LA MSA",2024,5,87609,84450,3159,3.6
MT2229180000000,22,29180,"Lafayette, LA MSA",2024,5,197459,190367,7092,3.6
MT2229340000000,22,29340,"Lake Charles, LA MSA",2024,5,98277,94131,4146,4.2
MT2233740000000,22,33740,"Monroe, LA MSA",2024,5,95851,91359,4492,4.7
MT2235380000000,22,35380,"New Orleans-Metairie, LA MSA",2024,5,467181,447293,19888,4.3
MT2243340000000,22,43340,"Shreveport-Bossier City, LA MSA",2024,5,167446,160317,7129,4.3
MT2243640000000,22,43640,"Slidell-Mandeville-Covington, LA MSA",2024,5,128983,124226,4757,3.7
MT2312620000000,23,12620,"Bangor, ME MSA",2024,5,75743,73465,2278,3
MT2330340000000,23,30340,"Lewiston-Auburn, ME MSA",2024,5,55493,53851,1642,3
MT2338860000000,23,38860,"Portland-South Portland, ME MSA",2024,5,313964,306189,7775,2.5
MT2412580000000,24,12580,"Baltimore-Columbia-Towson, MD MSA",2024,5,1498849,1453548,45301,3
MT2425180000000,24,25180,"Hagerstown-Martinsburg, MD-WV MSA",2024,5,144400,139656,4744,3.3
MT2430500000000,24,30500,"Lexington Park, MD MSA",2024,5,109471,106579,2892,2.6
MT2441540000000,24,41540,"Salisbury, MD MSA",2024,5,64392,62163,2229,3.5
MT2511200000000,25,11200,"Amherst Town-Northampton, MA MSA",2024,5,85738,82556,3182,3.7
MT2512700000000,25,12700,"Barnstable Town, MA MSA",2024,5,116939,111318,5621,4.8
MT2514460000000,25,14460,"Boston-Cambridge-Newton, MA-NH MSA",2024,5,2831678,2728742,102936,3.6
MT2538340000000,25,38340,"Pittsfield, MA MSA",2024,5,64273,61692,2581,4
MT2544140000000,25,44140,"Springfield, MA MSA",2024,5,225035,213739,11296,5
MT2549340000000,25,49340,"Worcester, MA MSA",2024,5,466532,447660,18872,4
MT2611460000000,26,11460,"Ann Arbor, MI MSA",2024,5,208239,200646,7593,3.6
MT2612980000000,26,12980,"Battle Creek, MI MSA",2024,5,63756,60528,3228,5.1
MT2613020000000,26,13020,"Bay City, MI MSA",2024,5,50369,47641,2728,5.4
MT2619820000000,26,19820,"Detroit-Warren-Dearborn, MI MSA",2024,5,2182149,2088001,94148,4.3
MT2622420000000,26,22420,"Flint, MI MSA",2024,5,189780,179282,10498,5.5
MT2624340000000,26,24340,"Grand Rapids-Wyoming-Kentwood, MI MSA",2024,5,630713,606141,24572,3.9
MT2627100000000,26,27100,"Jackson, MI MSA",2024,5,75164,71685,3479,4.6
MT2628020000000,26,28020,"Kalamazoo-Portage, MI MSA",2024,5,140867,135211,5656,4
MT2629620000000,26,29620,"Lansing-East Lansing, MI MSA",2024,5,255164,244057,11107,4.4
MT2633220000000,26,33220,"Midland, MI MSA",2024,5,42947,41081,1866,4.3
MT2633780000000,26,33780,"Monroe, MI MSA",2024,5,79583,75595,3988,5
MT2634740000000,26,34740,"Muskegon-Norton Shores, MI MSA",2024,5,85556,81361,4195,4.9
MT2635660000000,26,35660,"Niles, MI MSA",2024,5,77344,73569,3775,4.9
MT2640980000000,26,40980,"Saginaw, MI MSA",2024,5,85326,80464,4862,5.7
MT2645900000000,26,45900,"Traverse City, MI MSA",2024,5,81973,78556,3417,4.2
MT2720260000000,27,20260,"Duluth, MN-WI MSA",2024,5,140339,135134,5205,3.7
MT2731860000000,27,31860,"Mankato, MN MSA",2024,5,60668,59007,1661,2.7
MT2733460000000,27,33460,"Minneapolis-St. Paul-Bloomington, MN-WI MSA",2024,5,2071330,2009194,62136,3
MT2740340000000,27,40340,"Rochester, MN MSA",2024,5,127377,124113,3264,2.6
MT2741060000000,27,41060,"St. Cloud, MN MSA",2024,5,110944,107328,3616,3.3
MT2825060000000,28,25060,"Gulfport-Biloxi, MS MSA",2024,5,187183,182222,4961,2.7
MT2825620000000,28,25620,"Hattiesburg, MS MSA",2024,5,70240,68378,1862,2.7
MT2827140000000,28,27140,"Jackson, MS MSA",2024,5,280921,273756,7165,2.6
MT2916020000000,29,16020,"Cape Girardeau, MO-IL MSA",2024,5,49243,47464,1779,3.6
MT2917860000000,29,17860,"Columbia, MO MSA",2024,5,112733,109041,3692,3.3
MT2927620000000,29,27620,"Jefferson City, MO MSA",2024,5,76502,74045,2457,3.2
MT2927900000000,29,27900,"Joplin, MO-KS MSA",2024,5,98103,94472,3631,3.7
MT2928140000000,29,28140,"Kansas City, MO-KS MSA",2024,5,1199898,1156653,43245,3.6
MT2941140000000,29,41140,"St. Joseph, MO-KS MSA",2024,5,54612,52512,2100,3.8
MT2941180000000,29,41180,"St. Louis, MO-IL MSA",2024,5,1487389,1430676,56713,3.8
MT2944180000000,29,44180,"Springfield, MO MSA",2024,5,243426,234966,8460,3.5
MT3013740000000,30,13740,"Billings, MT MSA",2024,5,99236,96419,2817,2.8
MT3014580000000,30,14580,"Bozeman, MT MSA",2024,5,78380,76554,1826,2.3
MT3024500000000,30,24500,"Great Falls, MT MSA",2024,5,40002,38815,1187,3
MT3025740000000,30,25740,"Helena, MT MSA",2024,5,47908,46573,1335,2.8
MT3033540000000,30,33540,"Missoula, MT MSA",2024,5,74236,72071,2165,2.9
MT3124260000000,31,24260,"Grand Island, NE MSA",2024,5,42961,41808,1153,2.7
MT3130700000000,31,30700,"Lincoln, NE MSA",2024,5,193454,188625,4829,2.5
MT3136540000000,31,36540,"Omaha, NE-IA MSA",2024,5,526876,511265,15611,3
MT3216180000000,32,16180,"Carson City, NV MSA",2024,5,29214,27829,1385,4.7
MT3229820000000,32,29820,"Las Vegas-Henderson-North Las Vegas, NV MSA",2024,5,1217152,1147189,69963,5.7
MT3239900000000,32,39900,"Reno, NV MSA",2024,5,298203,283729,14474,4.9
MT3331700000000,33,31700,"Manchester-Nashua, NH MSA",2024,5,240657,234323,6334,2.6
MT3412100000000,34,12100,"Atlantic City-Hammonton, NJ MSA",2024,5,180363,169156,11207,6.2
MT3445940000000,34,45940,"Trenton-Princeton, NJ MSA",2024,5,199896,191197,8699,4.4
MT3447220000000,34,47220,"Vineland, NJ MSA",2024,5,65488,60892,4596,7
MT3510740000000,35,10740,"Albuquerque, NM MSA",2024,5,463024,445354,17670,3.8
MT3522140000000,35,22140,"Farmington, NM MSA",2024,5,49892,47574,2318,4.6
MT3529740000000,35,29740,"Las Cruces, NM MSA",2024,5,102390,97340,5050,4.9
MT3542140000000,35,42140,"Santa Fe, NM MSA",2024,5,74092,71438,2654,3.6
MT3610580000000,36,10580,"Albany-Schenectady-Troy, NY MSA",2024,5,457399,441955,15444,3.4
MT3613780000000,36,13780,"Binghamton, NY MSA",2024,5,106570,102375,4195,3.9
MT3615380000000,36,15380,"Buffalo-Cheektowaga, NY MSA",2024,5,559182,537199,21983,3.9
MT3621300000000,36,21300,"Elmira, NY MSA",2024,5,35255,33934,1321,3.7
MT3624020000000,36,24020,"Glens Falls, NY MSA",2024,5,59555,57394,2161,3.6
MT3627060000000,36,27060,"Ithaca, NY MSA",2024,5,48234,46639,1595,3.3
MT3628740000000,36,28740,"Kingston, NY MSA",2024,5,87100,83943,3157,3.6
MT3628880000000,36,28880,"Kiryas Joel-Poughkeepsie-Newburgh, NY MSA",2024,5,339489,327581,11908,3.5
MT3635620000000,36,35620,"New York-Newark-Jersey City, NY-NJ MSA",2024,5,10212163,9752347,459816,4.5
MT3640380000000,36,40380,"Rochester, NY MSA",2024,5,513847,494862,18985,3.7
MT3645060000000,36,45060,"Syracuse, NY MSA",2024,5,310926,299455,11471,3.7
MT3646540000000,36,46540,"Utica-Rome, NY MSA",2024,5,127408,122459,4949,3.9
MT3648060000000,36,48060,"Watertown-Fort Drum, NY MSA",2024,5,44853,42835,2018,4.5
MT3711700000000,37,11700,"Asheville, NC MSA",2024,5,212269,206074,6195,2.9
MT3715500000000,37,15500,"Burlington, NC MSA",2024,5,86211,83077,3134,3.6
MT3716740000000,37,16740,"Charlotte-Concord-Gastonia, NC-SC MSA",2024,5,1481449,1427280,54169,3.7
MT3720500000000,37,20500,"Durham-Chapel Hill, NC MSA",2024,5,323303,312757,10546,3.3
MT3722180000000,37,22180,"Fayetteville, NC MSA",2024,5,154117,147056,7061,4.6
MT3724140000000,37,24140,"Goldsboro, NC MSA",2024,5,50899,48989,1910,3.8
MT3724660000000,37,24660,"Greensboro-High Point, NC MSA",2024,5,373109,357878,15231,4.1
MT3724780000000,37,24780,"Greenville, NC MSA",2024,5,84074,80662,3412,4.1
MT3725860000000,37,25860,"Hickory-Lenoir-Morganton, NC MSA",2024,5,170976,164862,6114,3.6
MT3727340000000,37,27340,"Jacksonville, NC MSA",2024,5,74251,71424,2827,3.8
MT3738240000000,37,38240,"Pinehurst-Southern Pines, NC MSA",2024,5,45020,43484,1536,3.4
MT3739580000000,37,39580,"Raleigh-Cary, NC MSA",2024,5,846476,819792,26684,3.2
MT3740580000000,37,40580,"Rocky Mount, NC MSA",2024,5,64110,61082,3028,4.7
MT3748900000000,37,48900,"Wilmington, NC MSA",2024,5,223432,215498,7934,3.6
MT3749180000000,37,49180,"Winston-Salem, NC MSA",2024,5,324824,312819,12005,3.7
MT3813900000000,38,13900,"Bismarck, ND MSA",2024,5,73026,71331,1695,2.3
MT3822020000000,38,22020,"Fargo, ND-MN MSA",2024,5,154122,150605,3517,2.3
MT3824220000000,38,24220,"Grand Forks, ND-MN MSA",2024,5,56642,55262,1380,2.4
MT3833500000000,38,33500,"Minot, ND MSA",2024,5,40229,39260,969,2.4
MT3910420000000,39,10420,"Akron, OH MSA",2024,5,361022,345052,15970,4.4
MT3915940000000,39,15940,"Canton-Massillon, OH MSA",2024,5,195424,186575,8849,4.5
MT3917140000000,39,17140,"Cincinnati, OH-KY-IN MSA",2024,5,1172703,1123334,49369,4.2
MT3917410000000,39,17410,"Cleveland, OH MSA",2024,5,1098274,1056306,41968,3.8
MT3918140000000,39,18140,"Columbus, OH MSA",2024,5,1159797,1113593,46204,4
MT3919430000000,39,19430,"Dayton-Kettering-Beavercreek, OH MSA",2024,5,396002,378751,17251,4.4
MT3930620000000,39,30620,"Lima, OH MSA",2024,5,47656,45559,2097,4.4
MT3931900000000,39,31900,"Mansfield, OH MSA",2024,5,53696,51013,2683,5
MT3941780000000,39,41780,"Sandusky, OH MSA",2024,5,57396,54298,3098,5.4
MT3944220000000,39,44220,"Springfield, OH MSA",2024,5,62400,59562,2838,4.5
MT3945780000000,39,45780,"Toledo, OH MSA",2024,5,296372,282121,14251,4.8
MT3948260000000,39,48260,"Weirton-Steubenville, WV-OH MSA",2024,5,51812,48870,2942,5.7
MT3949660000000,39,49660,"Youngstown-Warren, OH MSA",2024,5,193078,183341,9737,5
MT4021420000000,40,21420,"Enid, OK MSA",2024,5,28333,27393,940,3.3
MT4030020000000,40,30020,"Lawton, OK MSA",2024,5,52420,50503,1917,3.7
MT4036420000000,40,36420,"Oklahoma City, OK MSA",2024,5,773868,750124,23744,3.1
MT4046140000000,40,46140,"Tulsa, OK MSA",2024,5,524093,506801,17292,3.3
MT4110540000000,41,10540,"Albany, OR MSA",2024,5,61469,58674,2795,4.5
MT4113460000000,41,13460,"Bend, OR MSA",2024,5,133422,127768,5654,4.2
MT4118700000000,41,18700,"Corvallis, OR MSA",2024,5,49571,47888,1683,3.4
MT4121660000000,41,21660,"Eugene-Springfield, OR MSA",2024,5,188764,181051,7713,4.1
MT4124420000000,41,24420,"Grants Pass, OR MSA",2024,5,35297,33317,1980,5.6
MT4132780000000,41,32780,"Medford, OR MSA",2024,5,106347,101273,5074,4.8
MT4138900000000,41,38900,"Portland-Vancouver-Hillsboro, OR-WA MSA",2024,5,1383479,1329760,53719,3.9
MT4141420000000,41,41420,"Salem, OR MSA",2024,5,220635,211920,8715,3.9
MT4210900000000,42,10900,"Allentown-Bethlehem-Easton, PA-NJ MSA",2024,5,452738,435452,17286,3.8
MT4211020000000,42,11020,"Altoona, PA MSA",2024,5,57626,55610,2016,3.5
MT4216540000000,42,16540,"Chambersburg, PA MSA",2024,5,77299,74940,2359,3.1
MT4221500000000,42,21500,"Erie, PA MSA",2024,5,127363,122601,4762,3.7
MT4223900000000,42,23900,"Gettysburg, PA MSA",2024,5,51887,50308,1579,3
MT4225420000000,42,25420,"Harrisburg-Carlisle, PA MSA",2024,5,313539,303264,10275,3.3
MT4227780000000,42,27780,"Johnstown, PA MSA",2024,5,56857,54450,2407,4.2
MT4229540000000,42,29540,"Lancaster, PA MSA",2024,5,292878,284552,8326,2.8
MT4230140000000,42,30140,"Lebanon, PA MSA",2024,5,73523,71243,2280,3.1
MT4237980000000,42,37980,"Philadelphia-Camden-Wilmington, PA-NJ-DE-MD MSA",2024,5,3302741,3177190,125551,3.8
MT4238300000000,42,38300,"Pittsburgh, PA MSA",2024,5,1241383,1196606,44777,3.6
MT4239740000000,42,39740,"Reading, PA MSA",2024,5,219392,211331,8061,3.7
MT4242540000000,42,42540,"Scranton--Wilkes-Barre, PA MSA",2024,5,281217,269277,11940,4.2
MT4244300000000,42,44300,"State College, PA MSA",2024,5,76689,74509,2180,2.8
MT4248700000000,42,48700,"Williamsport, PA MSA",2024,5,53090,51005,2085,3.9
MT4249620000000,42,49620,"York-Hanover, PA MSA",2024,5,240837,232800,8037,3.3
MT4439300000000,44,39300,"Providence-Warwick, RI-MA MSA",2024,5,904116,864088,40028,4.4
MT4516700000000,45,16700,"Charleston-North Charleston, SC MSA",2024,5,443289,427788,15501,3.5
MT4517900000000,45,17900,"Columbia, SC MSA",2024,5,419689,402730,16959,4
MT4522500000000,45,22500,"Florence, SC MSA",2024,5,92378,88141,4237,4.6
MT4524860000000,45,24860,"Greenville-Anderson-Greer, SC MSA",2024,5,479631,461222,18409,3.8
MT4525940000000,45,25940,"Hilton Head Island-Bluffton-Port Royal, SC MSA",2024,5,98024,94189,3835,3.9
MT4534820000000,45,34820,"Myrtle Beach-Conway-North Myrtle Beach, SC MSA",2024,5,170958,162830,8128,4.8
MT4543900000000,45,43900,"Spartanburg, SC MSA",2024,5,177063,169517,7546,4.3
MT4544940000000,45,44940,"Sumter, SC MSA",2024,5,41908,39785,2123,5.1
MT4639660000000,46,39660,"Rapid City, SD MSA",2024,5,79290,77875,1415,1.8
MT4643620000000,46,43620,"Sioux Falls, SD-MN MSA",2024,5,174577,171674,2903,1.7
MT4716860000000,47,16860,"Chattanooga, TN-GA MSA",2024,5,291878,282898,8980,3.1
MT4717300000000,47,17300,"Clarksville, TN-KY MSA",2024,5,138760,133284,5476,3.9
MT4717420000000,47,17420,"Cleveland, TN MSA",2024,5,56357,54356,2001,3.6
MT4727180000000,47,27180,"Jackson, TN MSA",2024,5,78051,75197,2854,3.7
MT4727740000000,47,27740,"Johnson City, TN MSA",2024,5,96918,93716,3202,3.3
MT4728700000000,47,28700,"Kingsport-Bristol, TN-VA MSA",2024,5,132726,128169,4557,3.4
MT4728940000000,47,28940,"Knoxville, TN MSA",2024,5,451779,438155,13624,3
MT4732820000000,47,32820,"Memphis, TN-MS-AR MSA",2024,5,625306,601108,24198,3.9
MT4734100000000,47,34100,"Morristown, TN MSA",2024,5,53653,51834,1819,3.4
MT4734980000000,47,34980,"Nashville-Davidson--Murfreesboro--Franklin, TN MSA",2024,5,1160894,1129800,31094,2.7
MT4810180000000,48,10180,"Abilene, TX MSA",2024,5,86561,83565,2996,3.5
MT4811100000000,48,11100,"Amarillo, TX MSA",2024,5,137330,133007,4323,3.1
MT4812420000000,48,12420,"Austin-Round Rock-San Marcos, TX MSA",2024,5,1499604,1446762,52842,3.5
MT4813140000000,48,13140,"Beaumont-Port Arthur, TX MSA",2024,5,182342,172311,10031,5.5
MT4815180000000,48,15180,"Brownsville-Harlingen, TX MSA",2024,5,189196,179200,9996,5.3
MT4817780000000,48,17780,"College Station-Bryan, TX MSA",2024,5,150957,145777,5180,3.4
MT4818580000000,48,18580,"Corpus Christi, TX MSA",2024,5,208556,199295,9261,4.4
MT4819100000000,48,19100,"Dallas-Fort Worth-Arlington, TX MSA",2024,5,4477650,4303138,174512,3.9
MT4820580000000,48,20580,"Eagle Pass, TX MSA",2024,5,23939,22048,1891,7.9
MT4821340000000,48,21340,"El Paso, TX MSA",2024,5,414224,396956,17268,4.2
MT4826420000000,48,26420,"Houston-Pasadena-The Woodlands, TX MSA",2024,5,3825049,3659575,165474,4.3
MT4828660000000,48,28660,"Killeen-Temple, TX MSA",2024,5,202305,193459,8846,4.4
MT4829700000000,48,29700,"Laredo, TX MSA",2024,5,118469,113506,4963,4.2
MT4830980000000,48,30980,"Longview, TX MSA",2024,5,129013,123108,5905,4.6
MT4831180000000,48,31180,"Lubbock, TX MSA",2024,5,184305,177922,6383,3.5
MT4832580000000,48,32580,"McAllen-Edinburg-Mission, TX MSA",2024,5,395167,371429,23738,6
MT4833260000000,48,33260,"Midland, TX MSA",2024,5,103500,100518,2982,2.9
MT4836220000000,48,36220,"Odessa, TX MSA",2024,5,86409,83457,2952,3.4
MT4841660000000,48,41660,"San Angelo, TX MSA",2024,5,61978,60002,1976,3.2
MT4841700000000,48,41700,"San Antonio-New Braunfels, TX MSA",2024,5,1332025,1281758,50267,3.8
MT4843300000000,48,43300,"Sherman-Denison, TX MSA",2024,5,71277,68504,2773,3.9
MT4845500000000,48,45500,"Texarkana, TX-AR MSA",2024,5,61829,59256,2573,4.2
MT4846340000000,48,46340,"Tyler, TX MSA",2024,5,117887,113308,4579,3.9
MT4847020000000,48,47020,"Victoria, TX MSA",2024,5,44941,43131,1810,4
MT4847380000000,48,47380,"Waco, TX MSA",2024,5,146125,140547,5578,3.8
MT4848660000000,48,48660,"Wichita Falls, TX MSA",2024,5,66793,64227,2566,3.8
MT4930860000000,49,30860,"Logan, UT-ID MSA",2024,5,79841,77549,2292,2.9
MT4936260000000,49,36260,"Ogden, UT MSA",2024,5,351634,340870,10764,3.1
MT4939340000000,49,39340,"Provo-Orem-Lehi, UT MSA",2024,5,370244,358050,12194,3.3
MT4941100000000,49,41100,"St. George, UT MSA",2024,5,93586,90414,3172,3.4
MT4941620000000,49,41620,"Salt Lake City-Murray, UT MSA",2024,5,737910,714300,23610,3.2
MT5015540000000,50,15540,"Burlington-South Burlington, VT MSA",2024,5,131465,128925,2540,1.9
MT5113980000000,51,13980,"Blacksburg-Christiansburg-Radford, VA MSA",2024,5,93154,90342,2812,3
MT5116820000000,51,16820,"Charlottesville, VA MSA",2024,5,121082,118046,3036,2.5
MT5125500000000,51,25500,"Harrisonburg, VA MSA",2024,5,72609,70576,2033,2.8
MT5131340000000,51,31340,"Lynchburg, VA MSA",2024,5,127509,123414,4095,3.2
MT5140060000000,51,40060,"Richmond, VA MSA",2024,5,728716,707222,21494,2.9
MT5140220000000,51,40220,"Roanoke, VA MSA",2024,5,158610,153975,4635,2.9
MT5144420000000,51,44420,"Staunton-Stuarts Draft, VA MSA",2024,5,65642,63972,1670,2.5
MT5147260000000,51,47260,"Virginia Beach-Chesapeake-Norfolk, VA-NC MSA",2024,5,883176,856124,27052,3.1
MT5149020000000,51,49020,"Winchester, VA-WV MSA",2024,5,77604,75501,2103,2.7
MT5313380000000,53,13380,"Bellingham, WA MSA",2024,5,114643,109466,5177,4.5
MT5314740000000,53,14740,"Bremerton-Silverdale-Port Orchard, WA MSA",2024,5,122619,117151,5468,4.5
MT5328420000000,53,28420,"Kennewick-Richland, WA MSA",2024,5,146789,139362,7427,5.1
MT5331020000000,53,31020,"Longview-Kelso, WA MSA",2024,5,47428,44959,2469,5.2
MT5334580000000,53,34580,"Mount Vernon-Anacortes, WA MSA",2024,5,59573,56594,2979,5
MT5336500000000,53,36500,"Olympia-Lacey-Tumwater, WA MSA",2024,5,143987,137517,6470,4.5
MT5342660000000,53,42660,"Seattle-Tacoma-Bellevue, WA MSA",2024,5,2320013,2221242,98771,4.3
MT5344060000000,53,44060,"Spokane-Spokane Valley, WA MSA",2024,5,283426,270497,12929,4.6
MT5347460000000,53,47460,"Walla Walla, WA MSA",2024,5,29432,28144,1288,4.4
MT5348300000000,53,48300,"Wenatchee-East Wenatchee, WA MSA",2024,5,62249,59224,3025,4.9
MT5349420000000,53,49420,"Yakima, WA MSA",2024,5,125335,117668,7667,6.1
MT5413220000000,54,13220,"Beckley, WV MSA",2024,5,46449,44561,1888,4.1
MT5416620000000,54,16620,"Charleston, WV MSA",2024,5,91203,87550,3653,4
MT5426580000000,54,26580,"Huntington-Ashland, WV-KY-OH MSA",2024,5,157489,149744,7745,4.9
MT5434060000000,54,34060,"Morgantown, WV MSA",2024,5,70963,68531,2432,3.4
MT5437620000000,54,37620,"Parkersburg-Vienna, WV MSA",2024,5,39488,37803,1685,4.3
MT5448540000000,54,48540,"Wheeling, WV-OH MSA",2024,5,59781,56913,2868,4.8
MT5511540000000,55,11540,"Appleton, WI MSA",2024,5,137381,133976,3405,2.5
MT5520740000000,55,20740,"Eau Claire, WI MSA",2024,5,96317,93597,2720,2.8
MT5522540000000,55,22540,"Fond du Lac, WI MSA",2024,5,55749,54231,1518,2.7
MT5524580000000,55,24580,"Green Bay, WI MSA",2024,5,178928,174215,4713,2.6
MT5527500000000,55,27500,"Janesville-Beloit, WI MSA",2024,5,86984,84170,2814,3.2
MT5528450000000,55,28450,"Kenosha, WI MSA",2024,5,95649,92634,3015,3.2
MT5529100000000,55,29100,"La Crosse-Onalaska, WI-MN MSA",2024,5,90473,88068,2405,2.7
MT5531540000000,55,31540,"Madison, WI MSA",2024,5,410640,400925,9715,2.4
MT5533340000000,55,33340,"Milwaukee-Waukesha, WI MSA",2024,5,817579,791542,26037,3.2
MT5536780000000,55,36780,"Oshkosh-Neenah, WI MSA",2024,5,93121,90648,2473,2.7
MT5539540000000,55,39540,"Racine-Mount Pleasant, WI MSA",2024,5,101645,98095,3550,3.5
MT5543100000000,55,43100,"Sheboygan, WI MSA",2024,5,63322,61759,1563,2.5
MT5548140000000,55,48140,"Wausau, WI MSA",2024,5,75465,73500,1965,2.6
MT5616220000000,56,16220,"Casper, WY MSA",2024,5,42113,40802,1311,3.1
MT5616940000000,56,16940,"Cheyenne, WY MSA",2024,5,49005,47384,1621,3.3
MT7210380000000,72,10380,"Aguadilla, PR MSA",2024,5,90567,84242,6325,7
MT7211640000000,72,11640,"Arecibo, PR MSA",2024,5,67595,63756,3839,5.7
MT7225020000000,72,25020,"Guayama, PR MSA",2024,5,19046,17153,1893,9.9
MT7232420000000,72,32420,"Mayaguez, PR MSA",2024,5,66560,61717,4843,7.3
MT7238660000000,72,38660,"Ponce, PR MSA",2024,5,89023,80939,8084,9.1
MT7241980000000,72,41980,"San Juan-Bayamon-Caguas, PR MSA",2024,5,808845,769781,39064,4.8
MT0111500000000,1,11500,"Anniston-Oxford, AL MSA",2024,6,49501,47972,1529,3.1
MT0112220000000,1,12220,"Auburn-Opelika, AL MSA",2024,6,96428,93579,2849,3
MT0113820000000,1,13820,"Birmingham, AL MSA",2024,6,572215,556476,15739,2.8
MT0119300000000,1,19300,"Daphne-Fairhope-Foley, AL MSA",2024,6,115631,112467,3164,2.7
MT0119460000000,1,19460,"Decatur, AL MSA",2024,6,75619,73684,1935,2.6
MT0120020000000,1,20020,"Dothan, AL MSA",2024,6,67715,65713,2002,3
MT0122520000000,1,22520,"Florence-Muscle Shoals, AL MSA",2024,6,68962,66767,2195,3.2
MT0123460000000,1,23460,"Gadsden, AL MSA",2024,6,42037,40717,1320,3.1
MT0126620000000,1,26620,"Huntsville, AL MSA",2024,6,276180,269365,6815,2.5
MT0133660000000,1,33660,"Mobile, AL MSA",2024,6,185380,178814,6566,3.5
MT0133860000000,1,33860,"Montgomery, AL MSA",2024,6,178399,173078,5321,3
MT0146220000000,1,46220,"Tuscaloosa, AL MSA",2024,6,126641,122633,4008,3.2
MT0211260000000,2,11260,"Anchorage, AK MSA",2024,6,201043,192570,8473,4.2
MT0221820000000,2,21820,"Fairbanks-College, AK MSA",2024,6,45743,43882,1861,4.1
MT0422380000000,4,22380,"Flagstaff, AZ MSA",2024,6,75714,72852,2862,3.8
MT0429420000000,4,29420,"Lake Havasu City-Kingman, AZ MSA",2024,6,87514,83585,3929,4.5
MT0438060000000,4,38060,"Phoenix-Mesa-Chandler, AZ MSA",2024,6,2710511,2623914,86597,3.2
MT0439150000000,4,39150,"Prescott Valley-Prescott, AZ MSA",2024,6,106325,102600,3725,3.5
MT0443420000000,4,43420,"Sierra Vista-Douglas, AZ MSA",2024,6,48087,46055,2032,4.2
MT0446060000000,4,46060,"Tucson, AZ MSA",2024,6,491978,474496,17482,3.6
MT0449740000000,4,49740,"Yuma, AZ MSA",2024,6,98637,86747,11890,12.1
MT0522220000000,5,22220,"Fayetteville-Springdale-Rogers, AR MSA",2024,6,305960,297825,8135,2.7
MT0522900000000,5,22900,"Fort Smith, AR-OK MSA",2024,6,101179,97638,3541,3.5
MT0526300000000,5,26300,"Hot Springs, AR MSA",2024,6,43542,41977,1565,3.6
MT0527860000000,5,27860,"Jonesboro, AR MSA",2024,6,66313,64228,2085,3.1
MT0530780000000,5,30780,"Little Rock-North Little Rock-Conway, AR MSA",2024,6,380264,368001,12263,3.2
MT0612540000000,6,12540,"Bakersfield-Delano, CA MSA",2024,6,406971,371431,35540,8.7
MT0617020000000,6,17020,"Chico, CA MSA",2024,6,91395,85974,5421,5.9
MT0620940000000,6,20940,"El Centro, CA MSA",2024,6,73032,59711,13321,18.2
MT0623420000000,6,23420,"Fresno, CA MSA",2024,6,538876,496006,42870,8
MT0625260000000,6,25260,"Hanford-Corcoran, CA MSA",2024,6,58331,53107,5224,9
MT0631080000000,6,31080,"Los Angeles-Long Beach-Anaheim, CA MSA",2024,6,6739138,6375801,363337,5.4
MT0632900000000,6,32900,"Merced, CA MSA",2024,6,120408,108520,11888,9.9
MT0633700000000,6,33700,"Modesto, CA MSA",2024,6,252794,235246,17548,6.9
MT0634900000000,6,34900,"Napa, CA MSA",2024,6,74239,71310,2929,3.9
MT0637100000000,6,37100,"Oxnard-Thousand Oaks-Ventura, CA MSA",2024,6,421921,402598,19323,4.6
MT0639820000000,6,39820,"Redding, CA MSA",2024,6,79049,74796,4253,5.4
MT0640140000000,6,40140,"Riverside-San Bernardino-Ontario, CA MSA",2024,6,2207699,2092482,115217,5.2
MT0640900000000,6,40900,"Sacramento-Roseville-Folsom, CA MSA",2024,6,1180886,1125952,54934,4.7
MT0641500000000,6,41500,"Salinas, CA MSA",2024,6,220126,204051,16075,7.3
MT0641740000000,6,41740,"San Diego-Chula Vista-Carlsbad, CA MSA",2024,6,1647886,1577339,70547,4.3
MT0641860000000,6,41860,"San Francisco-Oakland-Fremont, CA MSA",2024,6,2502041,2398395,103646,4.1
MT0641940000000,6,41940,"San Jose-Sunnyvale-Santa Clara, CA MSA",2024,6,1057848,1013569,44279,4.2
MT0642020000000,6,42020,"San Luis Obispo-Paso Robles, CA MSA",2024,6,132510,127139,5371,4.1
MT0642100000000,6,42100,"Santa Cruz-Watsonville, CA MSA",2024,6,135985,127912,8073,5.9
MT0642200000000,6,42200,"Santa Maria-Santa Barbara, CA MSA",2024,6,221310,211406,9904,4.5
MT0642220000000,6,42220,"Santa Rosa-Petaluma, CA MSA",2024,6,246529,236396,10133,4.1
MT0644700000000,6,44700,"Stockton-Lodi, CA MSA",2024,6,367605,343775,23830,6.5
MT0646700000000,6,46700,"Vallejo, CA MSA",2024,6,216543,205799,10744,5
MT0647300000000,6,47300,"Visalia, CA MSA",2024,6,220030,197238,22792,10.4
MT0649700000000,6,49700,"Yuba City, CA MSA",2024,6,81110,74686,6424,7.9
MT0814500000000,8,14500,"Boulder, CO MSA",2024,6,193931,185692,8239,4.2
MT0817820000000,8,17820,"Colorado Springs, CO MSA",2024,6,395651,378966,16685,4.2
MT0819740000000,8,19740,"Denver-Aurora-Centennial, CO MSA",2024,6,1774605,1700344,74261,4.2
MT0822660000000,8,22660,"Fort Collins-Loveland, CO MSA",2024,6,208169,199731,8438,4.1
MT0824300000000,8,24300,"Grand Junction, CO MSA",2024,6,79854,76332,3522,4.4
MT0824540000000,8,24540,"Greeley, CO MSA",2024,6,178668,170731,7937,4.4
MT0839380000000,8,39380,"Pueblo, CO MSA",2024,6,73627,69351,4276,5.8
MT0914860000000,9,14860,"Bridgeport-Stamford-Danbury, CT MSA",2024,6,516800,501123,15677,3
MT0925540000000,9,25540,"Hartford-West Hartford-East Hartford, CT MSA",2024,6,613896,594687,19209,3.1
MT0935300000000,9,35300,"New Haven, CT MSA",2024,6,316311,306434,9877,3.1
MT0935980000000,9,35980,"Norwich-New London-Willimantic, CT MSA",2024,6,142983,138653,4330,3
MT0947930000000,9,47930,"Waterbury-Shelton, CT MSA",2024,6,240415,231892,8523,3.5
MT1020100000000,10,20100,"Dover, DE MSA",2024,6,85592,82081,3511,4.1
MT1147900000000,11,47900,"Washington-Arlington-Alexandria, DC-VA-MD-WV MSA",2024,6,3557171,3449736,107435,3
MT1215980000000,12,15980,"Cape Coral-Fort Myers, FL MSA",2024,6,376838,363489,13349,3.5
MT1218880000000,12,18880,"Crestview-Fort Walton Beach-Destin, FL MSA",2024,6,142788,138293,4495,3.1
MT1219660000000,12,19660,"Deltona-Daytona Beach-Ormond Beach, FL MSA",2024,6,322243,309618,12625,3.9
MT1223540000000,12,23540,"Gainesville, FL MSA",2024,6,169436,162996,6440,3.8
MT1226140000000,12,26140,"Homosassa Springs, FL MSA",2024,6,53793,51095,2698,5
MT1227260000000,12,27260,"Jacksonville, FL MSA",2024,6,855007,825318,29689,3.5
MT1229460000000,12,29460,"Lakeland-Winter Haven, FL MSA",2024,6,358261,342961,15300,4.3
MT1233100000000,12,33100,"Miami-Fort Lauderdale-West Palm Beach, FL MSA",2024,6,3313322,3216741,96581,2.9
MT1234940000000,12,34940,"Naples-Marco Island, FL MSA",2024,6,187573,181353,6220,3.3
MT1235840000000,12,35840,"North Port-Bradenton-Sarasota, FL MSA",2024,6,400408,386285,14123,3.5
MT1236100000000,12,36100,"Ocala, FL MSA",2024,6,158883,152110,6773,4.3
MT1236740000000,12,36740,"Orlando-Kissimmee-Sanford, FL MSA",2024,6,1533651,1482896,50755,3.3
MT1237340000000,12,37340,"Palm Bay-Melbourne-Titusville, FL MSA",2024,6,304875,294031,10844,3.6
MT1237460000000,12,37460,"Panama City-Panama City Beach, FL MSA",2024,6,101985,98508,3477,3.4
MT1237860000000,12,37860,"Pensacola-Ferry Pass-Brent, FL MSA",2024,6,240299,231748,8551,3.6
MT1238940000000,12,38940,"Port St. Lucie, FL MSA",2024,6,240552,231317,9235,3.8
MT1239460000000,12,39460,"Punta Gorda, FL MSA",2024,6,77602,74448,3154,4.1
MT1242680000000,12,42680,"Sebastian-Vero Beach-West Vero Corridor, FL MSA",2024,6,68150,65427,2723,4
MT1242700000000,12,42700,"Sebring, FL MSA",2024,6,36653,34857,1796,4.9
MT1245220000000,12,45220,"Tallahassee, FL MSA",2024,6,207773,200501,7272,3.5
MT1245300000000,12,45300,"Tampa-St. Petersburg-Clearwater, FL MSA",2024,6,1701788,1643081,58707,3.4
MT1248680000000,12,48680,"Wildwood-The Villages, FL MSA",2024,6,34146,32227,1919,5.6
MT1310500000000,13,10500,"Albany, GA MSA",2024,6,62600,59941,2659,4.2
MT1312020000000,13,12020,"Athens-Clarke County, GA MSA",2024,6,108365,104636,3729,3.4
MT1312060000000,13,12060,"Atlanta-Sandy Springs-Roswell, GA MSA",2024,6,3313099,3197553,115546,3.5
MT1312260000000,13,12260,"Augusta-Richmond County, GA-SC MSA",2024,6,269739,257795,11944,4.4
MT1315260000000,13,15260,"Brunswick-St. Simons, GA MSA",2024,6,55749,53961,1788,3.2
MT1317980000000,13,17980,"Columbus, GA-AL MSA",2024,6,128780,123562,5218,4.1
MT1319140000000,13,19140,"Dalton, GA MSA",2024,6,67458,64762,2696,4
MT1323580000000,13,23580,"Gainesville, GA MSA",2024,6,109348,106096,3252,3
MT1325980000000,13,25980,"Hinesville, GA MSA",2024,6,31367,30073,1294,4.1
MT1331420000000,13,31420,"Macon-Bibb County, GA MSA",2024,6,97215,93007,4208,4.3
MT1340660000000,13,40660,"Rome, GA MSA",2024,6,47680,45935,1745,3.7
MT1342340000000,13,42340,"Savannah, GA MSA",2024,6,210538,203867,6671,3.2
MT1346660000000,13,46660,"Valdosta, GA MSA",2024,6,61701,59212,2489,4
MT1347580000000,13,47580,"Warner Robins, GA MSA",2024,6,90002,87006,2996,3.3
MT1527980000000,15,27980,"Kahului-Wailuku, HI MSA",2024,6,81467,78057,3410,4.2
MT1546520000000,15,46520,"Urban Honolulu, HI MSA",2024,6,471023,458380,12643,2.7
MT1614260000000,16,14260,"Boise City, ID MSA",2024,6,446994,431055,15939,3.6
MT1617660000000,16,17660,"Coeur d'Alene, ID MSA",2024,6,89887,85886,4001,4.5
MT1626820000000,16,26820,"Idaho Falls, ID MSA",2024,6,84644,81929,2715,3.2
MT1630300000000,16,30300,"Lewiston, ID-WA MSA",2024,6,31114,29953,1161,3.7
MT1638540000000,16,38540,"Pocatello, ID MSA",2024,6,40999,39336,1663,4.1
MT1646300000000,16,46300,"Twin Falls, ID MSA",2024,6,60280,58143,2137,3.5
MT1714010000000,17,14010,"Bloomington, IL MSA",2024,6,96952,93012,3940,4.1
MT1716580000000,17,16580,"Champaign-Urbana, IL MSA",2024,6,125142,119638,5504,4.4
MT1716980000000,17,16980,"Chicago-Naperville-Elgin, IL-IN MSA",2024,6,5013992,4746708,267284,5.3
MT1719340000000,17,19340,"Davenport-Moline-Rock Island, IA-IL MSA",2024,6,189085,180257,8828,4.7
MT1719500000000,17,19500,"Decatur, IL MSA",2024,6,44801,42119,2682,6
MT1728100000000,17,28100,"Kankakee, IL MSA",2024,6,51234,48188,3046,5.9
MT1737900000000,17,37900,"Peoria, IL MSA",2024,6,178346,169377,8969,5
MT1740420000000,17,40420,"Rockford, IL MSA",2024,6,160544,151355,9189,5.7
MT1744100000000,17,44100,"Springfield, IL MSA",2024,6,103789,99160,4629,4.5
MT1814020000000,18,14020,"Bloomington, IN MSA",2024,6,86336,82977,3359,3.9
MT1818020000000,18,18020,"Columbus, IN MSA",2024,6,39016,37380,1636,4.2
MT1821140000000,18,21140,"Elkhart-Goshen, IN MSA",2024,6,98005,93014,4991,5.1
MT1821780000000,18,21780,"Evansville, IN MSA",2024,6,135707,130390,5317,3.9
MT1823060000000,18,23060,"Fort Wayne, IN MSA",2024,6,232189,223410,8779,3.8
MT1826900000000,18,26900,"Indianapolis-Carmel-Greenwood, IN MSA",2024,6,1140713,1096475,44238,3.9
MT1829020000000,18,29020,"Kokomo, IN MSA",2024,6,36444,34334,2110,5.8
MT1829200000000,18,29200,"Lafayette-West Lafayette, IN MSA",2024,6,120493,115852,4641,3.9
MT1833140000000,18,33140,"Michigan City-La Porte, IN MSA",2024,6,51690,49255,2435,4.7
MT1834620000000,18,34620,"Muncie, IN MSA",2024,6,52853,50314,2539,4.8
MT1843780000000,18,43780,"South Bend-Mishawaka, IN-MI MSA",2024,6,154504,146699,7805,5.1
MT1845460000000,18,45460,"Terre Haute, IN MSA",2024,6,77858,74414,3444,4.4
MT1911180000000,19,11180,"Ames, IA MSA",2024,6,69449,67839,1610,2.3
MT1916300000000,19,16300,"Cedar Rapids, IA MSA",2024,6,145862,140971,4891,3.4
MT1919780000000,19,19780,"Des Moines-West Des Moines, IA MSA",2024,6,412951,400708,12243,3
MT1920220000000,19,20220,"Dubuque, IA MSA",2024,6,53273,51664,1609,3
MT1926980000000,19,26980,"Iowa City, IA MSA",2024,6,99431,97123,2308,2.3
MT1943580000000,19,43580,"Sioux City, IA-NE-SD MSA",2024,6,76509,74346,2163,2.8
MT1947940000000,19,47940,"Waterloo-Cedar Falls, IA MSA",2024,6,88017,85022,2995,3.4
MT2029940000000,20,29940,"Lawrence, KS MSA",2024,6,71267,68898,2369,3.3
MT2031740000000,20,31740,"Manhattan, KS MSA",2024,6,64402,62237,2165,3.4
MT2045820000000,20,45820,"Topeka, KS MSA",2024,6,118939,114539,4400,3.7
MT2048620000000,20,48620,"Wichita, KS MSA",2024,6,337378,324126,13252,3.9
MT2114540000000,21,14540,"Bowling Green, KY MSA",2024,6,93037,88663,4374,4.7
MT2121060000000,21,21060,"Elizabethtown, KY MSA",2024,6,55590,52721,2869,5.2
MT2130460000000,21,30460,"Lexington-Fayette, KY MSA",2024,6,278068,266351,11717,4.2
MT2131140000000,21,31140,"Louisville/Jefferson County, KY-IN MSA",2024,6,701456,669286,32170,4.6
MT2136980000000,21,36980,"Owensboro, KY MSA",2024,6,52267,49677,2590,5
MT2137140000000,21,37140,"Paducah, KY-IL MSA",2024,6,46118,43759,2359,5.1
MT2210780000000,22,10780,"Alexandria, LA MSA",2024,6,64158,61681,2477,3.9
MT2212940000000,22,12940,"Baton Rouge, LA MSA",2024,6,428403,411651,16752,3.9
MT2225220000000,22,25220,"Hammond, LA MSA",2024,6,60819,57953,2866,4.7
MT2226380000000,22,26380,"Houma-Bayou Cane-Thibodaux, LA MSA",2024,6,87724,84505,3219,3.7
MT2229180000000,22,29180,"Lafayette, LA MSA",2024,6,197503,190329,7174,3.6
MT2229340000000,22,29340,"Lake Charles, LA MSA",2024,6,98137,93917,4220,4.3
MT2233740000000,22,33740,"Monroe, LA MSA",2024,6,95848,91309,4539,4.7
MT2235380000000,22,35380,"New Orleans-Metairie, LA MSA",2024,6,467544,447517,20027,4.3
MT2243340000000,22,43340,"Shreveport-Bossier City, LA MSA",2024,6,167455,160297,7158,4.3
MT2243640000000,22,43640,"Slidell-Mandeville-Covington, LA MSA",2024,6,129124,124309,4815,3.7
MT2312620000000,23,12620,"Bangor, ME MSA",2024,6,75983,73604,2379,3.1
MT2330340000000,23,30340,"Lewiston-Auburn, ME MSA",2024,6,55639,53939,1700,3.1
MT2338860000000,23,38860,"Portland-South Portland, ME MSA",2024,6,314851,306721,8130,2.6
MT2412580000000,24,12580,"Baltimore-Columbia-Towson, MD MSA",2024,6,1499269,1452935,46334,3.1
MT2425180000000,24,25180,"Hagerstown-Martinsburg, MD-WV MSA",2024,6,144420,139606,4814,3.3
MT2430500000000,24,30500,"Lexington Park, MD MSA",2024,6,109675,106711,2964,2.7
MT2441540000000,24,41540,"Salisbury, MD MSA",2024,6,64432,62160,2272,3.5
MT2511200000000,25,11200,"Amherst Town-Northampton, MA MSA",2024,6,85789,82556,3233,3.8
MT2512700000000,25,12700,"Barnstable Town, MA MSA",2024,6,117358,111661,5697,4.9
MT2514460000000,25,14460,"Boston-Cambridge-Newton, MA-NH MSA",2024,6,2834964,2730292,104672,3.7
MT2538340000000,25,38340,"Pittsfield, MA MSA",2024,6,64255,61628,2627,4.1
MT2544140000000,25,44140,"Springfield, MA MSA",2024,6,225519,214047,11472,5.1
MT2549340000000,25,49340,"Worcester, MA MSA",2024,6,467531,448312,19219,4.1
MT2611460000000,26,11460,"Ann Arbor, MI MSA",2024,6,208733,200913,7820,3.7
MT2612980000000,26,12980,"Battle Creek, MI MSA",2024,6,64062,60710,3352,5.2
MT2613020000000,26,13020,"Bay City, MI MSA",2024,6,50484,47670,2814,5.6
MT2619820000000,26,19820,"Detroit-Warren-Dearborn, MI MSA",2024,6,2181292,2083607,97685,4.5
MT2622420000000,26,22420,"Flint, MI MSA",2024,6,190485,179684,10801,5.7
MT2624340000000,26,24340,"Grand Rapids-Wyoming-Kentwood, MI MSA",2024,6,632198,606638,25560,4
MT2627100000000,26,27100,"Jackson, MI MSA",2024,6,75300,71698,3602,4.8
MT2628020000000,26,28020,"Kalamazoo-Portage, MI MSA",2024,6,141202,135372,5830,4.1
MT2629620000000,26,29620,"Lansing-East Lansing, MI MSA",2024,6,255631,244305,11326,4.4
MT2633220000000,26,33220,"Midland, MI MSA",2024,6,43080,41139,1941,4.5
MT2633780000000,26,33780,"Monroe, MI MSA",2024,6,79796,75546,4250,5.3
MT2634740000000,26,34740,"Muskegon-Norton Shores, MI MSA",2024,6,85858,81505,4353,5.1
MT2635660000000,26,35660,"Niles, MI MSA",2024,6,77402,73485,3917,5.1
MT2640980000000,26,40980,"Saginaw, MI MSA",2024,6,85516,80515,5001,5.8
MT2645900000000,26,45900,"Traverse City, MI MSA",2024,6,82221,78653,3568,4.3
MT2720260000000,27,20260,"Duluth, MN-WI MSA",2024,6,140162,134904,5258,3.8
MT2731860000000,27,31860,"Mankato, MN MSA",2024,6,60697,59013,1684,2.8
MT2733460000000,27,33460,"Minneapolis-St. Paul-Bloomington, MN-WI MSA",2024,6,2070692,2007777,62915,3
MT2740340000000,27,40340,"Rochester, MN MSA",2024,6,127615,124271,3344,2.6
MT2741060000000,27,41060,"St. Cloud, MN MSA",2024,6,111264,107552,3712,3.3
MT2825060000000,28,25060,"Gulfport-Biloxi, MS MSA",2024,6,187870,182694,5176,2.8
MT2825620000000,28,25620,"Hattiesburg, MS MSA",2024,6,70372,68432,1940,2.8
MT2827140000000,28,27140,"Jackson, MS MSA",2024,6,282135,274663,7472,2.6
MT2916020000000,29,16020,"Cape Girardeau, MO-IL MSA",2024,6,49237,47438,1799,3.7
MT2917860000000,29,17860,"Columbia, MO MSA",2024,6,112780,109050,3730,3.3
MT2927620000000,29,27620,"Jefferson City, MO MSA",2024,6,76614,74132,2482,3.2
MT2927900000000,29,27900,"Joplin, MO-KS MSA",2024,6,98200,94566,3634,3.7
MT2928140000000,29,28140,"Kansas City, MO-KS MSA",2024,6,1201684,1158270,43414,3.6
MT2941140000000,29,41140,"St. Joseph, MO-KS MSA",2024,6,54734,52601,2133,3.9
MT2941180000000,29,41180,"St. Louis, MO-IL MSA",2024,6,1489183,1432278,56905,3.8
MT2944180000000,29,44180,"Springfield, MO MSA",2024,6,243862,235327,8535,3.5
MT3013740000000,30,13740,"Billings, MT MSA",2024,6,99320,96473,2847,2.9
MT3014580000000,30,14580,"Bozeman, MT MSA",2024,6,78503,76647,1856,2.4
MT3024500000000,30,24500,"Great Falls, MT MSA",2024,6,39961,38758,1203,3
MT3025740000000,30,25740,"Helena, MT MSA",2024,6,47925,46588,1337,2.8
MT3033540000000,30,33540,"Missoula, MT MSA",2024,6,74353,72170,2183,2.9
MT3124260000000,31,24260,"Grand Island, NE MSA",2024,6,42963,41790,1173,2.7
MT3130700000000,31,30700,"Lincoln, NE MSA",2024,6,193779,188806,4973,2.6
MT3136540000000,31,36540,"Omaha, NE-IA MSA",2024,6,527436,511484,15952,3
MT3216180000000,32,16180,"Carson City, NV MSA",2024,6,29332,27910,1422,4.8
MT3229820000000,32,29820,"Las Vegas-Henderson-North Las Vegas, NV MSA",2024,6,1218877,1147879,70998,5.8
MT3239900000000,32,39900,"Reno, NV MSA",2024,6,298775,284006,14769,4.9
MT3331700000000,33,31700,"Manchester-Nashua, NH MSA",2024,6,240978,234535,6443,2.7
MT3412100000000,34,12100,"Atlantic City-Hammonton, NJ MSA",2024,6,180550,169121,11429,6.3
MT3445940000000,34,45940,"Trenton-Princeton, NJ MSA",2024,6,199951,191141,8810,4.4
MT3447220000000,34,47220,"Vineland, NJ MSA",2024,6,65700,61024,4676,7.1
MT3510740000000,35,10740,"Albuquerque, NM MSA",2024,6,463860,445652,18208,3.9
MT3522140000000,35,22140,"Farmington, NM MSA",2024,6,49961,47592,2369,4.7
MT3529740000000,35,29740,"Las Cruces, NM MSA",2024,6,102421,97285,5136,5
MT3542140000000,35,42140,"Santa Fe, NM MSA",2024,6,74282,71520,2762,3.7
MT3610580000000,36,10580,"Albany-Schenectady-Troy, NY MSA",2024,6,457540,442083,15457,3.4
MT3613780000000,36,13780,"Binghamton, NY MSA",2024,6,106478,102231,4247,4
MT3615380000000,36,15380,"Buffalo-Cheektowaga, NY MSA",2024,6,558179,536177,22002,3.9
MT3621300000000,36,21300,"Elmira, NY MSA",2024,6,35199,33861,1338,3.8
MT3624020000000,36,24020,"Glens Falls, NY MSA",2024,6,59614,57438,2176,3.7
MT3627060000000,36,27060,"Ithaca, NY MSA",2024,6,48231,46627,1604,3.3
MT3628740000000,36,28740,"Kingston, NY MSA",2024,6,87049,83891,3158,3.6
MT3628880000000,36,28880,"Kiryas Joel-Poughkeepsie-Newburgh, NY MSA",2024,6,339372,327489,11883,3.5
MT3635620000000,36,35620,"New York-Newark-Jersey City, NY-NJ MSA",2024,6,10225205,9755791,469414,4.6
MT3640380000000,36,40380,"Rochester, NY MSA",2024,6,513921,495026,18895,3.7
MT3645060000000,36,45060,"Syracuse, NY MSA",2024,6,311383,299862,11521,3.7
MT3646540000000,36,46540,"Utica-Rome, NY MSA",2024,6,127214,122232,4982,3.9
MT3648060000000,36,48060,"Watertown-Fort Drum, NY MSA",2024,6,44821,42802,2019,4.5
MT3711700000000,37,11700,"Asheville, NC MSA",2024,6,212301,206063,6238,2.9
MT3715500000000,37,15500,"Burlington, NC MSA",2024,6,86229,83079,3150,3.7
MT3716740000000,37,16740,"Charlotte-Concord-Gastonia, NC-SC MSA",2024,6,1483176,1428244,54932,3.7
MT3720500000000,37,20500,"Durham-Chapel Hill, NC MSA",2024,6,323504,312947,10557,3.3
MT3722180000000,37,22180,"Fayetteville, NC MSA",2024,6,153995,146899,7096,4.6
MT3724140000000,37,24140,"Goldsboro, NC MSA",2024,6,51033,49105,1928,3.8
MT3724660000000,37,24660,"Greensboro-High Point, NC MSA",2024,6,372529,357211,15318,4.1
MT3724780000000,37,24780,"Greenville, NC MSA",2024,6,83952,80563,3389,4
MT3725860000000,37,25860,"Hickory-Lenoir-Morganton, NC MSA",2024,6,170994,164797,6197,3.6
MT3727340000000,37,27340,"Jacksonville, NC MSA",2024,6,74176,71349,2827,3.8
MT3738240000000,37,38240,"Pinehurst-Southern Pines, NC MSA",2024,6,45029,43488,1541,3.4
MT3739580000000,37,39580,"Raleigh-Cary, NC MSA",2024,6,847092,820418,26674,3.1
MT3740580000000,37,40580,"Rocky Mount, NC MSA",2024,6,64119,61060,3059,4.8
MT3748900000000,37,48900,"Wilmington, NC MSA",2024,6,223698,215728,7970,3.6
MT3749180000000,37,49180,"Winston-Salem, NC MSA",2024,6,324987,312878,12109,3.7
MT3813900000000,38,13900,"Bismarck, ND MSA",2024,6,73153,71417,1736,2.4
MT3822020000000,38,22020,"Fargo, ND-MN MSA",2024,6,154264,150684,3580,2.3
MT3824220000000,38,24220,"Grand Forks, ND-MN MSA",2024,6,56799,55378,1421,2.5
MT3833500000000,38,33500,"Minot, ND MSA",2024,6,40129,39134,995,2.5
MT3910420000000,39,10420,"Akron, OH MSA",2024,6,360836,344651,16185,4.5
MT3915940000000,39,15940,"Canton-Massillon, OH MSA",2024,6,195683,186671,9012,4.6
MT3917140000000,39,17140,"Cincinnati, OH-KY-IN MSA",2024,6,1174529,1124535,49994,4.3
MT3917410000000,39,17410,"Cleveland, OH MSA",2024,6,1101159,1059021,42138,3.8
MT3918140000000,39,18140,"Columbus, OH MSA",2024,6,1162487,1115665,46822,4
MT3919430000000,39,19430,"Dayton-Kettering-Beavercreek, OH MSA",2024,6,396275,378724,17551,4.4
MT3930620000000,39,30620,"Lima, OH MSA",2024,6,47682,45555,2127,4.5
MT3931900000000,39,31900,"Mansfield, OH MSA",2024,6,53712,51011,2701,5
MT3941780000000,39,41780,"Sandusky, OH MSA",2024,6,57359,54181,3178,5.5
MT3944220000000,39,44220,"Springfield, OH MSA",2024,6,62407,59500,2907,4.7
MT3945780000000,39,45780,"Toledo, OH MSA",2024,6,295985,281813,14172,4.8
MT3948260000000,39,48260,"Weirton-Steubenville, WV-OH MSA",2024,6,51642,48647,2995,5.8
MT3949660000000,39,49660,"Youngstown-Warren, OH MSA",2024,6,193132,183279,9853,5.1
MT4021420000000,40,21420,"Enid, OK MSA",2024,6,28351,27421,930,3.3
MT4030020000000,40,30020,"Lawton, OK MSA",2024,6,52393,50473,1920,3.7
MT4036420000000,40,36420,"Oklahoma City, OK MSA",2024,6,773792,750042,23750,3.1
MT4046140000000,40,46140,"Tulsa, OK MSA",2024,6,524196,506849,17347,3.3
MT4110540000000,41,10540,"Albany, OR MSA",2024,6,61599,58780,2819,4.6
MT4113460000000,41,13460,"Bend, OR MSA",2024,6,133214,127517,5697,4.3
MT4118700000000,41,18700,"Corvallis, OR MSA",2024,6,49442,47766,1676,3.4
MT4121660000000,41,21660,"Eugene-Springfield, OR MSA",2024,6,188717,180980,7737,4.1
MT4124420000000,41,24420,"Grants Pass, OR MSA",2024,6,35285,33262,2023,5.7
MT4132780000000,41,32780,"Medford, OR MSA",2024,6,106338,101245,5093,4.8
MT4138900000000,41,38900,"Portland-Vancouver-Hillsboro, OR-WA MSA",2024,6,1384891,1330796,54095,3.9
MT4141420000000,41,41420,"Salem, OR MSA",2024,6,220946,212165,8781,4
MT4210900000000,42,10900,"Allentown-Bethlehem-Easton, PA-NJ MSA",2024,6,452663,435341,17322,3.8
MT4211020000000,42,11020,"Altoona, PA MSA",2024,6,57578,55536,2042,3.5
MT4216540000000,42,16540,"Chambersburg, PA MSA",2024,6,77518,75143,2375,3.1
MT4221500000000,42,21500,"Erie, PA MSA",2024,6,127086,122323,4763,3.7
MT4223900000000,42,23900,"Gettysburg, PA MSA",2024,6,51859,50274,1585,3.1
MT4225420000000,42,25420,"Harrisburg-Carlisle, PA MSA",2024,6,313288,302980,10308,3.3
MT4227780000000,42,27780,"Johnstown, PA MSA",2024,6,56698,54270,2428,4.3
MT4229540000000,42,29540,"Lancaster, PA MSA",2024,6,292664,284306,8358,2.9
MT4230140000000,42,30140,"Lebanon, PA MSA",2024,6,73609,71328,2281,3.1
MT4237980000000,42,37980,"Philadelphia-Camden-Wilmington, PA-NJ-DE-MD MSA",2024,6,3299951,3173530,126421,3.8
MT4238300000000,42,38300,"Pittsburgh, PA MSA",2024,6,1238875,1193693,45182,3.6
MT4239740000000,42,39740,"Reading, PA MSA",2024,6,219364,211306,8058,3.7
MT4242540000000,42,42540,"Scranton--Wilkes-Barre, PA MSA",2024,6,280714,268770,11944,4.3
MT4244300000000,42,44300,"State College, PA MSA",2024,6,76361,74188,2173,2.8
MT4248700000000,42,48700,"Williamsport, PA MSA",2024,6,52972,50862,2110,4
MT4249620000000,42,49620,"York-Hanover, PA MSA",2024,6,240618,232499,8119,3.4
MT4439300000000,44,39300,"Providence-Warwick, RI-MA MSA",2024,6,905295,864534,40761,4.5
MT4516700000000,45,16700,"Charleston-North Charleston, SC MSA",2024,6,444647,428389,16258,3.7
MT4517900000000,45,17900,"Columbia, SC MSA",2024,6,421118,403474,17644,4.2
MT4522500000000,45,22500,"Florence, SC MSA",2024,6,92495,88095,4400,4.8
MT4524860000000,45,24860,"Greenville-Anderson-Greer, SC MSA",2024,6,480335,461019,19316,4
MT4525940000000,45,25940,"Hilton Head Island-Bluffton-Port Royal, SC MSA",2024,6,98359,94319,4040,4.1
MT4534820000000,45,34820,"Myrtle Beach-Conway-North Myrtle Beach, SC MSA",2024,6,171146,162711,8435,4.9
MT4543900000000,45,43900,"Spartanburg, SC MSA",2024,6,177679,169735,7944,4.5
MT4544940000000,45,44940,"Sumter, SC MSA",2024,6,41926,39702,2224,5.3
MT4639660000000,46,39660,"Rapid City, SD MSA",2024,6,79534,78091,1443,1.8
MT4643620000000,46,43620,"Sioux Falls, SD-MN MSA",2024,6,175139,172181,2958,1.7
MT4716860000000,47,16860,"Chattanooga, TN-GA MSA",2024,6,292384,283163,9221,3.2
MT4717300000000,47,17300,"Clarksville, TN-KY MSA",2024,6,139204,133587,5617,4
MT4717420000000,47,17420,"Cleveland, TN MSA",2024,6,56272,54221,2051,3.6
MT4727180000000,47,27180,"Jackson, TN MSA",2024,6,78009,75059,2950,3.8
MT4727740000000,47,27740,"Johnson City, TN MSA",2024,6,97033,93700,3333,3.4
MT4728700000000,47,28700,"Kingsport-Bristol, TN-VA MSA",2024,6,132882,128177,4705,3.5
MT4728940000000,47,28940,"Knoxville, TN MSA",2024,6,452698,438665,14033,3.1
MT4732820000000,47,32820,"Memphis, TN-MS-AR MSA",2024,6,625551,600650,24901,4
MT4734100000000,47,34100,"Morristown, TN MSA",2024,6,53838,51946,1892,3.5
MT4734980000000,47,34980,"Nashville-Davidson--Murfreesboro--Franklin, TN MSA",2024,6,1162917,1130757,32160,2.8
MT4810180000000,48,10180,"Abilene, TX MSA",2024,6,86734,83700,3034,3.5
MT4811100000000,48,11100,"Amarillo, TX MSA",2024,6,137691,133327,4364,3.2
MT4812420000000,48,12420,"Austin-Round Rock-San Marcos, TX MSA",2024,6,1504613,1451103,53510,3.6
MT4813140000000,48,13140,"Beaumont-Port Arthur, TX MSA",2024,6,183134,172878,10256,5.6
MT4815180000000,48,15180,"Brownsville-Harlingen, TX MSA",2024,6,189849,179697,10152,5.3
MT4817780000000,48,17780,"College Station-Bryan, TX MSA",2024,6,151399,146171,5228,3.5
MT4818580000000,48,18580,"Corpus Christi, TX MSA",2024,6,209023,199656,9367,4.5
MT4819100000000,48,19100,"Dallas-Fort Worth-Arlington, TX MSA",2024,6,4489448,4312818,176630,3.9
MT4820580000000,48,20580,"Eagle Pass, TX MSA",2024,6,24096,22164,1932,8
MT4821340000000,48,21340,"El Paso, TX MSA",2024,6,415575,398172,17403,4.2
MT4826420000000,48,26420,"Houston-Pasadena-The Woodlands, TX MSA",2024,6,3835492,3666525,168967,4.4
MT4828660000000,48,28660,"Killeen-Temple, TX MSA",2024,6,202498,193450,9048,4.5
MT4829700000000,48,29700,"Laredo, TX MSA",2024,6,118808,113842,4966,4.2
MT4830980000000,48,30980,"Longview, TX MSA",2024,6,129011,123039,5972,4.6
MT4831180000000,48,31180,"Lubbock, TX MSA",2024,6,184470,178005,6465,3.5
MT4832580000000,48,32580,"McAllen-Edinburg-Mission, TX MSA",2024,6,396546,372437,24109,6.1
MT4833260000000,48,33260,"Midland, TX MSA",2024,6,103645,100624,3021,2.9
MT4836220000000,48,36220,"Odessa, TX MSA",2024,6,86635,83633,3002,3.5
MT4841660000000,48,41660,"San Angelo, TX MSA",2024,6,62110,60118,1992,3.2
MT4841700000000,48,41700,"San Antonio-New Braunfels, TX MSA",2024,6,1336275,1285318,50957,3.8
MT4843300000000,48,43300,"Sherman-Denison, TX MSA",2024,6,71422,68595,2827,4
MT4845500000000,48,45500,"Texarkana, TX-AR MSA",2024,6,61965,59373,2592,4.2
MT4846340000000,48,46340,"Tyler, TX MSA",2024,6,118152,113542,4610,3.9
MT4847020000000,48,47020,"Victoria, TX MSA",2024,6,44987,43154,1833,4.1
MT4847380000000,48,47380,"Waco, TX MSA",2024,6,146490,140854,5636,3.8
MT4848660000000,48,48660,"Wichita Falls, TX MSA",2024,6,66845,64259,2586,3.9
MT4930860000000,49,30860,"Logan, UT-ID MSA",2024,6,80116,77750,2366,3
MT4936260000000,49,36260,"Ogden, UT MSA",2024,6,352168,341192,10976,3.1
MT4939340000000,49,39340,"Provo-Orem-Lehi, UT MSA",2024,6,370789,358271,12518,3.4
MT4941100000000,49,41100,"St. George, UT MSA",2024,6,93968,90704,3264,3.5
MT4941620000000,49,41620,"Salt Lake City-Murray, UT MSA",2024,6,738916,714903,24013,3.2
MT5015540000000,50,15540,"Burlington-South Burlington, VT MSA",2024,6,131653,129025,2628,2
MT5113980000000,51,13980,"Blacksburg-Christiansburg-Radford, VA MSA",2024,6,92997,90100,2897,3.1
MT5116820000000,51,16820,"Charlottesville, VA MSA",2024,6,121168,118096,3072,2.5
MT5125500000000,51,25500,"Harrisonburg, VA MSA",2024,6,72513,70455,2058,2.8
MT5131340000000,51,31340,"Lynchburg, VA MSA",2024,6,127274,123136,4138,3.3
MT5140060000000,51,40060,"Richmond, VA MSA",2024,6,729593,707794,21799,3
MT5140220000000,51,40220,"Roanoke, VA MSA",2024,6,158672,153968,4704,3
MT5144420000000,51,44420,"Staunton-Stuarts Draft, VA MSA",2024,6,65552,63841,1711,2.6
MT5147260000000,51,47260,"Virginia Beach-Chesapeake-Norfolk, VA-NC MSA",2024,6,883212,855913,27299,3.1
MT5149020000000,51,49020,"Winchester, VA-WV MSA",2024,6,77563,75417,2146,2.8
MT5313380000000,53,13380,"Bellingham, WA MSA",2024,6,114683,109434,5249,4.6
MT5314740000000,53,14740,"Bremerton-Silverdale-Port Orchard, WA MSA",2024,6,122626,117124,5502,4.5
MT5328420000000,53,28420,"Kennewick-Richland, WA MSA",2024,6,147224,139692,7532,5.1
MT5331020000000,53,31020,"Longview-Kelso, WA MSA",2024,6,47501,45011,2490,5.2
MT5334580000000,53,34580,"Mount Vernon-Anacortes, WA MSA",2024,6,59704,56673,3031,5.1
MT5336500000000,53,36500,"Olympia-Lacey-Tumwater, WA MSA",2024,6,144104,137587,6517,4.5
MT5342660000000,53,42660,"Seattle-Tacoma-Bellevue, WA MSA",2024,6,2323910,2226320,97590,4.2
MT5344060000000,53,44060,"Spokane-Spokane Valley, WA MSA",2024,6,283333,270133,13200,4.7
MT5347460000000,53,47460,"Walla Walla, WA MSA",2024,6,29302,28009,1293,4.4
MT5348300000000,53,48300,"Wenatchee-East Wenatchee, WA MSA",2024,6,62131,59062,3069,4.9
MT5349420000000,53,49420,"Yakima, WA MSA",2024,6,125028,117173,7855,6.3
MT5413220000000,54,13220,"Beckley, WV MSA",2024,6,46426,44497,1929,4.2
MT5416620000000,54,16620,"Charleston, WV MSA",2024,6,91093,87386,3707,4.1
MT5426580000000,54,26580,"Huntington-Ashland, WV-KY-OH MSA",2024,6,157551,149748,7803,5
MT5434060000000,54,34060,"Morgantown, WV MSA",2024,6,70886,68455,2431,3.4
MT5437620000000,54,37620,"Parkersburg-Vienna, WV MSA",2024,6,39487,37797,1690,4.3
MT5448540000000,54,48540,"Wheeling, WV-OH MSA",2024,6,59810,56864,2946,4.9
MT5511540000000,55,11540,"Appleton, WI MSA",2024,6,137444,134001,3443,2.5
MT5520740000000,55,20740,"Eau Claire, WI MSA",2024,6,96320,93576,2744,2.8
MT5522540000000,55,22540,"Fond du Lac, WI MSA",2024,6,55655,54093,1562,2.8
MT5524580000000,55,24580,"Green Bay, WI MSA",2024,6,179259,174521,4738,2.6
MT5527500000000,55,27500,"Janesville-Beloit, WI MSA",2024,6,87051,84225,2826,3.2
MT5528450000000,55,28450,"Kenosha, WI MSA",2024,6,95695,92693,3002,3.1
MT5529100000000,55,29100,"La Crosse-Onalaska, WI-MN MSA",2024,6,90659,88204,2455,2.7
MT5531540000000,55,31540,"Madison, WI MSA",2024,6,411119,401225,9894,2.4
MT5533340000000,55,33340,"Milwaukee-Waukesha, WI MSA",2024,6,818667,792692,25975,3.2
MT5536780000000,55,36780,"Oshkosh-Neenah, WI MSA",2024,6,93087,90614,2473,2.7
MT5539540000000,55,39540,"Racine-Mount Pleasant, WI MSA",2024,6,101573,98006,3567,3.5
MT5543100000000,55,43100,"Sheboygan, WI MSA",2024,6,63145,61564,1581,2.5
MT5548140000000,55,48140,"Wausau, WI MSA",2024,6,75403,73446,1957,2.6
MT5616220000000,56,16220,"Casper, WY MSA",2024,6,42187,40837,1350,3.2
MT5616940000000,56,16940,"Cheyenne, WY MSA",2024,6,49048,47390,1658,3.4
MT7210380000000,72,10380,"Aguadilla, PR MSA",2024,6,90602,84278,6324,7
MT7211640000000,72,11640,"Arecibo, PR MSA",2024,6,67643,63809,3834,5.7
MT7225020000000,72,25020,"Guayama, PR MSA",2024,6,19021,17135,1886,9.9
MT7232420000000,72,32420,"Mayaguez, PR MSA",2024,6,66498,61604,4894,7.4
MT7238660000000,72,38660,"Ponce, PR MSA",2024,6,88992,81026,7966,9
MT7241980000000,72,41980,"San Juan-Bayamon-Caguas, PR MSA",2024,6,810319,771432,38887,4.8
MT0111500000000,1,11500,"Anniston-Oxford, AL MSA",2024,7,49657,48063,1594,3.2
MT0112220000000,1,12220,"Auburn-Opelika, AL MSA",2024,7,96441,93514,2927,3
MT0113820000000,1,13820,"Birmingham, AL MSA",2024,7,572750,556490,16260,2.8
MT0119300000000,1,19300,"Daphne-Fairhope-Foley, AL MSA",2024,7,116099,112833,3266,2.8
MT0119460000000,1,19460,"Decatur, AL MSA",2024,7,75915,73892,2023,2.7
MT0120020000000,1,20020,"Dothan, AL MSA",2024,7,67836,65754,2082,3.1
MT0122520000000,1,22520,"Florence-Muscle Shoals, AL MSA",2024,7,69147,66870,2277,3.3
MT0123460000000,1,23460,"Gadsden, AL MSA",2024,7,42105,40727,1378,3.3
MT0126620000000,1,26620,"Huntsville, AL MSA",2024,7,277041,269956,7085,2.6
MT0133660000000,1,33660,"Mobile, AL MSA",2024,7,186033,179348,6685,3.6
MT0133860000000,1,33860,"Montgomery, AL MSA",2024,7,178768,173298,5470,3.1
MT0146220000000,1,46220,"Tuscaloosa, AL MSA",2024,7,126799,122607,4192,3.3
MT0211260000000,2,11260,"Anchorage, AK MSA",2024,7,201469,192821,8648,4.3
MT0221820000000,2,21820,"Fairbanks-College, AK MSA",2024,7,45823,43910,1913,4.2
MT0422380000000,4,22380,"Flagstaff, AZ MSA",2024,7,75780,72803,2977,3.9
MT0429420000000,4,29420,"Lake Havasu City-Kingman, AZ MSA",2024,7,87657,83639,4018,4.6
MT0438060000000,4,38060,"Phoenix-Mesa-Chandler, AZ MSA",2024,7,2713827,2624409,89418,3.3
MT0439150000000,4,39150,"Prescott Valley-Prescott, AZ MSA",2024,7,106485,102683,3802,3.6
MT0443420000000,4,43420,"Sierra Vista-Douglas, AZ MSA",2024,7,47992,45929,2063,4.3
MT0446060000000,4,46060,"Tucson, AZ MSA",2024,7,492968,474931,18037,3.7
MT0449740000000,4,49740,"Yuma, AZ MSA",2024,7,98735,86687,12048,12.2
MT0522220000000,5,22220,"Fayetteville-Springdale-Rogers, AR MSA",2024,7,306865,298653,8212,2.7
MT0522900000000,5,22900,"Fort Smith, AR-OK MSA",2024,7,101388,97836,3552,3.5
MT0526300000000,5,26300,"Hot Springs, AR MSA",2024,7,43522,41950,1572,3.6
MT0527860000000,5,27860,"Jonesboro, AR MSA",2024,7,66377,64271,2106,3.2
MT0530780000000,5,30780,"Little Rock-North Little Rock-Conway, AR MSA",2024,7,381119,368789,12330,3.2
MT0612540000000,6,12540,"Bakersfield-Delano, CA MSA",2024,7,408125,372405,35720,8.8
MT0617020000000,6,17020,"Chico, CA MSA",2024,7,91463,85965,5498,6
MT0620940000000,6,20940,"El Centro, CA MSA",2024,7,73173,59734,13439,18.4
MT0623420000000,6,23420,"Fresno, CA MSA",2024,7,539988,496910,43078,8
MT0625260000000,6,25260,"Hanford-Corcoran, CA MSA",2024,7,58480,53208,5272,9
MT0631080000000,6,31080,"Los Angeles-Long Beach-Anaheim, CA MSA",2024,7,6750559,6377187,373372,5.5
MT0632900000000,6,32900,"Merced, CA MSA",2024,7,120668,108715,11953,9.9
MT0633700000000,6,33700,"Modesto, CA MSA",2024,7,253719,235960,17759,7
MT0634900000000,6,34900,"Napa, CA MSA",2024,7,74463,71487,2976,4
MT0637100000000,6,37100,"Oxnard-Thousand Oaks-Ventura, CA MSA",2024,7,422338,402752,19586,4.6
MT0639820000000,6,39820,"Redding, CA MSA",2024,7,79279,74963,4316,5.4
MT0640140000000,6,40140,"Riverside-San Bernardino-Ontario, CA MSA",2024,7,2212684,2095536,117148,5.3
MT0640900000000,6,40900,"Sacramento-Roseville-Folsom, CA MSA",2024,7,1182798,1126749,56049,4.7
MT0641500000000,6,41500,"Salinas, CA MSA",2024,7,220354,204221,16133,7.3
MT0641740000000,6,41740,"San Diego-Chula Vista-Carlsbad, CA MSA",2024,7,1649235,1577352,71883,4.4
MT0641860000000,6,41860,"San Francisco-Oakland-Fremont, CA MSA",2024,7,2502196,2396785,105411,4.2
MT0641940000000,6,41940,"San Jose-Sunnyvale-Santa Clara, CA MSA",2024,7,1058523,1013494,45029,4.3
MT0642020000000,6,42020,"San Luis Obispo-Paso Robles, CA MSA",2024,7,132476,126998,5478,4.1
MT0642100000000,6,42100,"Santa Cruz-Watsonville, CA MSA",2024,7,136084,127897,8187,6
MT0642200000000,6,42200,"Santa Maria-Santa Barbara, CA MSA",2024,7,221377,211345,10032,4.5
MT0642220000000,6,42220,"Santa Rosa-Petaluma, CA MSA",2024,7,246350,236050,10300,4.2
MT0644700000000,6,44700,"Stockton-Lodi, CA MSA",2024,7,368562,344380,24182,6.6
MT0646700000000,6,46700,"Vallejo, CA MSA",2024,7,216553,205583,10970,5.1
MT0647300000000,6,47300,"Visalia, CA MSA",2024,7,220293,197415,22878,10.4
MT0649700000000,6,49700,"Yuba City, CA MSA",2024,7,81312,74819,6493,8
MT0814500000000,8,14500,"Boulder, CO MSA",2024,7,193955,185404,8551,4.4
MT0817820000000,8,17820,"Colorado Springs, CO MSA",2024,7,396571,379208,17363,4.4
MT0819740000000,8,19740,"Denver-Aurora-Centennial, CO MSA",2024,7,1778767,1701552,77215,4.3
MT0822660000000,8,22660,"Fort Collins-Loveland, CO MSA",2024,7,207990,199223,8767,4.2
MT0824300000000,8,24300,"Grand Junction, CO MSA",2024,7,80083,76418,3665,4.6
MT0824540000000,8,24540,"Greeley, CO MSA",2024,7,178926,170667,8259,4.6
MT0839380000000,8,39380,"Pueblo, CO MSA",2024,7,73746,69299,4447,6
MT0914860000000,9,14860,"Bridgeport-Stamford-Danbury, CT MSA",2024,7,517319,501540,15779,3.1
MT0925540000000,9,25540,"Hartford-West Hartford-East Hartford, CT MSA",2024,7,614959,595601,19358,3.1
MT0935300000000,9,35300,"New Haven, CT MSA",2024,7,316577,306651,9926,3.1
MT0935980000000,9,35980,"Norwich-New London-Willimantic, CT MSA",2024,7,143322,138966,4356,3
MT0947930000000,9,47930,"Waterbury-Shelton, CT MSA",2024,7,240959,232320,8639,3.6
MT1020100000000,10,20100,"Dover, DE MSA",2024,7,85663,82173,3490,4.1
MT1147900000000,11,47900,"Washington-Arlington-Alexandria, DC-VA-MD-WV MSA",2024,7,3561756,3452486,109270,3.1
MT1215980000000,12,15980,"Cape Coral-Fort Myers, FL MSA",2024,7,376619,363093,13526,3.6
MT1218880000000,12,18880,"Crestview-Fort Walton Beach-Destin, FL MSA",2024,7,143027,138459,4568,3.2
MT1219660000000,12,19660,"Deltona-Daytona Beach-Ormond Beach, FL MSA",2024,7,322223,309364,12859,4
MT1223540000000,12,23540,"Gainesville, FL MSA",2024,7,169707,163222,6485,3.8
MT1226140000000,12,26140,"Homosassa Springs, FL MSA",2024,7,53954,51203,2751,5.1
MT1227260000000,12,27260,"Jacksonville, FL MSA",2024,7,855321,825350,29971,3.5
MT1229460000000,12,29460,"Lakeland-Winter Haven, FL MSA",2024,7,358792,343365,15427,4.3
MT1233100000000,12,33100,"Miami-Fort Lauderdale-West Palm Beach, FL MSA",2024,7,3313573,3216032,97541,2.9
MT1234940000000,12,34940,"Naples-Marco Island, FL MSA",2024,7,187720,181471,6249,3.3
MT1235840000000,12,35840,"North Port-Bradenton-Sarasota, FL MSA",2024,7,400233,385838,14395,3.6
MT1236100000000,12,36100,"Ocala, FL MSA",2024,7,159077,152177,6900,4.3
MT1236740000000,12,36740,"Orlando-Kissimmee-Sanford, FL MSA",2024,7,1533796,1482484,51312,3.3
MT1237340000000,12,37340,"Palm Bay-Melbourne-Titusville, FL MSA",2024,7,305165,294141,11024,3.6
MT1237460000000,12,37460,"Panama City-Panama City Beach, FL MSA",2024,7,102040,98527,3513,3.4
MT1237860000000,12,37860,"Pensacola-Ferry Pass-Brent, FL MSA",2024,7,240236,231610,8626,3.6
MT1238940000000,12,38940,"Port St. Lucie, FL MSA",2024,7,241359,232043,9316,3.9
MT1239460000000,12,39460,"Punta Gorda, FL MSA",2024,7,77580,74356,3224,4.2
MT1242680000000,12,42680,"Sebastian-Vero Beach-West Vero Corridor, FL MSA",2024,7,68192,65446,2746,4
MT1242700000000,12,42700,"Sebring, FL MSA",2024,7,36746,34933,1813,4.9
MT1245220000000,12,45220,"Tallahassee, FL MSA",2024,7,208132,200800,7332,3.5
MT1245300000000,12,45300,"Tampa-St. Petersburg-Clearwater, FL MSA",2024,7,1701398,1641626,59772,3.5
MT1248680000000,12,48680,"Wildwood-The Villages, FL MSA",2024,7,34225,32294,1931,5.6
MT1310500000000,13,10500,"Albany, GA MSA",2024,7,62628,59951,2677,4.3
MT1312020000000,13,12020,"Athens-Clarke County, GA MSA",2024,7,108412,104612,3800,3.5
MT1312060000000,13,12060,"Atlanta-Sandy Springs-Roswell, GA MSA",2024,7,3313037,3196385,116652,3.5
MT1312260000000,13,12260,"Augusta-Richmond County, GA-SC MSA",2024,7,269655,257412,12243,4.5
MT1315260000000,13,15260,"Brunswick-St. Simons, GA MSA",2024,7,55844,54039,1805,3.2
MT1317980000000,13,17980,"Columbus, GA-AL MSA",2024,7,128883,123611,5272,4.1
MT1319140000000,13,19140,"Dalton, GA MSA",2024,7,67611,64870,2741,4.1
MT1323580000000,13,23580,"Gainesville, GA MSA",2024,7,109419,106139,3280,3
MT1325980000000,13,25980,"Hinesville, GA MSA",2024,7,31423,30135,1288,4.1
MT1331420000000,13,31420,"Macon-Bibb County, GA MSA",2024,7,97229,92983,4246,4.4
MT1340660000000,13,40660,"Rome, GA MSA",2024,7,47751,45991,1760,3.7
MT1342340000000,13,42340,"Savannah, GA MSA",2024,7,210396,203690,6706,3.2
MT1346660000000,13,46660,"Valdosta, GA MSA",2024,7,61782,59254,2528,4.1
MT1347580000000,13,47580,"Warner Robins, GA MSA",2024,7,90139,87134,3005,3.3
MT1527980000000,15,27980,"Kahului-Wailuku, HI MSA",2024,7,81424,78084,3340,4.1
MT1546520000000,15,46520,"Urban Honolulu, HI MSA",2024,7,471667,458615,13052,2.8
MT1614260000000,16,14260,"Boise City, ID MSA",2024,7,448326,432191,16135,3.6
MT1617660000000,16,17660,"Coeur d'Alene, ID MSA",2024,7,90148,86082,4066,4.5
MT1626820000000,16,26820,"Idaho Falls, ID MSA",2024,7,84809,82080,2729,3.2
MT1630300000000,16,30300,"Lewiston, ID-WA MSA",2024,7,31079,29900,1179,3.8
MT1638540000000,16,38540,"Pocatello, ID MSA",2024,7,41059,39378,1681,4.1
MT1646300000000,16,46300,"Twin Falls, ID MSA",2024,7,60547,58371,2176,3.6
MT1714010000000,17,14010,"Bloomington, IL MSA",2024,7,96635,92719,3916,4.1
MT1716580000000,17,16580,"Champaign-Urbana, IL MSA",2024,7,125132,119718,5414,4.3
MT1716980000000,17,16980,"Chicago-Naperville-Elgin, IL-IN MSA",2024,7,5025341,4756745,268596,5.3
MT1719340000000,17,19340,"Davenport-Moline-Rock Island, IA-IL MSA",2024,7,189225,180073,9152,4.8
MT1719500000000,17,19500,"Decatur, IL MSA",2024,7,44690,42035,2655,5.9
MT1728100000000,17,28100,"Kankakee, IL MSA",2024,7,51210,48199,3011,5.9
MT1737900000000,17,37900,"Peoria, IL MSA",2024,7,178375,169522,8853,5
MT1740420000000,17,40420,"Rockford, IL MSA",2024,7,160423,151361,9062,5.6
MT1744100000000,17,44100,"Springfield, IL MSA",2024,7,103556,98977,4579,4.4
MT1814020000000,18,14020,"Bloomington, IN MSA",2024,7,86421,83046,3375,3.9
MT1818020000000,18,18020,"Columbus, IN MSA",2024,7,39364,37699,1665,4.2
MT1821140000000,18,21140,"Elkhart-Goshen, IN MSA",2024,7,98193,93181,5012,5.1
MT1821780000000,18,21780,"Evansville, IN MSA",2024,7,136109,130700,5409,4
MT1823060000000,18,23060,"Fort Wayne, IN MSA",2024,7,232601,223615,8986,3.9
MT1826900000000,18,26900,"Indianapolis-Carmel-Greenwood, IN MSA",2024,7,1143454,1098477,44977,3.9
MT1829020000000,18,29020,"Kokomo, IN MSA",2024,7,36515,34326,2189,6
MT1829200000000,18,29200,"Lafayette-West Lafayette, IN MSA",2024,7,120588,115892,4696,3.9
MT1833140000000,18,33140,"Michigan City-La Porte, IN MSA",2024,7,51749,49244,2505,4.8
MT1834620000000,18,34620,"Muncie, IN MSA",2024,7,53005,50448,2557,4.8
MT1843780000000,18,43780,"South Bend-Mishawaka, IN-MI MSA",2024,7,155089,147189,7900,5.1
MT1845460000000,18,45460,"Terre Haute, IN MSA",2024,7,78020,74515,3505,4.5
MT1911180000000,19,11180,"Ames, IA MSA",2024,7,69470,67825,1645,2.4
MT1916300000000,19,16300,"Cedar Rapids, IA MSA",2024,7,145745,140817,4928,3.4
MT1919780000000,19,19780,"Des Moines-West Des Moines, IA MSA",2024,7,413009,400331,12678,3.1
MT1920220000000,19,20220,"Dubuque, IA MSA",2024,7,53334,51694,1640,3.1
MT1926980000000,19,26980,"Iowa City, IA MSA",2024,7,99592,97258,2334,2.3
MT1943580000000,19,43580,"Sioux City, IA-NE-SD MSA",2024,7,76541,74298,2243,2.9
MT1947940000000,19,47940,"Waterloo-Cedar Falls, IA MSA",2024,7,88216,85006,3210,3.6
MT2029940000000,20,29940,"Lawrence, KS MSA",2024,7,71411,69000,2411,3.4
MT2031740000000,20,31740,"Manhattan, KS MSA",2024,7,64583,62376,2207,3.4
MT2045820000000,20,45820,"Topeka, KS MSA",2024,7,119108,114619,4489,3.8
MT2048620000000,20,48620,"Wichita, KS MSA",2024,7,337992,324334,13658,4
MT2114540000000,21,14540,"Bowling Green, KY MSA",2024,7,93439,88970,4469,4.8
MT2121060000000,21,21060,"Elizabethtown, KY MSA",2024,7,55707,52751,2956,5.3
MT2130460000000,21,30460,"Lexington-Fayette, KY MSA",2024,7,278621,266656,11965,4.3
MT2131140000000,21,31140,"Louisville/Jefferson County, KY-IN MSA",2024,7,703008,670091,32917,4.7
MT2136980000000,21,36980,"Owensboro, KY MSA",2024,7,52518,49843,2675,5.1
MT2137140000000,21,37140,"Paducah, KY-IL MSA",2024,7,46205,43798,2407,5.2
MT2210780000000,22,10780,"Alexandria, LA MSA",2024,7,64265,61736,2529,3.9
MT2212940000000,22,12940,"Baton Rouge, LA MSA",2024,7,427749,410609,17140,4
MT2225220000000,22,25220,"Hammond, LA MSA",2024,7,60869,57930,2939,4.8
MT2226380000000,22,26380,"Houma-Bayou Cane-Thibodaux, LA MSA",2024,7,87905,84574,3331,3.8
MT2229180000000,22,29180,"Lafayette, LA MSA",2024,7,197669,190292,7377,3.7
MT2229340000000,22,29340,"Lake Charles, LA MSA",2024,7,98043,93672,4371,4.5
MT2233740000000,22,33740,"Monroe, LA MSA",2024,7,95880,91230,4650,4.8
MT2235380000000,22,35380,"New Orleans-Metairie, LA MSA",2024,7,468009,447652,20357,4.3
MT2243340000000,22,43340,"Shreveport-Bossier City, LA MSA",2024,7,167594,160309,7285,4.3
MT2243640000000,22,43640,"Slidell-Mandeville-Covington, LA MSA",2024,7,129325,124378,4947,3.8
MT2312620000000,23,12620,"Bangor, ME MSA",2024,7,76206,73687,2519,3.3
MT2330340000000,23,30340,"Lewiston-Auburn, ME MSA",2024,7,55769,53994,1775,3.2
MT2338860000000,23,38860,"Portland-South Portland, ME MSA",2024,7,315736,307203,8533,2.7
MT2412580000000,24,12580,"Baltimore-Columbia-Towson, MD MSA",2024,7,1499698,1452432,47266,3.2
MT2425180000000,24,25180,"Hagerstown-Martinsburg, MD-WV MSA",2024,7,144419,139548,4871,3.4
MT2430500000000,24,30500,"Lexington Park, MD MSA",2024,7,109853,106817,3036,2.8
MT2441540000000,24,41540,"Salisbury, MD MSA",2024,7,64478,62182,2296,3.6
MT2511200000000,25,11200,"Amherst Town-Northampton, MA MSA",2024,7,85839,82553,3286,3.8
MT2512700000000,25,12700,"Barnstable Town, MA MSA",2024,7,117841,112088,5753,4.9
MT2514460000000,25,14460,"Boston-Cambridge-Newton, MA-NH MSA",2024,7,2837825,2731432,106393,3.7
MT2538340000000,25,38340,"Pittsfield, MA MSA",2024,7,64262,61600,2662,4.1
MT2544140000000,25,44140,"Springfield, MA MSA",2024,7,225926,214290,11636,5.2
MT2549340000000,25,49340,"Worcester, MA MSA",2024,7,468418,448846,19572,4.2
MT2611460000000,26,11460,"Ann Arbor, MI MSA",2024,7,209191,201156,8035,3.8
MT2612980000000,26,12980,"Battle Creek, MI MSA",2024,7,64364,60900,3464,5.4
MT2613020000000,26,13020,"Bay City, MI MSA",2024,7,50606,47713,2893,5.7
MT2619820000000,26,19820,"Detroit-Warren-Dearborn, MI MSA",2024,7,2179748,2078581,101167,4.6
MT2622420000000,26,22420,"Flint, MI MSA",2024,7,191026,179939,11087,5.8
MT2624340000000,26,24340,"Grand Rapids-Wyoming-Kentwood, MI MSA",2024,7,633588,607219,26369,4.2
MT2627100000000,26,27100,"Jackson, MI MSA",2024,7,75407,71679,3728,4.9
MT2628020000000,26,28020,"Kalamazoo-Portage, MI MSA",2024,7,141484,135483,6001,4.2
MT2629620000000,26,29620,"Lansing-East Lansing, MI MSA",2024,7,256235,244744,11491,4.5
MT2633220000000,26,33220,"Midland, MI MSA",2024,7,43213,41209,2004,4.6
MT2633780000000,26,33780,"Monroe, MI MSA",2024,7,79981,75495,4486,5.6
MT2634740000000,26,34740,"Muskegon-Norton Shores, MI MSA",2024,7,86098,81591,4507,5.2
MT2635660000000,26,35660,"Niles, MI MSA",2024,7,77445,73398,4047,5.2
MT2640980000000,26,40980,"Saginaw, MI MSA",2024,7,85679,80541,5138,6
MT2645900000000,26,45900,"Traverse City, MI MSA",2024,7,82509,78811,3698,4.5
MT2720260000000,27,20260,"Duluth, MN-WI MSA",2024,7,139968,134734,5234,3.7
MT2731860000000,27,31860,"Mankato, MN MSA",2024,7,60656,58978,1678,2.8
MT2733460000000,27,33460,"Minneapolis-St. Paul-Bloomington, MN-WI MSA",2024,7,2069901,2006973,62928,3
MT2740340000000,27,40340,"Rochester, MN MSA",2024,7,127879,124499,3380,2.6
MT2741060000000,27,41060,"St. Cloud, MN MSA",2024,7,111474,107730,3744,3.4
MT2825060000000,28,25060,"Gulfport-Biloxi, MS MSA",2024,7,188627,183160,5467,2.9
MT2825620000000,28,25620,"Hattiesburg, MS MSA",2024,7,70482,68429,2053,2.9
MT2827140000000,28,27140,"Jackson, MS MSA",2024,7,283534,275603,7931,2.8
MT2916020000000,29,16020,"Cape Girardeau, MO-IL MSA",2024,7,49219,47428,1791,3.6
MT2917860000000,29,17860,"Columbia, MO MSA",2024,7,112867,109150,3717,3.3
MT2927620000000,29,27620,"Jefferson City, MO MSA",2024,7,76709,74230,2479,3.2
MT2927900000000,29,27900,"Joplin, MO-KS MSA",2024,7,98325,94718,3607,3.7
MT2928140000000,29,28140,"Kansas City, MO-KS MSA",2024,7,1202940,1159474,43466,3.6
MT2941140000000,29,41140,"St. Joseph, MO-KS MSA",2024,7,54828,52688,2140,3.9
MT2941180000000,29,41180,"St. Louis, MO-IL MSA",2024,7,1489934,1433332,56602,3.8
MT2944180000000,29,44180,"Springfield, MO MSA",2024,7,244246,235747,8499,3.5
MT3013740000000,30,13740,"Billings, MT MSA",2024,7,99355,96498,2857,2.9
MT3014580000000,30,14580,"Bozeman, MT MSA",2024,7,78544,76678,1866,2.4
MT3024500000000,30,24500,"Great Falls, MT MSA",2024,7,39871,38656,1215,3
MT3025740000000,30,25740,"Helena, MT MSA",2024,7,47894,46564,1330,2.8
MT3033540000000,30,33540,"Missoula, MT MSA",2024,7,74443,72249,2194,2.9
MT3124260000000,31,24260,"Grand Island, NE MSA",2024,7,42960,41766,1194,2.8
MT3130700000000,31,30700,"Lincoln, NE MSA",2024,7,194115,189020,5095,2.6
MT3136540000000,31,36540,"Omaha, NE-IA MSA",2024,7,528076,511872,16204,3.1
MT3216180000000,32,16180,"Carson City, NV MSA",2024,7,29419,27976,1443,4.9
MT3229820000000,32,29820,"Las Vegas-Henderson-North Las Vegas, NV MSA",2024,7,1220424,1148477,71947,5.9
MT3239900000000,32,39900,"Reno, NV MSA",2024,7,299409,284478,14931,5
MT3331700000000,33,31700,"Manchester-Nashua, NH MSA",2024,7,241383,234763,6620,2.7
MT3412100000000,34,12100,"Atlantic City-Hammonton, NJ MSA",2024,7,180817,169212,11605,6.4
MT3445940000000,34,45940,"Trenton-Princeton, NJ MSA",2024,7,199899,191004,8895,4.4
MT3447220000000,34,47220,"Vineland, NJ MSA",2024,7,65915,61175,4740,7.2
MT3510740000000,35,10740,"Albuquerque, NM MSA",2024,7,464680,446050,18630,4
MT3522140000000,35,22140,"Farmington, NM MSA",2024,7,50025,47617,2408,4.8
MT3529740000000,35,29740,"Las Cruces, NM MSA",2024,7,102406,97219,5187,5.1
MT3542140000000,35,42140,"Santa Fe, NM MSA",2024,7,74436,71580,2856,3.8
MT3610580000000,36,10580,"Albany-Schenectady-Troy, NY MSA",2024,7,457426,442026,15400,3.4
MT3613780000000,36,13780,"Binghamton, NY MSA",2024,7,106381,102115,4266,4
MT3615380000000,36,15380,"Buffalo-Cheektowaga, NY MSA",2024,7,556827,534890,21937,3.9
MT3621300000000,36,21300,"Elmira, NY MSA",2024,7,35154,33804,1350,3.8
MT3624020000000,36,24020,"Glens Falls, NY MSA",2024,7,59640,57468,2172,3.6
MT3627060000000,36,27060,"Ithaca, NY MSA",2024,7,48213,46606,1607,3.3
MT3628740000000,36,28740,"Kingston, NY MSA",2024,7,87029,83889,3140,3.6
MT3628880000000,36,28880,"Kiryas Joel-Poughkeepsie-Newburgh, NY MSA",2024,7,339296,327471,11825,3.5
MT3635620000000,36,35620,"New York-Newark-Jersey City, NY-NJ MSA",2024,7,10234147,9757628,476519,4.7
MT3640380000000,36,40380,"Rochester, NY MSA",2024,7,513657,494919,18738,3.6
MT3645060000000,36,45060,"Syracuse, NY MSA",2024,7,311743,300244,11499,3.7
MT3646540000000,36,46540,"Utica-Rome, NY MSA",2024,7,126990,122010,4980,3.9
MT3648060000000,36,48060,"Watertown-Fort Drum, NY MSA",2024,7,44780,42773,2007,4.5
MT3711700000000,37,11700,"Asheville, NC MSA",2024,7,212205,205966,6239,2.9
MT3715500000000,37,15500,"Burlington, NC MSA",2024,7,86183,83040,3143,3.6
MT3716740000000,37,16740,"Charlotte-Concord-Gastonia, NC-SC MSA",2024,7,1484029,1428666,55363,3.7
MT3720500000000,37,20500,"Durham-Chapel Hill, NC MSA",2024,7,323569,313070,10499,3.2
MT3722180000000,37,22180,"Fayetteville, NC MSA",2024,7,153882,146798,7084,4.6
MT3724140000000,37,24140,"Goldsboro, NC MSA",2024,7,51138,49207,1931,3.8
MT3724660000000,37,24660,"Greensboro-High Point, NC MSA",2024,7,371835,356554,15281,4.1
MT3724780000000,37,24780,"Greenville, NC MSA",2024,7,83766,80399,3367,4
MT3725860000000,37,25860,"Hickory-Lenoir-Morganton, NC MSA",2024,7,170910,164673,6237,3.6
MT3727340000000,37,27340,"Jacksonville, NC MSA",2024,7,74057,71247,2810,3.8
MT3738240000000,37,38240,"Pinehurst-Southern Pines, NC MSA",2024,7,44997,43455,1542,3.4
MT3739580000000,37,39580,"Raleigh-Cary, NC MSA",2024,7,847484,820905,26579,3.1
MT3740580000000,37,40580,"Rocky Mount, NC MSA",2024,7,63975,60894,3081,4.8
MT3748900000000,37,48900,"Wilmington, NC MSA",2024,7,223807,215828,7979,3.6
MT3749180000000,37,49180,"Winston-Salem, NC MSA",2024,7,325021,312897,12124,3.7
MT3813900000000,38,13900,"Bismarck, ND MSA",2024,7,73271,71512,1759,2.4
MT3822020000000,38,22020,"Fargo, ND-MN MSA",2024,7,154319,150690,3629,2.4
MT3824220000000,38,24220,"Grand Forks, ND-MN MSA",2024,7,56954,55507,1447,2.5
MT3833500000000,38,33500,"Minot, ND MSA",2024,7,40047,39028,1019,2.5
MT3910420000000,39,10420,"Akron, OH MSA",2024,7,360474,344185,16289,4.5
MT3915940000000,39,15940,"Canton-Massillon, OH MSA",2024,7,195802,186691,9111,4.7
MT3917140000000,39,17140,"Cincinnati, OH-KY-IN MSA",2024,7,1176176,1125812,50364,4.3
MT3917410000000,39,17410,"Cleveland, OH MSA",2024,7,1102622,1060415,42207,3.8
MT3918140000000,39,18140,"Columbus, OH MSA",2024,7,1164167,1117005,47162,4.1
MT3919430000000,39,19430,"Dayton-Kettering-Beavercreek, OH MSA",2024,7,396329,378622,17707,4.5
MT3930620000000,39,30620,"Lima, OH MSA",2024,7,47683,45542,2141,4.5
MT3931900000000,39,31900,"Mansfield, OH MSA",2024,7,53701,50994,2707,5
MT3941780000000,39,41780,"Sandusky, OH MSA",2024,7,57392,54190,3202,5.6
MT3944220000000,39,44220,"Springfield, OH MSA",2024,7,62363,59413,2950,4.7
MT3945780000000,39,45780,"Toledo, OH MSA",2024,7,295491,281506,13985,4.7
MT3948260000000,39,48260,"Weirton-Steubenville, WV-OH MSA",2024,7,51405,48380,3025,5.9
MT3949660000000,39,49660,"Youngstown-Warren, OH MSA",2024,7,193211,183291,9920,5.1
MT4021420000000,40,21420,"Enid, OK MSA",2024,7,28357,27437,920,3.2
MT4030020000000,40,30020,"Lawton, OK MSA",2024,7,52382,50467,1915,3.7
MT4036420000000,40,36420,"Oklahoma City, OK MSA",2024,7,773921,750121,23800,3.1
MT4046140000000,40,46140,"Tulsa, OK MSA",2024,7,524663,507237,17426,3.3
MT4110540000000,41,10540,"Albany, OR MSA",2024,7,61775,58919,2856,4.6
MT4113460000000,41,13460,"Bend, OR MSA",2024,7,133091,127356,5735,4.3
MT4118700000000,41,18700,"Corvallis, OR MSA",2024,7,49327,47623,1704,3.5
MT4121660000000,41,21660,"Eugene-Springfield, OR MSA",2024,7,188620,180782,7838,4.2
MT4124420000000,41,24420,"Grants Pass, OR MSA",2024,7,35230,33164,2066,5.9
MT4132780000000,41,32780,"Medford, OR MSA",2024,7,106282,101140,5142,4.8
MT4138900000000,41,38900,"Portland-Vancouver-Hillsboro, OR-WA MSA",2024,7,1386016,1331084,54932,4
MT4141420000000,41,41420,"Salem, OR MSA",2024,7,221657,212714,8943,4
MT4210900000000,42,10900,"Allentown-Bethlehem-Easton, PA-NJ MSA",2024,7,452537,435109,17428,3.9
MT4211020000000,42,11020,"Altoona, PA MSA",2024,7,57552,55487,2065,3.6
MT4216540000000,42,16540,"Chambersburg, PA MSA",2024,7,77632,75237,2395,3.1
MT4221500000000,42,21500,"Erie, PA MSA",2024,7,126706,121917,4789,3.8
MT4223900000000,42,23900,"Gettysburg, PA MSA",2024,7,51775,50178,1597,3.1
MT4225420000000,42,25420,"Harrisburg-Carlisle, PA MSA",2024,7,313226,302898,10328,3.3
MT4227780000000,42,27780,"Johnstown, PA MSA",2024,7,56527,54087,2440,4.3
MT4229540000000,42,29540,"Lancaster, PA MSA",2024,7,292272,283858,8414,2.9
MT4230140000000,42,30140,"Lebanon, PA MSA",2024,7,73678,71388,2290,3.1
MT4237980000000,42,37980,"Philadelphia-Camden-Wilmington, PA-NJ-DE-MD MSA",2024,7,3296078,3168868,127210,3.9
MT4238300000000,42,38300,"Pittsburgh, PA MSA",2024,7,1236101,1190654,45447,3.7
MT4239740000000,42,39740,"Reading, PA MSA",2024,7,219275,211203,8072,3.7
MT4242540000000,42,42540,"Scranton--Wilkes-Barre, PA MSA",2024,7,280099,268164,11935,4.3
MT4244300000000,42,44300,"State College, PA MSA",2024,7,76088,73913,2175,2.9
MT4248700000000,42,48700,"Williamsport, PA MSA",2024,7,52867,50737,2130,4
MT4249620000000,42,49620,"York-Hanover, PA MSA",2024,7,240282,232060,8222,3.4
MT4439300000000,44,39300,"Providence-Warwick, RI-MA MSA",2024,7,905747,864389,41358,4.6
MT4516700000000,45,16700,"Charleston-North Charleston, SC MSA",2024,7,446058,429222,16836,3.8
MT4517900000000,45,17900,"Columbia, SC MSA",2024,7,422410,404258,18152,4.3
MT4522500000000,45,22500,"Florence, SC MSA",2024,7,92564,88059,4505,4.9
MT4524860000000,45,24860,"Greenville-Anderson-Greer, SC MSA",2024,7,481006,461064,19942,4.1
MT4525940000000,45,25940,"Hilton Head Island-Bluffton-Port Royal, SC MSA",2024,7,98660,94484,4176,4.2
MT4534820000000,45,34820,"Myrtle Beach-Conway-North Myrtle Beach, SC MSA",2024,7,171302,162655,8647,5
MT4543900000000,45,43900,"Spartanburg, SC MSA",2024,7,178218,169988,8230,4.6
MT4544940000000,45,44940,"Sumter, SC MSA",2024,7,41898,39589,2309,5.5
MT4639660000000,46,39660,"Rapid City, SD MSA",2024,7,79843,78377,1466,1.8
MT4643620000000,46,43620,"Sioux Falls, SD-MN MSA",2024,7,175543,172536,3007,1.7
MT4716860000000,47,16860,"Chattanooga, TN-GA MSA",2024,7,292644,283171,9473,3.2
MT4717300000000,47,17300,"Clarksville, TN-KY MSA",2024,7,139654,133877,5777,4.1
MT4717420000000,47,17420,"Cleveland, TN MSA",2024,7,56173,54065,2108,3.8
MT4727180000000,47,27180,"Jackson, TN MSA",2024,7,78053,74995,3058,3.9
MT4727740000000,47,27740,"Johnson City, TN MSA",2024,7,97103,93624,3479,3.6
MT4728700000000,47,28700,"Kingsport-Bristol, TN-VA MSA",2024,7,133043,128188,4855,3.6
MT4728940000000,47,28940,"Knoxville, TN MSA",2024,7,453624,439118,14506,3.2
MT4732820000000,47,32820,"Memphis, TN-MS-AR MSA",2024,7,625906,600115,25791,4.1
MT4734100000000,47,34100,"Morristown, TN MSA",2024,7,53992,52031,1961,3.6
MT4734980000000,47,34980,"Nashville-Davidson--Murfreesboro--Franklin, TN MSA",2024,7,1164161,1130752,33409,2.9
MT4810180000000,48,10180,"Abilene, TX MSA",2024,7,86922,83852,3070,3.5
MT4811100000000,48,11100,"Amarillo, TX MSA",2024,7,138101,133695,4406,3.2
MT4812420000000,48,12420,"Austin-Round Rock-San Marcos, TX MSA",2024,7,1509299,1455200,54099,3.6
MT4813140000000,48,13140,"Beaumont-Port Arthur, TX MSA",2024,7,183848,173484,10364,5.6
MT4815180000000,48,15180,"Brownsville-Harlingen, TX MSA",2024,7,190465,180223,10242,5.4
MT4817780000000,48,17780,"College Station-Bryan, TX MSA",2024,7,151818,146528,5290,3.5
MT4818580000000,48,18580,"Corpus Christi, TX MSA",2024,7,209788,200367,9421,4.5
MT4819100000000,48,19100,"Dallas-Fort Worth-Arlington, TX MSA",2024,7,4500756,4322161,178595,4
MT4820580000000,48,20580,"Eagle Pass, TX MSA",2024,7,24236,22275,1961,8.1
MT4821340000000,48,21340,"El Paso, TX MSA",2024,7,416772,399237,17535,4.2
MT4826420000000,48,26420,"Houston-Pasadena-The Woodlands, TX MSA",2024,7,3845517,3673503,172014,4.5
MT4828660000000,48,28660,"Killeen-Temple, TX MSA",2024,7,202673,193444,9229,4.6
MT4829700000000,48,29700,"Laredo, TX MSA",2024,7,119141,114159,4982,4.2
MT4830980000000,48,30980,"Longview, TX MSA",2024,7,129054,122966,6088,4.7
MT4831180000000,48,31180,"Lubbock, TX MSA",2024,7,184689,178126,6563,3.6
MT4832580000000,48,32580,"McAllen-Edinburg-Mission, TX MSA",2024,7,397687,373373,24314,6.1
MT4833260000000,48,33260,"Midland, TX MSA",2024,7,103837,100772,3065,3
MT4836220000000,48,36220,"Odessa, TX MSA",2024,7,86802,83741,3061,3.5
MT4841660000000,48,41660,"San Angelo, TX MSA",2024,7,62283,60262,2021,3.2
MT4841700000000,48,41700,"San Antonio-New Braunfels, TX MSA",2024,7,1340800,1289162,51638,3.9
MT4843300000000,48,43300,"Sherman-Denison, TX MSA",2024,7,71577,68710,2867,4
MT4845500000000,48,45500,"Texarkana, TX-AR MSA",2024,7,62107,59500,2607,4.2
MT4846340000000,48,46340,"Tyler, TX MSA",2024,7,118435,113808,4627,3.9
MT4847020000000,48,47020,"Victoria, TX MSA",2024,7,45063,43203,1860,4.1
MT4847380000000,48,47380,"Waco, TX MSA",2024,7,146862,141160,5702,3.9
MT4848660000000,48,48660,"Wichita Falls, TX MSA",2024,7,66924,64320,2604,3.9
MT4930860000000,49,30860,"Logan, UT-ID MSA",2024,7,80357,77947,2410,3
MT4936260000000,49,36260,"Ogden, UT MSA",2024,7,352656,341582,11074,3.1
MT4939340000000,49,39340,"Provo-Orem-Lehi, UT MSA",2024,7,371201,358503,12698,3.4
MT4941100000000,49,41100,"St. George, UT MSA",2024,7,94339,91022,3317,3.5
MT4941620000000,49,41620,"Salt Lake City-Murray, UT MSA",2024,7,739643,715334,24309,3.3
MT5015540000000,50,15540,"Burlington-South Burlington, VT MSA",2024,7,131771,129053,2718,2.1
MT5113980000000,51,13980,"Blacksburg-Christiansburg-Radford, VA MSA",2024,7,92882,89907,2975,3.2
MT5116820000000,51,16820,"Charlottesville, VA MSA",2024,7,121183,118082,3101,2.6
MT5125500000000,51,25500,"Harrisonburg, VA MSA",2024,7,72402,70333,2069,2.9
MT5131340000000,51,31340,"Lynchburg, VA MSA",2024,7,127086,122907,4179,3.3
MT5140060000000,51,40060,"Richmond, VA MSA",2024,7,730248,708203,22045,3
MT5140220000000,51,40220,"Roanoke, VA MSA",2024,7,158746,153992,4754,3
MT5144420000000,51,44420,"Staunton-Stuarts Draft, VA MSA",2024,7,65451,63708,1743,2.7
MT5147260000000,51,47260,"Virginia Beach-Chesapeake-Norfolk, VA-NC MSA",2024,7,883346,855887,27459,3.1
MT5149020000000,51,49020,"Winchester, VA-WV MSA",2024,7,77521,75340,2181,2.8
MT5313380000000,53,13380,"Bellingham, WA MSA",2024,7,114464,109164,5300,4.6
MT5314740000000,53,14740,"Bremerton-Silverdale-Port Orchard, WA MSA",2024,7,122431,116889,5542,4.5
MT5328420000000,53,28420,"Kennewick-Richland, WA MSA",2024,7,147656,140076,7580,5.1
MT5331020000000,53,31020,"Longview-Kelso, WA MSA",2024,7,47444,44933,2511,5.3
MT5334580000000,53,34580,"Mount Vernon-Anacortes, WA MSA",2024,7,59764,56698,3066,5.1
MT5336500000000,53,36500,"Olympia-Lacey-Tumwater, WA MSA",2024,7,144023,137445,6578,4.6
MT5342660000000,53,42660,"Seattle-Tacoma-Bellevue, WA MSA",2024,7,2328218,2231811,96407,4.1
MT5344060000000,53,44060,"Spokane-Spokane Valley, WA MSA",2024,7,282560,269149,13411,4.7
MT5347460000000,53,47460,"Walla Walla, WA MSA",2024,7,29179,27895,1284,4.4
MT5348300000000,53,48300,"Wenatchee-East Wenatchee, WA MSA",2024,7,62005,58914,3091,5
MT5349420000000,53,49420,"Yakima, WA MSA",2024,7,124785,116799,7986,6.4
MT5413220000000,54,13220,"Beckley, WV MSA",2024,7,46345,44400,1945,4.2
MT5416620000000,54,16620,"Charleston, WV MSA",2024,7,90897,87160,3737,4.1
MT5426580000000,54,26580,"Huntington-Ashland, WV-KY-OH MSA",2024,7,157541,149672,7869,5
MT5434060000000,54,34060,"Morgantown, WV MSA",2024,7,70865,68438,2427,3.4
MT5437620000000,54,37620,"Parkersburg-Vienna, WV MSA",2024,7,39430,37738,1692,4.3
MT5448540000000,54,48540,"Wheeling, WV-OH MSA",2024,7,59773,56783,2990,5
MT5511540000000,55,11540,"Appleton, WI MSA",2024,7,137572,134103,3469,2.5
MT5520740000000,55,20740,"Eau Claire, WI MSA",2024,7,96401,93625,2776,2.9
MT5522540000000,55,22540,"Fond du Lac, WI MSA",2024,7,55523,53924,1599,2.9
MT5524580000000,55,24580,"Green Bay, WI MSA",2024,7,179745,174982,4763,2.6
MT5527500000000,55,27500,"Janesville-Beloit, WI MSA",2024,7,87176,84351,2825,3.2
MT5528450000000,55,28450,"Kenosha, WI MSA",2024,7,95808,92802,3006,3.1
MT5529100000000,55,29100,"La Crosse-Onalaska, WI-MN MSA",2024,7,90903,88417,2486,2.7
MT5531540000000,55,31540,"Madison, WI MSA",2024,7,411626,401631,9995,2.4
MT5533340000000,55,33340,"Milwaukee-Waukesha, WI MSA",2024,7,820381,794351,26030,3.2
MT5536780000000,55,36780,"Oshkosh-Neenah, WI MSA",2024,7,93115,90641,2474,2.7
MT5539540000000,55,39540,"Racine-Mount Pleasant, WI MSA",2024,7,101540,97964,3576,3.5
MT5543100000000,55,43100,"Sheboygan, WI MSA",2024,7,62996,61398,1598,2.5
MT5548140000000,55,48140,"Wausau, WI MSA",2024,7,75333,73385,1948,2.6
MT5616220000000,56,16220,"Casper, WY MSA",2024,7,42267,40871,1396,3.3
MT5616940000000,56,16940,"Cheyenne, WY MSA",2024,7,49106,47411,1695,3.5
MT7210380000000,72,10380,"Aguadilla, PR MSA",2024,7,90677,84349,6328,7
MT7211640000000,72,11640,"Arecibo, PR MSA",2024,7,67721,63923,3798,5.6
MT7225020000000,72,25020,"Guayama, PR MSA",2024,7,19050,17182,1868,9.8
MT7232420000000,72,32420,"Mayaguez, PR MSA",2024,7,66650,61725,4925,7.4
MT7238660000000,72,38660,"Ponce, PR MSA",2024,7,89150,81320,7830,8.8
MT7241980000000,72,41980,"San Juan-Bayamon-Caguas, PR MSA",2024,7,813747,775058,38689,4.8
MT0111500000000,1,11500,"Anniston-Oxford, AL MSA",2024,8,49813,48143,1670,3.4
MT0112220000000,1,12220,"Auburn-Opelika, AL MSA",2024,8,96558,93562,2996,3.1
MT0113820000000,1,13820,"Birmingham, AL MSA",2024,8,573114,556201,16913,3
MT0119300000000,1,19300,"Daphne-Fairhope-Foley, AL MSA",2024,8,116786,113422,3364,2.9
MT0119460000000,1,19460,"Decatur, AL MSA",2024,8,76273,74162,2111,2.8
MT0120020000000,1,20020,"Dothan, AL MSA",2024,8,67942,65764,2178,3.2
MT0122520000000,1,22520,"Florence-Muscle Shoals, AL MSA",2024,8,69371,67009,2362,3.4
MT0123460000000,1,23460,"Gadsden, AL MSA",2024,8,42190,40746,1444,3.4
MT0126620000000,1,26620,"Huntsville, AL MSA",2024,8,277946,270549,7397,2.7
MT0133660000000,1,33660,"Mobile, AL MSA",2024,8,186868,179943,6925,3.7
MT0133860000000,1,33860,"Montgomery, AL MSA",2024,8,179186,173526,5660,3.2
MT0146220000000,1,46220,"Tuscaloosa, AL MSA",2024,8,126948,122556,4392,3.5
MT0211260000000,2,11260,"Anchorage, AK MSA",2024,8,201821,193075,8746,4.3
MT0221820000000,2,21820,"Fairbanks-College, AK MSA",2024,8,45896,43953,1943,4.2
MT0422380000000,4,22380,"Flagstaff, AZ MSA",2024,8,75862,72784,3078,4.1
MT0429420000000,4,29420,"Lake Havasu City-Kingman, AZ MSA",2024,8,87858,83780,4078,4.6
MT0438060000000,4,38060,"Phoenix-Mesa-Chandler, AZ MSA",2024,8,2716850,2625352,91498,3.4
MT0439150000000,4,39150,"Prescott Valley-Prescott, AZ MSA",2024,8,106752,102902,3850,3.6
MT0443420000000,4,43420,"Sierra Vista-Douglas, AZ MSA",2024,8,47894,45802,2092,4.4
MT0446060000000,4,46060,"Tucson, AZ MSA",2024,8,493925,475442,18483,3.7
MT0449740000000,4,49740,"Yuma, AZ MSA",2024,8,98811,86600,12211,12.4
MT0522220000000,5,22220,"Fayetteville-Springdale-Rogers, AR MSA",2024,8,307865,299561,8304,2.7
MT0522900000000,5,22900,"Fort Smith, AR-OK MSA",2024,8,101643,98087,3556,3.5
MT0526300000000,5,26300,"Hot Springs, AR MSA",2024,8,43536,41952,1584,3.6
MT0527860000000,5,27860,"Jonesboro, AR MSA",2024,8,66458,64324,2134,3.2
MT0530780000000,5,30780,"Little Rock-North Little Rock-Conway, AR MSA",2024,8,381887,369469,12418,3.3
MT0612540000000,6,12540,"Bakersfield-Delano, CA MSA",2024,8,409462,373669,35793,8.7
MT0617020000000,6,17020,"Chico, CA MSA",2024,8,91568,86005,5563,6.1
MT0620940000000,6,20940,"El Centro, CA MSA",2024,8,73289,59737,13552,18.5
MT0623420000000,6,23420,"Fresno, CA MSA",2024,8,540848,497686,43162,8
MT0625260000000,6,25260,"Hanford-Corcoran, CA MSA",2024,8,58617,53316,5301,9
MT0631080000000,6,31080,"Los Angeles-Long Beach-Anaheim, CA MSA",2024,8,6757451,6377242,380209,5.6
MT0632900000000,6,32900,"Merced, CA MSA",2024,8,120934,108952,11982,9.9
MT0633700000000,6,33700,"Modesto, CA MSA",2024,8,254719,236810,17909,7
MT0634900000000,6,34900,"Napa, CA MSA",2024,8,74727,71712,3015,4
MT0637100000000,6,37100,"Oxnard-Thousand Oaks-Ventura, CA MSA",2024,8,422344,402536,19808,4.7
MT0639820000000,6,39820,"Redding, CA MSA",2024,8,79531,75170,4361,5.5
MT0640140000000,6,40140,"Riverside-San Bernardino-Ontario, CA MSA",2024,8,2216912,2098261,118651,5.4
MT0640900000000,6,40900,"Sacramento-Roseville-Folsom, CA MSA",2024,8,1184376,1127408,56968,4.8
MT0641500000000,6,41500,"Salinas, CA MSA",2024,8,221020,204834,16186,7.3
MT0641740000000,6,41740,"San Diego-Chula Vista-Carlsbad, CA MSA",2024,8,1650534,1577421,73113,4.4
MT0641860000000,6,41860,"San Francisco-Oakland-Fremont, CA MSA",2024,8,2502019,2394941,107078,4.3
MT0641940000000,6,41940,"San Jose-Sunnyvale-Santa Clara, CA MSA",2024,8,1058958,1013330,45628,4.3
MT0642020000000,6,42020,"San Luis Obispo-Paso Robles, CA MSA",2024,8,132391,126818,5573,4.2
MT0642100000000,6,42100,"Santa Cruz-Watsonville, CA MSA",2024,8,136212,127941,8271,6.1
MT0642200000000,6,42200,"Santa Maria-Santa Barbara, CA MSA",2024,8,221487,211357,10130,4.6
MT0642220000000,6,42220,"Santa Rosa-Petaluma, CA MSA",2024,8,246264,235816,10448,4.2
MT0644700000000,6,44700,"Stockton-Lodi, CA MSA",2024,8,369588,345144,24444,6.6
MT0646700000000,6,46700,"Vallejo, CA MSA",2024,8,216514,205358,11156,5.2
MT0647300000000,6,47300,"Visalia, CA MSA",2024,8,220782,197830,22952,10.4
MT0649700000000,6,49700,"Yuba City, CA MSA",2024,8,81547,75023,6524,8
MT0814500000000,8,14500,"Boulder, CO MSA",2024,8,193928,185160,8768,4.5
MT0817820000000,8,17820,"Colorado Springs, CO MSA",2024,8,397389,379423,17966,4.5
MT0819740000000,8,19740,"Denver-Aurora-Centennial, CO MSA",2024,8,1782761,1702994,79767,4.5
MT0822660000000,8,22660,"Fort Collins-Loveland, CO MSA",2024,8,207871,198829,9042,4.3
MT0824300000000,8,24300,"Grand Junction, CO MSA",2024,8,80317,76535,3782,4.7
MT0824540000000,8,24540,"Greeley, CO MSA",2024,8,178915,170384,8531,4.8
MT0839380000000,8,39380,"Pueblo, CO MSA",2024,8,73844,69255,4589,6.2
MT0914860000000,9,14860,"Bridgeport-Stamford-Danbury, CT MSA",2024,8,517953,502072,15881,3.1
MT0925540000000,9,25540,"Hartford-West Hartford-East Hartford, CT MSA",2024,8,615797,596265,19532,3.2
MT0935300000000,9,35300,"New Haven, CT MSA",2024,8,317016,307017,9999,3.2
MT0935980000000,9,35980,"Norwich-New London-Willimantic, CT MSA",2024,8,143674,139275,4399,3.1
MT0947930000000,9,47930,"Waterbury-Shelton, CT MSA",2024,8,241568,232799,8769,3.6
MT1020100000000,10,20100,"Dover, DE MSA",2024,8,85618,82170,3448,4
MT1147900000000,11,47900,"Washington-Arlington-Alexandria, DC-VA-MD-WV MSA",2024,8,3566059,3455491,110568,3.1
MT1215980000000,12,15980,"Cape Coral-Fort Myers, FL MSA",2024,8,376201,362537,13664,3.6
MT1218880000000,12,18880,"Crestview-Fort Walton Beach-Destin, FL MSA",2024,8,143319,138706,4613,3.2
MT1219660000000,12,19660,"Deltona-Daytona Beach-Ormond Beach, FL MSA",2024,8,322374,309375,12999,4
MT1223540000000,12,23540,"Gainesville, FL MSA",2024,8,169996,163473,6523,3.8
MT1226140000000,12,26140,"Homosassa Springs, FL MSA",2024,8,54065,51273,2792,5.2
MT1227260000000,12,27260,"Jacksonville, FL MSA",2024,8,855962,825775,30187,3.5
MT1229460000000,12,29460,"Lakeland-Winter Haven, FL MSA",2024,8,359230,343764,15466,4.3
MT1233100000000,12,33100,"Miami-Fort Lauderdale-West Palm Beach, FL MSA",2024,8,3313126,3215117,98009,3
MT1234940000000,12,34940,"Naples-Marco Island, FL MSA",2024,8,187395,181107,6288,3.4
MT1235840000000,12,35840,"North Port-Bradenton-Sarasota, FL MSA",2024,8,399819,385179,14640,3.7
MT1236100000000,12,36100,"Ocala, FL MSA",2024,8,159259,152291,6968,4.4
MT1236740000000,12,36740,"Orlando-Kissimmee-Sanford, FL MSA",2024,8,1534546,1482901,51645,3.4
MT1237340000000,12,37340,"Palm Bay-Melbourne-Titusville, FL MSA",2024,8,305557,294434,11123,3.6
MT1237460000000,12,37460,"Panama City-Panama City Beach, FL MSA",2024,8,102081,98553,3528,3.5
MT1237860000000,12,37860,"Pensacola-Ferry Pass-Brent, FL MSA",2024,8,240228,231536,8692,3.6
MT1238940000000,12,38940,"Port St. Lucie, FL MSA",2024,8,241932,232563,9369,3.9
MT1239460000000,12,39460,"Punta Gorda, FL MSA",2024,8,77525,74229,3296,4.3
MT1242680000000,12,42680,"Sebastian-Vero Beach-West Vero Corridor, FL MSA",2024,8,68149,65372,2777,4.1
MT1242700000000,12,42700,"Sebring, FL MSA",2024,8,36809,34984,1825,5
MT1245220000000,12,45220,"Tallahassee, FL MSA",2024,8,208583,201200,7383,3.5
MT1245300000000,12,45300,"Tampa-St. Petersburg-Clearwater, FL MSA",2024,8,1701304,1640608,60696,3.6
MT1248680000000,12,48680,"Wildwood-The Villages, FL MSA",2024,8,34302,32356,1946,5.7
MT1310500000000,13,10500,"Albany, GA MSA",2024,8,62588,59909,2679,4.3
MT1312020000000,13,12020,"Athens-Clarke County, GA MSA",2024,8,108530,104713,3817,3.5
MT1312060000000,13,12060,"Atlanta-Sandy Springs-Roswell, GA MSA",2024,8,3311567,3194312,117255,3.5
MT1312260000000,13,12260,"Augusta-Richmond County, GA-SC MSA",2024,8,269308,256868,12440,4.6
MT1315260000000,13,15260,"Brunswick-St. Simons, GA MSA",2024,8,55930,54124,1806,3.2
MT1317980000000,13,17980,"Columbus, GA-AL MSA",2024,8,128945,123633,5312,4.1
MT1319140000000,13,19140,"Dalton, GA MSA",2024,8,67826,65068,2758,4.1
MT1323580000000,13,23580,"Gainesville, GA MSA",2024,8,109446,106181,3265,3
MT1325980000000,13,25980,"Hinesville, GA MSA",2024,8,31448,30175,1273,4
MT1331420000000,13,31420,"Macon-Bibb County, GA MSA",2024,8,97239,92986,4253,4.4
MT1340660000000,13,40660,"Rome, GA MSA",2024,8,47853,46095,1758,3.7
MT1342340000000,13,42340,"Savannah, GA MSA",2024,8,210226,203546,6680,3.2
MT1346660000000,13,46660,"Valdosta, GA MSA",2024,8,61841,59300,2541,4.1
MT1347580000000,13,47580,"Warner Robins, GA MSA",2024,8,90281,87303,2978,3.3
MT1527980000000,15,27980,"Kahului-Wailuku, HI MSA",2024,8,81410,78118,3292,4
MT1546520000000,15,46520,"Urban Honolulu, HI MSA",2024,8,472189,458780,13409,2.8
MT1614260000000,16,14260,"Boise City, ID MSA",2024,8,449583,433344,16239,3.6
MT1617660000000,16,17660,"Coeur d'Alene, ID MSA",2024,8,90424,86316,4108,4.5
MT1626820000000,16,26820,"Idaho Falls, ID MSA",2024,8,84937,82201,2736,3.2
MT1630300000000,16,30300,"Lewiston, ID-WA MSA",2024,8,31048,29868,1180,3.8
MT1638540000000,16,38540,"Pocatello, ID MSA",2024,8,41126,39435,1691,4.1
MT1646300000000,16,46300,"Twin Falls, ID MSA",2024,8,60686,58485,2201,3.6
MT1714010000000,17,14010,"Bloomington, IL MSA",2024,8,96326,92484,3842,4
MT1716580000000,17,16580,"Champaign-Urbana, IL MSA",2024,8,125220,119954,5266,4.2
MT1716980000000,17,16980,"Chicago-Naperville-Elgin, IL-IN MSA",2024,8,5035781,4768389,267392,5.3
MT1719340000000,17,19340,"Davenport-Moline-Rock Island, IA-IL MSA",2024,8,189466,180077,9389,5
MT1719500000000,17,19500,"Decatur, IL MSA",2024,8,44580,41971,2609,5.9
MT1728100000000,17,28100,"Kankakee, IL MSA",2024,8,51188,48246,2942,5.7
MT1737900000000,17,37900,"Peoria, IL MSA",2024,8,178316,169643,8673,4.9
MT1740420000000,17,40420,"Rockford, IL MSA",2024,8,160382,151496,8886,5.5
MT1744100000000,17,44100,"Springfield, IL MSA",2024,8,103473,98992,4481,4.3
MT1814020000000,18,14020,"Bloomington, IN MSA",2024,8,86332,82947,3385,3.9
MT1818020000000,18,18020,"Columbus, IN MSA",2024,8,39608,37922,1686,4.3
MT1821140000000,18,21140,"Elkhart-Goshen, IN MSA",2024,8,98392,93393,4999,5.1
MT1821780000000,18,21780,"Evansville, IN MSA",2024,8,136459,130974,5485,4
MT1823060000000,18,23060,"Fort Wayne, IN MSA",2024,8,233032,223842,9190,3.9
MT1826900000000,18,26900,"Indianapolis-Carmel-Greenwood, IN MSA",2024,8,1146314,1100716,45598,4
MT1829020000000,18,29020,"Kokomo, IN MSA",2024,8,36568,34314,2254,6.2
MT1829200000000,18,29200,"Lafayette-West Lafayette, IN MSA",2024,8,120589,115856,4733,3.9
MT1833140000000,18,33140,"Michigan City-La Porte, IN MSA",2024,8,51815,49253,2562,4.9
MT1834620000000,18,34620,"Muncie, IN MSA",2024,8,53149,50578,2571,4.8
MT1843780000000,18,43780,"South Bend-Mishawaka, IN-MI MSA",2024,8,155686,147732,7954,5.1
MT1845460000000,18,45460,"Terre Haute, IN MSA",2024,8,78138,74579,3559,4.6
MT1911180000000,19,11180,"Ames, IA MSA",2024,8,69536,67850,1686,2.4
MT1916300000000,19,16300,"Cedar Rapids, IA MSA",2024,8,145770,140838,4932,3.4
MT1919780000000,19,19780,"Des Moines-West Des Moines, IA MSA",2024,8,413240,400229,13011,3.1
MT1920220000000,19,20220,"Dubuque, IA MSA",2024,8,53419,51752,1667,3.1
MT1926980000000,19,26980,"Iowa City, IA MSA",2024,8,99886,97514,2372,2.4
MT1943580000000,19,43580,"Sioux City, IA-NE-SD MSA",2024,8,76565,74248,2317,3
MT1947940000000,19,47940,"Waterloo-Cedar Falls, IA MSA",2024,8,88438,85044,3394,3.8
MT2029940000000,20,29940,"Lawrence, KS MSA",2024,8,71580,69137,2443,3.4
MT2031740000000,20,31740,"Manhattan, KS MSA",2024,8,64745,62498,2247,3.5
MT2045820000000,20,45820,"Topeka, KS MSA",2024,8,119248,114698,4550,3.8
MT2048620000000,20,48620,"Wichita, KS MSA",2024,8,338409,324412,13997,4.1
MT2114540000000,21,14540,"Bowling Green, KY MSA",2024,8,93770,89211,4559,4.9
MT2121060000000,21,21060,"Elizabethtown, KY MSA",2024,8,55828,52793,3035,5.4
MT2130460000000,21,30460,"Lexington-Fayette, KY MSA",2024,8,279194,266978,12216,4.4
MT2131140000000,21,31140,"Louisville/Jefferson County, KY-IN MSA",2024,8,703985,670534,33451,4.8
MT2136980000000,21,36980,"Owensboro, KY MSA",2024,8,52745,49990,2755,5.2
MT2137140000000,21,37140,"Paducah, KY-IL MSA",2024,8,46282,43834,2448,5.3
MT2210780000000,22,10780,"Alexandria, LA MSA",2024,8,64398,61775,2623,4.1
MT2212940000000,22,12940,"Baton Rouge, LA MSA",2024,8,427526,409849,17677,4.1
MT2225220000000,22,25220,"Hammond, LA MSA",2024,8,60970,57941,3029,5
MT2226380000000,22,26380,"Houma-Bayou Cane-Thibodaux, LA MSA",2024,8,88097,84628,3469,3.9
MT2229180000000,22,29180,"Lafayette, LA MSA",2024,8,197913,190264,7649,3.9
MT2229340000000,22,29340,"Lake Charles, LA MSA",2024,8,98046,93482,4564,4.7
MT2233740000000,22,33740,"Monroe, LA MSA",2024,8,95940,91135,4805,5
MT2235380000000,22,35380,"New Orleans-Metairie, LA MSA",2024,8,468427,447635,20792,4.4
MT2243340000000,22,43340,"Shreveport-Bossier City, LA MSA",2024,8,167824,160346,7478,4.5
MT2243640000000,22,43640,"Slidell-Mandeville-Covington, LA MSA",2024,8,129547,124425,5122,4
MT2312620000000,23,12620,"Bangor, ME MSA",2024,8,76380,73707,2673,3.5
MT2330340000000,23,30340,"Lewiston-Auburn, ME MSA",2024,8,55862,54005,1857,3.3
MT2338860000000,23,38860,"Portland-South Portland, ME MSA",2024,8,316505,307591,8914,2.8
MT2412580000000,24,12580,"Baltimore-Columbia-Towson, MD MSA",2024,8,1500063,1452149,47914,3.2
MT2425180000000,24,25180,"Hagerstown-Martinsburg, MD-WV MSA",2024,8,144388,139488,4900,3.4
MT2430500000000,24,30500,"Lexington Park, MD MSA",2024,8,109980,106893,3087,2.8
MT2441540000000,24,41540,"Salisbury, MD MSA",2024,8,64516,62214,2302,3.6
MT2511200000000,25,11200,"Amherst Town-Northampton, MA MSA",2024,8,85934,82592,3342,3.9
MT2512700000000,25,12700,"Barnstable Town, MA MSA",2024,8,118354,112566,5788,4.9
MT2514460000000,25,14460,"Boston-Cambridge-Newton, MA-NH MSA",2024,8,2840797,2732756,108041,3.8
MT2538340000000,25,38340,"Pittsfield, MA MSA",2024,8,64289,61604,2685,4.2
MT2544140000000,25,44140,"Springfield, MA MSA",2024,8,226232,214465,11767,5.2
MT2549340000000,25,49340,"Worcester, MA MSA",2024,8,469131,449232,19899,4.2
MT2611460000000,26,11460,"Ann Arbor, MI MSA",2024,8,209606,201367,8239,3.9
MT2612980000000,26,12980,"Battle Creek, MI MSA",2024,8,64642,61081,3561,5.5
MT2613020000000,26,13020,"Bay City, MI MSA",2024,8,50731,47771,2960,5.8
MT2619820000000,26,19820,"Detroit-Warren-Dearborn, MI MSA",2024,8,2177923,2073517,104406,4.8
MT2622420000000,26,22420,"Flint, MI MSA",2024,8,191409,180042,11367,5.9
MT2624340000000,26,24340,"Grand Rapids-Wyoming-Kentwood, MI MSA",2024,8,634740,607733,27007,4.3
MT2627100000000,26,27100,"Jackson, MI MSA",2024,8,75497,71646,3851,5.1
MT2628020000000,26,28020,"Kalamazoo-Portage, MI MSA",2024,8,141731,135558,6173,4.4
MT2629620000000,26,29620,"Lansing-East Lansing, MI MSA",2024,8,257115,245454,11661,4.5
MT2633220000000,26,33220,"Midland, MI MSA",2024,8,43346,41291,2055,4.7
MT2633780000000,26,33780,"Monroe, MI MSA",2024,8,80118,75460,4658,5.8
MT2634740000000,26,34740,"Muskegon-Norton Shores, MI MSA",2024,8,86279,81619,4660,5.4
MT2635660000000,26,35660,"Niles, MI MSA",2024,8,77547,73384,4163,5.4
MT2640980000000,26,40980,"Saginaw, MI MSA",2024,8,85825,80548,5277,6.1
MT2645900000000,26,45900,"Traverse City, MI MSA",2024,8,82836,79035,3801,4.6
MT2720260000000,27,20260,"Duluth, MN-WI MSA",2024,8,139833,134690,5143,3.7
MT2731860000000,27,31860,"Mankato, MN MSA",2024,8,60571,58926,1645,2.7
MT2733460000000,27,33460,"Minneapolis-St. Paul-Bloomington, MN-WI MSA",2024,8,2069652,2007501,62151,3
MT2740340000000,27,40340,"Rochester, MN MSA",2024,8,128217,124852,3365,2.6
MT2741060000000,27,41060,"St. Cloud, MN MSA",2024,8,111554,107846,3708,3.3
MT2825060000000,28,25060,"Gulfport-Biloxi, MS MSA",2024,8,189380,183601,5779,3.1
MT2825620000000,28,25620,"Hattiesburg, MS MSA",2024,8,70569,68388,2181,3.1
MT2827140000000,28,27140,"Jackson, MS MSA",2024,8,284954,276498,8456,3
MT2916020000000,29,16020,"Cape Girardeau, MO-IL MSA",2024,8,49204,47445,1759,3.6
MT2917860000000,29,17860,"Columbia, MO MSA",2024,8,113011,109345,3666,3.2
MT2927620000000,29,27620,"Jefferson City, MO MSA",2024,8,76808,74357,2451,3.2
MT2927900000000,29,27900,"Joplin, MO-KS MSA",2024,8,98467,94904,3563,3.6
MT2928140000000,29,28140,"Kansas City, MO-KS MSA",2024,8,1203800,1160296,43504,3.6
MT2941140000000,29,41140,"St. Joseph, MO-KS MSA",2024,8,54897,52777,2120,3.9
MT2941180000000,29,41180,"St. Louis, MO-IL MSA",2024,8,1489633,1433697,55936,3.8
MT2944180000000,29,44180,"Springfield, MO MSA",2024,8,244567,236184,8383,3.4
MT3013740000000,30,13740,"Billings, MT MSA",2024,8,99372,96531,2841,2.9
MT3014580000000,30,14580,"Bozeman, MT MSA",2024,8,78493,76644,1849,2.4
MT3024500000000,30,24500,"Great Falls, MT MSA",2024,8,39761,38551,1210,3
MT3025740000000,30,25740,"Helena, MT MSA",2024,8,47850,46536,1314,2.7
MT3033540000000,30,33540,"Missoula, MT MSA",2024,8,74496,72308,2188,2.9
MT3124260000000,31,24260,"Grand Island, NE MSA",2024,8,42966,41752,1214,2.8
MT3130700000000,31,30700,"Lincoln, NE MSA",2024,8,194486,189308,5178,2.7
MT3136540000000,31,36540,"Omaha, NE-IA MSA",2024,8,528804,512466,16338,3.1
MT3216180000000,32,16180,"Carson City, NV MSA",2024,8,29469,28019,1450,4.9
MT3229820000000,32,29820,"Las Vegas-Henderson-North Las Vegas, NV MSA",2024,8,1222029,1149237,72792,6
MT3239900000000,32,39900,"Reno, NV MSA",2024,8,300094,285110,14984,5
MT3331700000000,33,31700,"Manchester-Nashua, NH MSA",2024,8,241880,235001,6879,2.8
MT3412100000000,34,12100,"Atlantic City-Hammonton, NJ MSA",2024,8,181146,169448,11698,6.5
MT3445940000000,34,45940,"Trenton-Princeton, NJ MSA",2024,8,199783,190837,8946,4.5
MT3447220000000,34,47220,"Vineland, NJ MSA",2024,8,66096,61324,4772,7.2
MT3510740000000,35,10740,"Albuquerque, NM MSA",2024,8,465462,446576,18886,4.1
MT3522140000000,35,22140,"Farmington, NM MSA",2024,8,50075,47644,2431,4.9
MT3529740000000,35,29740,"Las Cruces, NM MSA",2024,8,102385,97176,5209,5.1
MT3542140000000,35,42140,"Santa Fe, NM MSA",2024,8,74530,71610,2920,3.9
MT3610580000000,36,10580,"Albany-Schenectady-Troy, NY MSA",2024,8,457102,441817,15285,3.3
MT3613780000000,36,13780,"Binghamton, NY MSA",2024,8,106300,102055,4245,4
MT3615380000000,36,15380,"Buffalo-Cheektowaga, NY MSA",2024,8,555683,533860,21823,3.9
MT3621300000000,36,21300,"Elmira, NY MSA",2024,8,35121,33767,1354,3.9
MT3624020000000,36,24020,"Glens Falls, NY MSA",2024,8,59620,57473,2147,3.6
MT3627060000000,36,27060,"Ithaca, NY MSA",2024,8,48192,46589,1603,3.3
MT3628740000000,36,28740,"Kingston, NY MSA",2024,8,87045,83939,3106,3.6
MT3628880000000,36,28880,"Kiryas Joel-Poughkeepsie-Newburgh, NY MSA",2024,8,339280,327533,11747,3.5
MT3635620000000,36,35620,"New York-Newark-Jersey City, NY-NJ MSA",2024,8,10240090,9759613,480477,4.7
MT3640380000000,36,40380,"Rochester, NY MSA",2024,8,513114,494570,18544,3.6
MT3645060000000,36,45060,"Syracuse, NY MSA",2024,8,311988,300585,11403,3.7
MT3646540000000,36,46540,"Utica-Rome, NY MSA",2024,8,126794,121847,4947,3.9
MT3648060000000,36,48060,"Watertown-Fort Drum, NY MSA",2024,8,44760,42776,1984,4.4
MT3711700000000,37,11700,"Asheville, NC MSA",2024,8,212004,205791,6213,2.9
MT3715500000000,37,15500,"Burlington, NC MSA",2024,8,86101,82978,3123,3.6
MT3716740000000,37,16740,"Charlotte-Concord-Gastonia, NC-SC MSA",2024,8,1483992,1428591,55401,3.7
MT3720500000000,37,20500,"Durham-Chapel Hill, NC MSA",2024,8,323562,313150,10412,3.2
MT3722180000000,37,22180,"Fayetteville, NC MSA",2024,8,153755,146724,7031,4.6
MT3724140000000,37,24140,"Goldsboro, NC MSA",2024,8,51212,49293,1919,3.7
MT3724660000000,37,24660,"Greensboro-High Point, NC MSA",2024,8,371202,356054,15148,4.1
MT3724780000000,37,24780,"Greenville, NC MSA",2024,8,83565,80215,3350,4
MT3725860000000,37,25860,"Hickory-Lenoir-Morganton, NC MSA",2024,8,170734,164493,6241,3.7
MT3727340000000,37,27340,"Jacksonville, NC MSA",2024,8,73950,71165,2785,3.8
MT3738240000000,37,38240,"Pinehurst-Southern Pines, NC MSA",2024,8,44941,43401,1540,3.4
MT3739580000000,37,39580,"Raleigh-Cary, NC MSA",2024,8,847687,821249,26438,3.1
MT3740580000000,37,40580,"Rocky Mount, NC MSA",2024,8,63720,60634,3086,4.8
MT3748900000000,37,48900,"Wilmington, NC MSA",2024,8,223792,215835,7957,3.6
MT3749180000000,37,49180,"Winston-Salem, NC MSA",2024,8,324976,312910,12066,3.7
MT3813900000000,38,13900,"Bismarck, ND MSA",2024,8,73374,71608,1766,2.4
MT3822020000000,38,22020,"Fargo, ND-MN MSA",2024,8,154308,150644,3664,2.4
MT3824220000000,38,24220,"Grand Forks, ND-MN MSA",2024,8,57094,55637,1457,2.6
MT3833500000000,38,33500,"Minot, ND MSA",2024,8,40003,38966,1037,2.6
MT3910420000000,39,10420,"Akron, OH MSA",2024,8,360125,343762,16363,4.5
MT3915940000000,39,15940,"Canton-Massillon, OH MSA",2024,8,195820,186653,9167,4.7
MT3917140000000,39,17140,"Cincinnati, OH-KY-IN MSA",2024,8,1177639,1126968,50671,4.3
MT3917410000000,39,17410,"Cleveland, OH MSA",2024,8,1103654,1061420,42234,3.8
MT3918140000000,39,18140,"Columbus, OH MSA",2024,8,1164775,1117357,47418,4.1
MT3919430000000,39,19430,"Dayton-Kettering-Beavercreek, OH MSA",2024,8,396262,378461,17801,4.5
MT3930620000000,39,30620,"Lima, OH MSA",2024,8,47668,45518,2150,4.5
MT3931900000000,39,31900,"Mansfield, OH MSA",2024,8,53694,50979,2715,5.1
MT3941780000000,39,41780,"Sandusky, OH MSA",2024,8,57564,54377,3187,5.5
MT3944220000000,39,44220,"Springfield, OH MSA",2024,8,62301,59330,2971,4.8
MT3945780000000,39,45780,"Toledo, OH MSA",2024,8,294992,281263,13729,4.7
MT3948260000000,39,48260,"Weirton-Steubenville, WV-OH MSA",2024,8,51150,48122,3028,5.9
MT3949660000000,39,49660,"Youngstown-Warren, OH MSA",2024,8,193312,183341,9971,5.2
MT4021420000000,40,21420,"Enid, OK MSA",2024,8,28350,27440,910,3.2
MT4030020000000,40,30020,"Lawton, OK MSA",2024,8,52393,50493,1900,3.6
MT4036420000000,40,36420,"Oklahoma City, OK MSA",2024,8,774450,750573,23877,3.1
MT4046140000000,40,46140,"Tulsa, OK MSA",2024,8,525464,508018,17446,3.3
MT4110540000000,41,10540,"Albany, OR MSA",2024,8,61976,59077,2899,4.7
MT4113460000000,41,13460,"Bend, OR MSA",2024,8,133140,127379,5761,4.3
MT4118700000000,41,18700,"Corvallis, OR MSA",2024,8,49267,47509,1758,3.6
MT4121660000000,41,21660,"Eugene-Springfield, OR MSA",2024,8,188590,180606,7984,4.2
MT4124420000000,41,24420,"Grants Pass, OR MSA",2024,8,35148,33051,2097,6
MT4132780000000,41,32780,"Medford, OR MSA",2024,8,106191,100984,5207,4.9
MT4138900000000,41,38900,"Portland-Vancouver-Hillsboro, OR-WA MSA",2024,8,1386652,1330657,55995,4
MT4141420000000,41,41420,"Salem, OR MSA",2024,8,222690,213533,9157,4.1
MT4210900000000,42,10900,"Allentown-Bethlehem-Easton, PA-NJ MSA",2024,8,452386,434833,17553,3.9
MT4211020000000,42,11020,"Altoona, PA MSA",2024,8,57566,55486,2080,3.6
MT4216540000000,42,16540,"Chambersburg, PA MSA",2024,8,77643,75224,2419,3.1
MT4221500000000,42,21500,"Erie, PA MSA",2024,8,126337,121491,4846,3.8
MT4223900000000,42,23900,"Gettysburg, PA MSA",2024,8,51657,50046,1611,3.1
MT4225420000000,42,25420,"Harrisburg-Carlisle, PA MSA",2024,8,313370,303019,10351,3.3
MT4227780000000,42,27780,"Johnstown, PA MSA",2024,8,56380,53935,2445,4.3
MT4229540000000,42,29540,"Lancaster, PA MSA",2024,8,291784,283301,8483,2.9
MT4230140000000,42,30140,"Lebanon, PA MSA",2024,8,73720,71416,2304,3.1
MT4237980000000,42,37980,"Philadelphia-Camden-Wilmington, PA-NJ-DE-MD MSA",2024,8,3292126,3164341,127785,3.9
MT4238300000000,42,38300,"Pittsburgh, PA MSA",2024,8,1233696,1188122,45574,3.7
MT4239740000000,42,39740,"Reading, PA MSA",2024,8,219158,211062,8096,3.7
MT4242540000000,42,42540,"Scranton--Wilkes-Barre, PA MSA",2024,8,279511,267605,11906,4.3
MT4244300000000,42,44300,"State College, PA MSA",2024,8,75920,73736,2184,2.9
MT4248700000000,42,48700,"Williamsport, PA MSA",2024,8,52801,50662,2139,4.1
MT4249620000000,42,49620,"York-Hanover, PA MSA",2024,8,239858,231533,8325,3.5
MT4439300000000,44,39300,"Providence-Warwick, RI-MA MSA",2024,8,905723,863946,41777,4.6
MT4516700000000,45,16700,"Charleston-North Charleston, SC MSA",2024,8,447352,430218,17134,3.8
MT4517900000000,45,17900,"Columbia, SC MSA",2024,8,423384,404978,18406,4.3
MT4522500000000,45,22500,"Florence, SC MSA",2024,8,92616,88075,4541,4.9
MT4524860000000,45,24860,"Greenville-Anderson-Greer, SC MSA",2024,8,481615,461447,20168,4.2
MT4525940000000,45,25940,"Hilton Head Island-Bluffton-Port Royal, SC MSA",2024,8,98923,94708,4215,4.3
MT4534820000000,45,34820,"Myrtle Beach-Conway-North Myrtle Beach, SC MSA",2024,8,171494,162766,8728,5.1
MT4543900000000,45,43900,"Spartanburg, SC MSA",2024,8,178625,170269,8356,4.7
MT4544940000000,45,44940,"Sumter, SC MSA",2024,8,41856,39495,2361,5.6
MT4639660000000,46,39660,"Rapid City, SD MSA",2024,8,80190,78713,1477,1.8
MT4643620000000,46,43620,"Sioux Falls, SD-MN MSA",2024,8,175774,172730,3044,1.7
MT4716860000000,47,16860,"Chattanooga, TN-GA MSA",2024,8,292726,283017,9709,3.3
MT4717300000000,47,17300,"Clarksville, TN-KY MSA",2024,8,140079,134144,5935,4.2
MT4717420000000,47,17420,"Cleveland, TN MSA",2024,8,56106,53937,2169,3.9
MT4727180000000,47,27180,"Jackson, TN MSA",2024,8,78197,75033,3164,4
MT4727740000000,47,27740,"Johnson City, TN MSA",2024,8,97153,93535,3618,3.7
MT4728700000000,47,28700,"Kingsport-Bristol, TN-VA MSA",2024,8,133207,128223,4984,3.7
MT4728940000000,47,28940,"Knoxville, TN MSA",2024,8,454605,439646,14959,3.3
MT4732820000000,47,32820,"Memphis, TN-MS-AR MSA",2024,8,626424,599696,26728,4.3
MT4734100000000,47,34100,"Morristown, TN MSA",2024,8,54118,52105,2013,3.7
MT4734980000000,47,34980,"Nashville-Davidson--Murfreesboro--Franklin, TN MSA",2024,8,1164891,1130244,34647,3
MT4810180000000,48,10180,"Abilene, TX MSA",2024,8,87126,84036,3090,3.5
MT4811100000000,48,11100,"Amarillo, TX MSA",2024,8,138529,134096,4433,3.2
MT4812420000000,48,12420,"Austin-Round Rock-San Marcos, TX MSA",2024,8,1513219,1458777,54442,3.6
MT4813140000000,48,13140,"Beaumont-Port Arthur, TX MSA",2024,8,184452,174104,10348,5.6
MT4815180000000,48,15180,"Brownsville-Harlingen, TX MSA",2024,8,190992,180732,10260,5.4
MT4817780000000,48,17780,"College Station-Bryan, TX MSA",2024,8,152232,146885,5347,3.5
MT4818580000000,48,18580,"Corpus Christi, TX MSA",2024,8,210673,201257,9416,4.5
MT4819100000000,48,19100,"Dallas-Fort Worth-Arlington, TX MSA",2024,8,4510474,4330619,179855,4
MT4820580000000,48,20580,"Eagle Pass, TX MSA",2024,8,24336,22366,1970,8.1
MT4821340000000,48,21340,"El Paso, TX MSA",2024,8,417751,400117,17634,4.2
MT4826420000000,48,26420,"Houston-Pasadena-The Woodlands, TX MSA",2024,8,3854419,3680600,173819,4.5
MT4828660000000,48,28660,"Killeen-Temple, TX MSA",2024,8,202836,193488,9348,4.6
MT4829700000000,48,29700,"Laredo, TX MSA",2024,8,119462,114448,5014,4.2
MT4830980000000,48,30980,"Longview, TX MSA",2024,8,129171,122950,6221,4.8
MT4831180000000,48,31180,"Lubbock, TX MSA",2024,8,185010,178357,6653,3.6
MT4832580000000,48,32580,"McAllen-Edinburg-Mission, TX MSA",2024,8,398505,374155,24350,6.1
MT4833260000000,48,33260,"Midland, TX MSA",2024,8,104097,100991,3106,3
MT4836220000000,48,36220,"Odessa, TX MSA",2024,8,86926,83810,3116,3.6
MT4841660000000,48,41660,"San Angelo, TX MSA",2024,8,62484,60428,2056,3.3
MT4841700000000,48,41700,"San Antonio-New Braunfels, TX MSA",2024,8,1345117,1292970,52147,3.9
MT4843300000000,48,43300,"Sherman-Denison, TX MSA",2024,8,71726,68844,2882,4
MT4845500000000,48,45500,"Texarkana, TX-AR MSA",2024,8,62241,59619,2622,4.2
MT4846340000000,48,46340,"Tyler, TX MSA",2024,8,118718,114090,4628,3.9
MT4847020000000,48,47020,"Victoria, TX MSA",2024,8,45159,43278,1881,4.2
MT4847380000000,48,47380,"Waco, TX MSA",2024,8,147223,141467,5756,3.9
MT4848660000000,48,48660,"Wichita Falls, TX MSA",2024,8,67019,64403,2616,3.9
MT4930860000000,49,30860,"Logan, UT-ID MSA",2024,8,80533,78117,2416,3
MT4936260000000,49,36260,"Ogden, UT MSA",2024,8,353157,342082,11075,3.1
MT4939340000000,49,39340,"Provo-Orem-Lehi, UT MSA",2024,8,371522,358794,12728,3.4
MT4941100000000,49,41100,"St. George, UT MSA",2024,8,94688,91362,3326,3.5
MT4941620000000,49,41620,"Salt Lake City-Murray, UT MSA",2024,8,740082,715600,24482,3.3
MT5015540000000,50,15540,"Burlington-South Burlington, VT MSA",2024,8,131858,129058,2800,2.1
MT5113980000000,51,13980,"Blacksburg-Christiansburg-Radford, VA MSA",2024,8,92868,89836,3032,3.3
MT5116820000000,51,16820,"Charlottesville, VA MSA",2024,8,121177,118056,3121,2.6
MT5125500000000,51,25500,"Harrisonburg, VA MSA",2024,8,72285,70217,2068,2.9
MT5131340000000,51,31340,"Lynchburg, VA MSA",2024,8,126990,122782,4208,3.3
MT5140060000000,51,40060,"Richmond, VA MSA",2024,8,730586,708398,22188,3
MT5140220000000,51,40220,"Roanoke, VA MSA",2024,8,158849,154072,4777,3
MT5144420000000,51,44420,"Staunton-Stuarts Draft, VA MSA",2024,8,65364,63603,1761,2.7
MT5147260000000,51,47260,"Virginia Beach-Chesapeake-Norfolk, VA-NC MSA",2024,8,883655,856114,27541,3.1
MT5149020000000,51,49020,"Winchester, VA-WV MSA",2024,8,77514,75312,2202,2.8
MT5313380000000,53,13380,"Bellingham, WA MSA",2024,8,114024,108721,5303,4.7
MT5314740000000,53,14740,"Bremerton-Silverdale-Port Orchard, WA MSA",2024,8,122086,116523,5563,4.6
MT5328420000000,53,28420,"Kennewick-Richland, WA MSA",2024,8,148021,140464,7557,5.1
MT5331020000000,53,31020,"Longview-Kelso, WA MSA",2024,8,47269,44748,2521,5.3
MT5334580000000,53,34580,"Mount Vernon-Anacortes, WA MSA",2024,8,59746,56677,3069,5.1
MT5336500000000,53,36500,"Olympia-Lacey-Tumwater, WA MSA",2024,8,143797,137174,6623,4.6
MT5342660000000,53,42660,"Seattle-Tacoma-Bellevue, WA MSA",2024,8,2333741,2238213,95528,4.1
MT5344060000000,53,44060,"Spokane-Spokane Valley, WA MSA",2024,8,281335,267856,13479,4.8
MT5347460000000,53,47460,"Walla Walla, WA MSA",2024,8,29114,27853,1261,4.3
MT5348300000000,53,48300,"Wenatchee-East Wenatchee, WA MSA",2024,8,61885,58806,3079,5
MT5349420000000,53,49420,"Yakima, WA MSA",2024,8,124588,116569,8019,6.4
MT5413220000000,54,13220,"Beckley, WV MSA",2024,8,46225,44293,1932,4.2
MT5416620000000,54,16620,"Charleston, WV MSA",2024,8,90664,86927,3737,4.1
MT5426580000000,54,26580,"Huntington-Ashland, WV-KY-OH MSA",2024,8,157514,149578,7936,5
MT5434060000000,54,34060,"Morgantown, WV MSA",2024,8,70898,68479,2419,3.4
MT5437620000000,54,37620,"Parkersburg-Vienna, WV MSA",2024,8,39329,37641,1688,4.3
MT5448540000000,54,48540,"Wheeling, WV-OH MSA",2024,8,59679,56688,2991,5
MT5511540000000,55,11540,"Appleton, WI MSA",2024,8,137776,134273,3503,2.5
MT5520740000000,55,20740,"Eau Claire, WI MSA",2024,8,96564,93740,2824,2.9
MT5522540000000,55,22540,"Fond du Lac, WI MSA",2024,8,55392,53764,1628,2.9
MT5524580000000,55,24580,"Green Bay, WI MSA",2024,8,180340,175528,4812,2.7
MT5527500000000,55,27500,"Janesville-Beloit, WI MSA",2024,8,87369,84539,2830,3.2
MT5528450000000,55,28450,"Kenosha, WI MSA",2024,8,95962,92921,3041,3.2
MT5529100000000,55,29100,"La Crosse-Onalaska, WI-MN MSA",2024,8,91176,88667,2509,2.8
MT5531540000000,55,31540,"Madison, WI MSA",2024,8,412148,402075,10073,2.4
MT5533340000000,55,33340,"Milwaukee-Waukesha, WI MSA",2024,8,822378,796024,26354,3.2
MT5536780000000,55,36780,"Oshkosh-Neenah, WI MSA",2024,8,93208,90715,2493,2.7
MT5539540000000,55,39540,"Racine-Mount Pleasant, WI MSA",2024,8,101566,97969,3597,3.5
MT5543100000000,55,43100,"Sheboygan, WI MSA",2024,8,62929,61309,1620,2.6
MT5548140000000,55,48140,"Wausau, WI MSA",2024,8,75282,73331,1951,2.6
MT5616220000000,56,16220,"Casper, WY MSA",2024,8,42340,40894,1446,3.4
MT5616940000000,56,16940,"Cheyenne, WY MSA",2024,8,49178,47444,1734,3.5
MT7210380000000,72,10380,"Aguadilla, PR MSA",2024,8,90813,84466,6347,7
MT7211640000000,72,11640,"Arecibo, PR MSA",2024,8,67810,64083,3727,5.5
MT7225020000000,72,25020,"Guayama, PR MSA",2024,8,19119,17275,1844,9.6
MT7232420000000,72,32420,"Mayaguez, PR MSA",2024,8,66969,62021,4948,7.4
MT7238660000000,72,38660,"Ponce, PR MSA",2024,8,89464,81744,7720,8.6
MT7241980000000,72,41980,"San Juan-Bayamon-Caguas, PR MSA",2024,8,818136,779677,38459,4.7
MT0111500000000,1,11500,"Anniston-Oxford, AL MSA",2024,9,49930,48193,1737,3.5
MT0112220000000,1,12220,"Auburn-Opelika, AL MSA",2024,9,96718,93678,3040,3.1
MT0113820000000,1,13820,"Birmingham, AL MSA",2024,9,573170,555653,17517,3.1
MT0119300000000,1,19300,"Daphne-Fairhope-Foley, AL MSA",2024,9,117498,114058,3440,2.9
MT0119460000000,1,19460,"Decatur, AL MSA",2024,9,76623,74435,2188,2.9
MT0120020000000,1,20020,"Dothan, AL MSA",2024,9,68008,65743,2265,3.3
MT0122520000000,1,22520,"Florence-Muscle Shoals, AL MSA",2024,9,69593,67162,2431,3.5
MT0123460000000,1,23460,"Gadsden, AL MSA",2024,9,42275,40771,1504,3.6
MT0126620000000,1,26620,"Huntsville, AL MSA",2024,9,278730,271059,7671,2.8
MT0133660000000,1,33660,"Mobile, AL MSA",2024,9,187628,180434,7194,3.8
MT0133860000000,1,33860,"Montgomery, AL MSA",2024,9,179544,173703,5841,3.3
MT0146220000000,1,46220,"Tuscaloosa, AL MSA",2024,9,127078,122534,4544,3.6
MT0211260000000,2,11260,"Anchorage, AK MSA",2024,9,202048,193297,8751,4.3
MT0221820000000,2,21820,"Fairbanks-College, AK MSA",2024,9,45959,44012,1947,4.2
MT0422380000000,4,22380,"Flagstaff, AZ MSA",2024,9,75941,72794,3147,4.1
MT0429420000000,4,29420,"Lake Havasu City-Kingman, AZ MSA",2024,9,88039,83933,4106,4.7
MT0438060000000,4,38060,"Phoenix-Mesa-Chandler, AZ MSA",2024,9,2719467,2626936,92531,3.4
MT0439150000000,4,39150,"Prescott Valley-Prescott, AZ MSA",2024,9,107031,103168,3863,3.6
MT0443420000000,4,43420,"Sierra Vista-Douglas, AZ MSA",2024,9,47802,45687,2115,4.4
MT0446060000000,4,46060,"Tucson, AZ MSA",2024,9,494620,475892,18728,3.8
MT0449740000000,4,49740,"Yuma, AZ MSA",2024,9,98872,86497,12375,12.5
MT0522220000000,5,22220,"Fayetteville-Springdale-Rogers, AR MSA",2024,9,308828,300423,8405,2.7
MT0522900000000,5,22900,"Fort Smith, AR-OK MSA",2024,9,101883,98327,3556,3.5
MT0526300000000,5,26300,"Hot Springs, AR MSA",2024,9,43570,41969,1601,3.7
MT0527860000000,5,27860,"Jonesboro, AR MSA",2024,9,66552,64385,2167,3.3
MT0530780000000,5,30780,"Little Rock-North Little Rock-Conway, AR MSA",2024,9,382545,370019,12526,3.3
MT0612540000000,6,12540,"Bakersfield-Delano, CA MSA",2024,9,410727,374951,35776,8.7
MT0617020000000,6,17020,"Chico, CA MSA",2024,9,91691,86090,5601,6.1
MT0620940000000,6,20940,"El Centro, CA MSA",2024,9,73374,59732,13642,18.6
MT0623420000000,6,23420,"Fresno, CA MSA",2024,9,541467,498326,43141,8
MT0625260000000,6,25260,"Hanford-Corcoran, CA MSA",2024,9,58723,53417,5306,9
MT0631080000000,6,31080,"Los Angeles-Long Beach-Anaheim, CA MSA",2024,9,6758492,6375688,382804,5.7
MT0632900000000,6,32900,"Merced, CA MSA",2024,9,121201,109221,11980,9.9
MT0633700000000,6,33700,"Modesto, CA MSA",2024,9,255655,237675,17980,7
MT0634900000000,6,34900,"Napa, CA MSA",2024,9,74991,71955,3036,4
MT0637100000000,6,37100,"Oxnard-Thousand Oaks-Ventura, CA MSA",2024,9,421930,401988,19942,4.7
MT0639820000000,6,39820,"Redding, CA MSA",2024,9,79762,75388,4374,5.5
MT0640140000000,6,40140,"Riverside-San Bernardino-Ontario, CA MSA",2024,9,2219813,2100437,119376,5.4
MT0640900000000,6,40900,"Sacramento-Roseville-Folsom, CA MSA",2024,9,1185462,1128017,57445,4.8
MT0641500000000,6,41500,"Salinas, CA MSA",2024,9,221966,205764,16202,7.3
MT0641740000000,6,41740,"San Diego-Chula Vista-Carlsbad, CA MSA",2024,9,1651521,1577613,73908,4.5
MT0641860000000,6,41860,"San Francisco-Oakland-Fremont, CA MSA",2024,9,2501454,2393264,108190,4.3
MT0641940000000,6,41940,"San Jose-Sunnyvale-Santa Clara, CA MSA",2024,9,1059019,1013113,45906,4.3
MT0642020000000,6,42020,"San Luis Obispo-Paso Robles, CA MSA",2024,9,132304,126678,5626,4.3
MT0642100000000,6,42100,"Santa Cruz-Watsonville, CA MSA",2024,9,136347,128040,8307,6.1
MT0642200000000,6,42200,"Santa Maria-Santa Barbara, CA MSA",2024,9,221634,211472,10162,4.6
MT0642220000000,6,42220,"Santa Rosa-Petaluma, CA MSA",2024,9,246244,235706,10538,4.3
MT0644700000000,6,44700,"Stockton-Lodi, CA MSA",2024,9,370560,346002,24558,6.6
MT0646700000000,6,46700,"Vallejo, CA MSA",2024,9,216451,205189,11262,5.2
MT0647300000000,6,47300,"Visalia, CA MSA",2024,9,221361,198368,22993,10.4
MT0649700000000,6,49700,"Yuba City, CA MSA",2024,9,81777,75264,6513,8
MT0814500000000,8,14500,"Boulder, CO MSA",2024,9,193882,185002,8880,4.6
MT0817820000000,8,17820,"Colorado Springs, CO MSA",2024,9,397986,379605,18381,4.6
MT0819740000000,8,19740,"Denver-Aurora-Centennial, CO MSA",2024,9,1785645,1704147,81498,4.6
MT0822660000000,8,22660,"Fort Collins-Loveland, CO MSA",2024,9,207845,198624,9221,4.4
MT0824300000000,8,24300,"Grand Junction, CO MSA",2024,9,80513,76659,3854,4.8
MT0824540000000,8,24540,"Greeley, CO MSA",2024,9,178744,170041,8703,4.9
MT0839380000000,8,39380,"Pueblo, CO MSA",2024,9,73894,69219,4675,6.3
MT0914860000000,9,14860,"Bridgeport-Stamford-Danbury, CT MSA",2024,9,518726,502777,15949,3.1
MT0925540000000,9,25540,"Hartford-West Hartford-East Hartford, CT MSA",2024,9,616441,596750,19691,3.2
MT0935300000000,9,35300,"New Haven, CT MSA",2024,9,317531,307461,10070,3.2
MT0935980000000,9,35980,"Norwich-New London-Willimantic, CT MSA",2024,9,143991,139542,4449,3.1
MT0947930000000,9,47930,"Waterbury-Shelton, CT MSA",2024,9,242125,233258,8867,3.7
MT1020100000000,10,20100,"Dover, DE MSA",2024,9,85491,82089,3402,4
MT1147900000000,11,47900,"Washington-Arlington-Alexandria, DC-VA-MD-WV MSA",2024,9,3569241,3458126,111115,3.1
MT1215980000000,12,15980,"Cape Coral-Fort Myers, FL MSA",2024,9,375675,361936,13739,3.7
MT1218880000000,12,18880,"Crestview-Fort Walton Beach-Destin, FL MSA",2024,9,143642,139016,4626,3.2
MT1219660000000,12,19660,"Deltona-Daytona Beach-Ormond Beach, FL MSA",2024,9,322601,309571,13030,4
MT1223540000000,12,23540,"Gainesville, FL MSA",2024,9,170250,163690,6560,3.9
MT1226140000000,12,26140,"Homosassa Springs, FL MSA",2024,9,54104,51291,2813,5.2
MT1227260000000,12,27260,"Jacksonville, FL MSA",2024,9,856805,826498,30307,3.5
MT1229460000000,12,29460,"Lakeland-Winter Haven, FL MSA",2024,9,359491,344056,15435,4.3
MT1233100000000,12,33100,"Miami-Fort Lauderdale-West Palm Beach, FL MSA",2024,9,3311908,3213848,98060,3
MT1234940000000,12,34940,"Naples-Marco Island, FL MSA",2024,9,186747,180416,6331,3.4
MT1235840000000,12,35840,"North Port-Bradenton-Sarasota, FL MSA",2024,9,399314,384510,14804,3.7
MT1236100000000,12,36100,"Ocala, FL MSA",2024,9,159418,152454,6964,4.4
MT1236740000000,12,36740,"Orlando-Kissimmee-Sanford, FL MSA",2024,9,1535878,1484128,51750,3.4
MT1237340000000,12,37340,"Palm Bay-Melbourne-Titusville, FL MSA",2024,9,305990,294857,11133,3.6
MT1237460000000,12,37460,"Panama City-Panama City Beach, FL MSA",2024,9,102140,98614,3526,3.5
MT1237860000000,12,37860,"Pensacola-Ferry Pass-Brent, FL MSA",2024,9,240286,231545,8741,3.6
MT1238940000000,12,38940,"Port St. Lucie, FL MSA",2024,9,242231,232843,9388,3.9
MT1239460000000,12,39460,"Punta Gorda, FL MSA",2024,9,77449,74094,3355,4.3
MT1242680000000,12,42680,"Sebastian-Vero Beach-West Vero Corridor, FL MSA",2024,9,68021,65215,2806,4.1
MT1242700000000,12,42700,"Sebring, FL MSA",2024,9,36839,35007,1832,5
MT1245220000000,12,45220,"Tallahassee, FL MSA",2024,9,209031,201596,7435,3.6
MT1245300000000,12,45300,"Tampa-St. Petersburg-Clearwater, FL MSA",2024,9,1701504,1640188,61316,3.6
MT1248680000000,12,48680,"Wildwood-The Villages, FL MSA",2024,9,34363,32405,1958,5.7
MT1310500000000,13,10500,"Albany, GA MSA",2024,9,62503,59833,2670,4.3
MT1312020000000,13,12020,"Athens-Clarke County, GA MSA",2024,9,108691,104913,3778,3.5
MT1312060000000,13,12060,"Atlanta-Sandy Springs-Roswell, GA MSA",2024,9,3309300,3191823,117477,3.5
MT1312260000000,13,12260,"Augusta-Richmond County, GA-SC MSA",2024,9,268837,256320,12517,4.7
MT1315260000000,13,15260,"Brunswick-St. Simons, GA MSA",2024,9,55987,54193,1794,3.2
MT1317980000000,13,17980,"Columbus, GA-AL MSA",2024,9,128946,123605,5341,4.1
MT1319140000000,13,19140,"Dalton, GA MSA",2024,9,68039,65284,2755,4
MT1323580000000,13,23580,"Gainesville, GA MSA",2024,9,109420,106203,3217,2.9
MT1325980000000,13,25980,"Hinesville, GA MSA",2024,9,31447,30191,1256,4
MT1331420000000,13,31420,"Macon-Bibb County, GA MSA",2024,9,97243,93003,4240,4.4
MT1340660000000,13,40660,"Rome, GA MSA",2024,9,47970,46225,1745,3.6
MT1342340000000,13,42340,"Savannah, GA MSA",2024,9,210052,203441,6611,3.1
MT1346660000000,13,46660,"Valdosta, GA MSA",2024,9,61867,59334,2533,4.1
MT1347580000000,13,47580,"Warner Robins, GA MSA",2024,9,90373,87443,2930,3.2
MT1527980000000,15,27980,"Kahului-Wailuku, HI MSA",2024,9,81399,78157,3242,4
MT1546520000000,15,46520,"Urban Honolulu, HI MSA",2024,9,472525,458866,13659,2.9
MT1614260000000,16,14260,"Boise City, ID MSA",2024,9,450708,434443,16265,3.6
MT1617660000000,16,17660,"Coeur d'Alene, ID MSA",2024,9,90702,86579,4123,4.5
MT1626820000000,16,26820,"Idaho Falls, ID MSA",2024,9,85024,82290,2734,3.2
MT1630300000000,16,30300,"Lewiston, ID-WA MSA",2024,9,31029,29861,1168,3.8
MT1638540000000,16,38540,"Pocatello, ID MSA",2024,9,41180,39484,1696,4.1
MT1646300000000,16,46300,"Twin Falls, ID MSA",2024,9,60707,58494,2213,3.6
MT1714010000000,17,14010,"Bloomington, IL MSA",2024,9,96112,92366,3746,3.9
MT1716580000000,17,16580,"Champaign-Urbana, IL MSA",2024,9,125378,120287,5091,4.1
MT1716980000000,17,16980,"Chicago-Naperville-Elgin, IL-IN MSA",2024,9,5044355,4780022,264333,5.2
MT1719340000000,17,19340,"Davenport-Moline-Rock Island, IA-IL MSA",2024,9,189719,180226,9493,5
MT1719500000000,17,19500,"Decatur, IL MSA",2024,9,44490,41936,2554,5.7
MT1728100000000,17,28100,"Kankakee, IL MSA",2024,9,51169,48320,2849,5.6
MT1737900000000,17,37900,"Peoria, IL MSA",2024,9,178237,169763,8474,4.8
MT1740420000000,17,40420,"Rockford, IL MSA",2024,9,160442,151752,8690,5.4
MT1744100000000,17,44100,"Springfield, IL MSA",2024,9,103553,99188,4365,4.2
MT1814020000000,18,14020,"Bloomington, IN MSA",2024,9,86178,82786,3392,3.9
MT1818020000000,18,18020,"Columbus, IN MSA",2024,9,39768,38073,1695,4.3
MT1821140000000,18,21140,"Elkhart-Goshen, IN MSA",2024,9,98551,93591,4960,5
MT1821780000000,18,21780,"Evansville, IN MSA",2024,9,136684,131150,5534,4
MT1823060000000,18,23060,"Fort Wayne, IN MSA",2024,9,233421,224067,9354,4
MT1826900000000,18,26900,"Indianapolis-Carmel-Greenwood, IN MSA",2024,9,1148919,1102874,46045,4
MT1829020000000,18,29020,"Kokomo, IN MSA",2024,9,36609,34311,2298,6.3
MT1829200000000,18,29200,"Lafayette-West Lafayette, IN MSA",2024,9,120528,115770,4758,3.9
MT1833140000000,18,33140,"Michigan City-La Porte, IN MSA",2024,9,51875,49278,2597,5
MT1834620000000,18,34620,"Muncie, IN MSA",2024,9,53272,50694,2578,4.8
MT1843780000000,18,43780,"South Bend-Mishawaka, IN-MI MSA",2024,9,156215,148242,7973,5.1
MT1845460000000,18,45460,"Terre Haute, IN MSA",2024,9,78208,74606,3602,4.6
MT1911180000000,19,11180,"Ames, IA MSA",2024,9,69640,67918,1722,2.5
MT1916300000000,19,16300,"Cedar Rapids, IA MSA",2024,9,145883,140960,4923,3.4
MT1919780000000,19,19780,"Des Moines-West Des Moines, IA MSA",2024,9,413606,400410,13196,3.2
MT1920220000000,19,20220,"Dubuque, IA MSA",2024,9,53502,51813,1689,3.2
MT1926980000000,19,26980,"Iowa City, IA MSA",2024,9,100234,97822,2412,2.4
MT1943580000000,19,43580,"Sioux City, IA-NE-SD MSA",2024,9,76574,74209,2365,3.1
MT1947940000000,19,47940,"Waterloo-Cedar Falls, IA MSA",2024,9,88588,85077,3511,4
MT2029940000000,20,29940,"Lawrence, KS MSA",2024,9,71744,69284,2460,3.4
MT2031740000000,20,31740,"Manhattan, KS MSA",2024,9,64866,62591,2275,3.5
MT2045820000000,20,45820,"Topeka, KS MSA",2024,9,119361,114777,4584,3.8
MT2048620000000,20,48620,"Wichita, KS MSA",2024,9,338629,324410,14219,4.2
MT2114540000000,21,14540,"Bowling Green, KY MSA",2024,9,93953,89326,4627,4.9
MT2121060000000,21,21060,"Elizabethtown, KY MSA",2024,9,55925,52831,3094,5.5
MT2130460000000,21,30460,"Lexington-Fayette, KY MSA",2024,9,279616,267208,12408,4.4
MT2131140000000,21,31140,"Louisville/Jefferson County, KY-IN MSA",2024,9,704384,670646,33738,4.8
MT2136980000000,21,36980,"Owensboro, KY MSA",2024,9,52901,50089,2812,5.3
MT2137140000000,21,37140,"Paducah, KY-IL MSA",2024,9,46333,43855,2478,5.3
MT2210780000000,22,10780,"Alexandria, LA MSA",2024,9,64512,61785,2727,4.2
MT2212940000000,22,12940,"Baton Rouge, LA MSA",2024,9,427747,409550,18197,4.3
MT2225220000000,22,25220,"Hammond, LA MSA",2024,9,61080,57968,3112,5.1
MT2226380000000,22,26380,"Houma-Bayou Cane-Thibodaux, LA MSA",2024,9,88238,84649,3589,4.1
MT2229180000000,22,29180,"Lafayette, LA MSA",2024,9,198149,190248,7901,4
MT2229340000000,22,29340,"Lake Charles, LA MSA",2024,9,98124,93386,4738,4.8
MT2233740000000,22,33740,"Monroe, LA MSA",2024,9,95980,91021,4959,5.2
MT2235380000000,22,35380,"New Orleans-Metairie, LA MSA",2024,9,468707,447505,21202,4.5
MT2243340000000,22,43340,"Shreveport-Bossier City, LA MSA",2024,9,168011,160344,7667,4.6
MT2243640000000,22,43640,"Slidell-Mandeville-Covington, LA MSA",2024,9,129722,124441,5281,4.1
MT2312620000000,23,12620,"Bangor, ME MSA",2024,9,76480,73669,2811,3.7
MT2330340000000,23,30340,"Lewiston-Auburn, ME MSA",2024,9,55891,53959,1932,3.5
MT2338860000000,23,38860,"Portland-South Portland, ME MSA",2024,9,317047,307831,9216,2.9
MT2412580000000,24,12580,"Baltimore-Columbia-Towson, MD MSA",2024,9,1499840,1451643,48197,3.2
MT2425180000000,24,25180,"Hagerstown-Martinsburg, MD-WV MSA",2024,9,144331,139434,4897,3.4
MT2430500000000,24,30500,"Lexington Park, MD MSA",2024,9,110034,106926,3108,2.8
MT2441540000000,24,41540,"Salisbury, MD MSA",2024,9,64537,62240,2297,3.6
MT2511200000000,25,11200,"Amherst Town-Northampton, MA MSA",2024,9,86071,82676,3395,3.9
MT2512700000000,25,12700,"Barnstable Town, MA MSA",2024,9,118843,113028,5815,4.9
MT2514460000000,25,14460,"Boston-Cambridge-Newton, MA-NH MSA",2024,9,2843858,2734379,109479,3.8
MT2538340000000,25,38340,"Pittsfield, MA MSA",2024,9,64332,61633,2699,4.2
MT2544140000000,25,44140,"Springfield, MA MSA",2024,9,226424,214566,11858,5.2
MT2549340000000,25,49340,"Worcester, MA MSA",2024,9,469614,449439,20175,4.3
MT2611460000000,26,11460,"Ann Arbor, MI MSA",2024,9,209958,201536,8422,4
MT2612980000000,26,12980,"Battle Creek, MI MSA",2024,9,64866,61229,3637,5.6
MT2613020000000,26,13020,"Bay City, MI MSA",2024,9,50842,47831,3011,5.9
MT2619820000000,26,19820,"Detroit-Warren-Dearborn, MI MSA",2024,9,2176515,2069306,107209,4.9
MT2622420000000,26,22420,"Flint, MI MSA",2024,9,191652,180029,11623,6.1
MT2624340000000,26,24340,"Grand Rapids-Wyoming-Kentwood, MI MSA",2024,9,635557,608058,27499,4.3
MT2627100000000,26,27100,"Jackson, MI MSA",2024,9,75585,71627,3958,5.2
MT2628020000000,26,28020,"Kalamazoo-Portage, MI MSA",2024,9,141935,135602,6333,4.5
MT2629620000000,26,29620,"Lansing-East Lansing, MI MSA",2024,9,258150,246307,11843,4.6
MT2633220000000,26,33220,"Midland, MI MSA",2024,9,43467,41371,2096,4.8
MT2633780000000,26,33780,"Monroe, MI MSA",2024,9,80215,75462,4753,5.9
MT2634740000000,26,34740,"Muskegon-Norton Shores, MI MSA",2024,9,86409,81604,4805,5.6
MT2635660000000,26,35660,"Niles, MI MSA",2024,9,77730,73472,4258,5.5
MT2640980000000,26,40980,"Saginaw, MI MSA",2024,9,85949,80539,5410,6.3
MT2645900000000,26,45900,"Traverse City, MI MSA",2024,9,83161,79284,3877,4.7
MT2720260000000,27,20260,"Duluth, MN-WI MSA",2024,9,139786,134779,5007,3.6
MT2731860000000,27,31860,"Mankato, MN MSA",2024,9,60456,58863,1593,2.6
MT2733460000000,27,33460,"Minneapolis-St. Paul-Bloomington, MN-WI MSA",2024,9,2070291,2009539,60752,2.9
MT2740340000000,27,40340,"Rochester, MN MSA",2024,9,128614,125310,3304,2.6
MT2741060000000,27,41060,"St. Cloud, MN MSA",2024,9,111513,107892,3621,3.2
MT2825060000000,28,25060,"Gulfport-Biloxi, MS MSA",2024,9,190031,183979,6052,3.2
MT2825620000000,28,25620,"Hattiesburg, MS MSA",2024,9,70647,68347,2300,3.3
MT2827140000000,28,27140,"Jackson, MS MSA",2024,9,286148,277221,8927,3.1
MT2916020000000,29,16020,"Cape Girardeau, MO-IL MSA",2024,9,49205,47487,1718,3.5
MT2917860000000,29,17860,"Columbia, MO MSA",2024,9,113182,109585,3597,3.2
MT2927620000000,29,27620,"Jefferson City, MO MSA",2024,9,76909,74499,2410,3.1
MT2927900000000,29,27900,"Joplin, MO-KS MSA",2024,9,98585,95070,3515,3.6
MT2928140000000,29,28140,"Kansas City, MO-KS MSA",2024,9,1204384,1160794,43590,3.6
MT2941140000000,29,41140,"St. Joseph, MO-KS MSA",2024,9,54938,52853,2085,3.8
MT2941180000000,29,41180,"St. Louis, MO-IL MSA",2024,9,1488622,1433498,55124,3.7
MT2944180000000,29,44180,"Springfield, MO MSA",2024,9,244803,236576,8227,3.4
MT3013740000000,30,13740,"Billings, MT MSA",2024,9,99396,96590,2806,2.8
MT3014580000000,30,14580,"Bozeman, MT MSA",2024,9,78385,76574,1811,2.3
MT3024500000000,30,24500,"Great Falls, MT MSA",2024,9,39680,38490,1190,3
MT3025740000000,30,25740,"Helena, MT MSA",2024,9,47835,46542,1293,2.7
MT3033540000000,30,33540,"Missoula, MT MSA",2024,9,74539,72375,2164,2.9
MT3124260000000,31,24260,"Grand Island, NE MSA",2024,9,42987,41757,1230,2.9
MT3130700000000,31,30700,"Lincoln, NE MSA",2024,9,194869,189650,5219,2.7
MT3136540000000,31,36540,"Omaha, NE-IA MSA",2024,9,529505,513153,16352,3.1
MT3216180000000,32,16180,"Carson City, NV MSA",2024,9,29495,28045,1450,4.9
MT3229820000000,32,29820,"Las Vegas-Henderson-North Las Vegas, NV MSA",2024,9,1223507,1150084,73423,6
MT3239900000000,32,39900,"Reno, NV MSA",2024,9,300768,285799,14969,5
MT3331700000000,33,31700,"Manchester-Nashua, NH MSA",2024,9,242346,235180,7166,3
MT3412100000000,34,12100,"Atlantic City-Hammonton, NJ MSA",2024,9,181506,169798,11708,6.5
MT3445940000000,34,45940,"Trenton-Princeton, NJ MSA",2024,9,199666,190696,8970,4.5
MT3447220000000,34,47220,"Vineland, NJ MSA",2024,9,66207,61437,4770,7.2
MT3510740000000,35,10740,"Albuquerque, NM MSA",2024,9,466155,447168,18987,4.1
MT3522140000000,35,22140,"Farmington, NM MSA",2024,9,50110,47668,2442,4.9
MT3529740000000,35,29740,"Las Cruces, NM MSA",2024,9,102378,97162,5216,5.1
MT3542140000000,35,42140,"Santa Fe, NM MSA",2024,9,74541,71589,2952,4
MT3610580000000,36,10580,"Albany-Schenectady-Troy, NY MSA",2024,9,456576,441401,15175,3.3
MT3613780000000,36,13780,"Binghamton, NY MSA",2024,9,106233,102025,4208,4
MT3615380000000,36,15380,"Buffalo-Cheektowaga, NY MSA",2024,9,555057,533349,21708,3.9
MT3621300000000,36,21300,"Elmira, NY MSA",2024,9,35086,33736,1350,3.8
MT3624020000000,36,24020,"Glens Falls, NY MSA",2024,9,59566,57455,2111,3.5
MT3627060000000,36,27060,"Ithaca, NY MSA",2024,9,48174,46573,1601,3.3
MT3628740000000,36,28740,"Kingston, NY MSA",2024,9,87072,84001,3071,3.5
MT3628880000000,36,28880,"Kiryas Joel-Poughkeepsie-Newburgh, NY MSA",2024,9,339297,327609,11688,3.4
MT3635620000000,36,35620,"New York-Newark-Jersey City, NY-NJ MSA",2024,9,10242939,9761010,481929,4.7
MT3640380000000,36,40380,"Rochester, NY MSA",2024,9,512413,494033,18380,3.6
MT3645060000000,36,45060,"Syracuse, NY MSA",2024,9,312088,300800,11288,3.6
MT3646540000000,36,46540,"Utica-Rome, NY MSA",2024,9,126658,121752,4906,3.9
MT3648060000000,36,48060,"Watertown-Fort Drum, NY MSA",2024,9,44771,42817,1954,4.4
MT3711700000000,37,11700,"Asheville, NC MSA",2024,9,211772,205597,6175,2.9
MT3715500000000,37,15500,"Burlington, NC MSA",2024,9,86020,82919,3101,3.6
MT3716740000000,37,16740,"Charlotte-Concord-Gastonia, NC-SC MSA",2024,9,1483482,1428385,55097,3.7
MT3720500000000,37,20500,"Durham-Chapel Hill, NC MSA",2024,9,323562,313223,10339,3.2
MT3722180000000,37,22180,"Fayetteville, NC MSA",2024,9,153605,146652,6953,4.5
MT3724140000000,37,24140,"Goldsboro, NC MSA",2024,9,51259,49360,1899,3.7
MT3724660000000,37,24660,"Greensboro-High Point, NC MSA",2024,9,370746,355770,14976,4
MT3724780000000,37,24780,"Greenville, NC MSA",2024,9,83403,80064,3339,4
MT3725860000000,37,25860,"Hickory-Lenoir-Morganton, NC MSA",2024,9,170529,164304,6225,3.7
MT3727340000000,37,27340,"Jacksonville, NC MSA",2024,9,73917,71160,2757,3.7
MT3738240000000,37,38240,"Pinehurst-Southern Pines, NC MSA",2024,9,44879,43344,1535,3.4
MT3739580000000,37,39580,"Raleigh-Cary, NC MSA",2024,9,847936,821637,26299,3.1
MT3740580000000,37,40580,"Rocky Mount, NC MSA",2024,9,63432,60360,3072,4.8
MT3748900000000,37,48900,"Wilmington, NC MSA",2024,9,223740,215830,7910,3.5
MT3749180000000,37,49180,"Winston-Salem, NC MSA",2024,9,324934,312957,11977,3.7
MT3813900000000,38,13900,"Bismarck, ND MSA",2024,9,73470,71707,1763,2.4
MT3822020000000,38,22020,"Fargo, ND-MN MSA",2024,9,154275,150595,3680,2.4
MT3824220000000,38,24220,"Grand Forks, ND-MN MSA",2024,9,57209,55756,1453,2.5
MT3833500000000,38,33500,"Minot, ND MSA",2024,9,40004,38959,1045,2.6
MT3910420000000,39,10420,"Akron, OH MSA",2024,9,359878,343406,16472,4.6
MT3915940000000,39,15940,"Canton-Massillon, OH MSA",2024,9,195751,186549,9202,4.7
MT3917140000000,39,17140,"Cincinnati, OH-KY-IN MSA",2024,9,1178841,1127831,51010,4.3
MT3917410000000,39,17410,"Cleveland, OH MSA",2024,9,1104621,1062303,42318,3.8
MT3918140000000,39,18140,"Columbus, OH MSA",2024,9,1164366,1116644,47722,4.1
MT3919430000000,39,19430,"Dayton-Kettering-Beavercreek, OH MSA",2024,9,396132,378248,17884,4.5
MT3930620000000,39,30620,"Lima, OH MSA",2024,9,47643,45481,2162,4.5
MT3931900000000,39,31900,"Mansfield, OH MSA",2024,9,53696,50969,2727,5.1
MT3941780000000,39,41780,"Sandusky, OH MSA",2024,9,57858,54701,3157,5.5
MT3944220000000,39,44220,"Springfield, OH MSA",2024,9,62242,59258,2984,4.8
MT3945780000000,39,45780,"Toledo, OH MSA",2024,9,294597,281111,13486,4.6
MT3948260000000,39,48260,"Weirton-Steubenville, WV-OH MSA",2024,9,50927,47917,3010,5.9
MT3949660000000,39,49660,"Youngstown-Warren, OH MSA",2024,9,193365,183334,10031,5.2
MT4021420000000,40,21420,"Enid, OK MSA",2024,9,28329,27430,899,3.2
MT4030020000000,40,30020,"Lawton, OK MSA",2024,9,52413,50535,1878,3.6
MT4036420000000,40,36420,"Oklahoma City, OK MSA",2024,9,775257,751333,23924,3.1
MT4046140000000,40,46140,"Tulsa, OK MSA",2024,9,526299,508959,17340,3.3
MT4110540000000,41,10540,"Albany, OR MSA",2024,9,62165,59231,2934,4.7
MT4113460000000,41,13460,"Bend, OR MSA",2024,9,133353,127593,5760,4.3
MT4118700000000,41,18700,"Corvallis, OR MSA",2024,9,49267,47446,1821,3.7
MT4121660000000,41,21660,"Eugene-Springfield, OR MSA",2024,9,188683,180555,8128,4.3
MT4124420000000,41,24420,"Grants Pass, OR MSA",2024,9,35062,32958,2104,6
MT4132780000000,41,32780,"Medford, OR MSA",2024,9,106063,100803,5260,5
MT4138900000000,41,38900,"Portland-Vancouver-Hillsboro, OR-WA MSA",2024,9,1386804,1329840,56964,4.1
MT4141420000000,41,41420,"Salem, OR MSA",2024,9,223852,214501,9351,4.2
MT4210900000000,42,10900,"Allentown-Bethlehem-Easton, PA-NJ MSA",2024,9,452240,434594,17646,3.9
MT4211020000000,42,11020,"Altoona, PA MSA",2024,9,57623,55534,2089,3.6
MT4216540000000,42,16540,"Chambersburg, PA MSA",2024,9,77595,75151,2444,3.1
MT4221500000000,42,21500,"Erie, PA MSA",2024,9,126069,121143,4926,3.9
MT4223900000000,42,23900,"Gettysburg, PA MSA",2024,9,51550,49925,1625,3.2
MT4225420000000,42,25420,"Harrisburg-Carlisle, PA MSA",2024,9,313635,303246,10389,3.3
MT4227780000000,42,27780,"Johnstown, PA MSA",2024,9,56271,53824,2447,4.3
MT4229540000000,42,29540,"Lancaster, PA MSA",2024,9,291350,282795,8555,2.9
MT4230140000000,42,30140,"Lebanon, PA MSA",2024,9,73742,71422,2320,3.1
MT4237980000000,42,37980,"Philadelphia-Camden-Wilmington, PA-NJ-DE-MD MSA",2024,9,3288968,3160882,128086,3.9
MT4238300000000,42,38300,"Pittsburgh, PA MSA",2024,9,1231966,1186331,45635,3.7
MT4239740000000,42,39740,"Reading, PA MSA",2024,9,219051,210930,8121,3.7
MT4242540000000,42,42540,"Scranton--Wilkes-Barre, PA MSA",2024,9,279056,267194,11862,4.3
MT4244300000000,42,44300,"State College, PA MSA",2024,9,75865,73667,2198,2.9
MT4248700000000,42,48700,"Williamsport, PA MSA",2024,9,52782,50643,2139,4.1
MT4249620000000,42,49620,"York-Hanover, PA MSA",2024,9,239414,231008,8406,3.5
MT4439300000000,44,39300,"Providence-Warwick, RI-MA MSA",2024,9,905515,863509,42006,4.6
MT4516700000000,45,16700,"Charleston-North Charleston, SC MSA",2024,9,448353,431227,17126,3.8
MT4517900000000,45,17900,"Columbia, SC MSA",2024,9,423878,405480,18398,4.3
MT4522500000000,45,22500,"Florence, SC MSA",2024,9,92675,88153,4522,4.9
MT4524860000000,45,24860,"Greenville-Anderson-Greer, SC MSA",2024,9,482101,462083,20018,4.2
MT4525940000000,45,25940,"Hilton Head Island-Bluffton-Port Royal, SC MSA",2024,9,99135,94975,4160,4.2
MT4534820000000,45,34820,"Myrtle Beach-Conway-North Myrtle Beach, SC MSA",2024,9,171775,163073,8702,5.1
MT4543900000000,45,43900,"Spartanburg, SC MSA",2024,9,178870,170544,8326,4.7
MT4544940000000,45,44940,"Sumter, SC MSA",2024,9,41827,39449,2378,5.7
MT4639660000000,46,39660,"Rapid City, SD MSA",2024,9,80539,79062,1477,1.8
MT4643620000000,46,43620,"Sioux Falls, SD-MN MSA",2024,9,175876,172813,3063,1.7
MT4716860000000,47,16860,"Chattanooga, TN-GA MSA",2024,9,292736,282830,9906,3.4
MT4717300000000,47,17300,"Clarksville, TN-KY MSA",2024,9,140397,134333,6064,4.3
MT4717420000000,47,17420,"Cleveland, TN MSA",2024,9,56100,53869,2231,4
MT4727180000000,47,27180,"Jackson, TN MSA",2024,9,78413,75158,3255,4.2
MT4727740000000,47,27740,"Johnson City, TN MSA",2024,9,97223,93487,3736,3.8
MT4728700000000,47,28700,"Kingsport-Bristol, TN-VA MSA",2024,9,133384,128302,5082,3.8
MT4728940000000,47,28940,"Knoxville, TN MSA",2024,9,455638,440314,15324,3.4
MT4732820000000,47,32820,"Memphis, TN-MS-AR MSA",2024,9,627043,599466,27577,4.4
MT4734100000000,47,34100,"Morristown, TN MSA",2024,9,54210,52168,2042,3.8
MT4734980000000,47,34980,"Nashville-Davidson--Murfreesboro--Franklin, TN MSA",2024,9,1165373,1129706,35667,3.1
MT4810180000000,48,10180,"Abilene, TX MSA",2024,9,87304,84222,3082,3.5
MT4811100000000,48,11100,"Amarillo, TX MSA",2024,9,138907,134479,4428,3.2
MT4812420000000,48,12420,"Austin-Round Rock-San Marcos, TX MSA",2024,9,1515866,1461434,54432,3.6
MT4813140000000,48,13140,"Beaumont-Port Arthur, TX MSA",2024,9,184881,174622,10259,5.5
MT4815180000000,48,15180,"Brownsville-Harlingen, TX MSA",2024,9,191380,181156,10224,5.3
MT4817780000000,48,17780,"College Station-Bryan, TX MSA",2024,9,152596,147234,5362,3.5
MT4818580000000,48,18580,"Corpus Christi, TX MSA",2024,9,211388,202020,9368,4.4
MT4819100000000,48,19100,"Dallas-Fort Worth-Arlington, TX MSA",2024,9,4517218,4337240,179978,4
MT4820580000000,48,20580,"Eagle Pass, TX MSA",2024,9,24388,22423,1965,8.1
MT4821340000000,48,21340,"El Paso, TX MSA",2024,9,418411,400745,17666,4.2
MT4826420000000,48,26420,"Houston-Pasadena-The Woodlands, TX MSA",2024,9,3861334,3687363,173971,4.5
MT4828660000000,48,28660,"Killeen-Temple, TX MSA",2024,9,202926,193545,9381,4.6
MT4829700000000,48,29700,"Laredo, TX MSA",2024,9,119719,114675,5044,4.2
MT4830980000000,48,30980,"Longview, TX MSA",2024,9,129302,122975,6327,4.9
MT4831180000000,48,31180,"Lubbock, TX MSA",2024,9,185348,178644,6704,3.6
MT4832580000000,48,32580,"McAllen-Edinburg-Mission, TX MSA",2024,9,399031,374724,24307,6.1
MT4833260000000,48,33260,"Midland, TX MSA",2024,9,104368,101237,3131,3
MT4836220000000,48,36220,"Odessa, TX MSA",2024,9,87014,83865,3149,3.6
MT4841660000000,48,41660,"San Angelo, TX MSA",2024,9,62669,60586,2083,3.3
MT4841700000000,48,41700,"San Antonio-New Braunfels, TX MSA",2024,9,1348548,1296224,52324,3.9
MT4843300000000,48,43300,"Sherman-Denison, TX MSA",2024,9,71845,68978,2867,4
MT4845500000000,48,45500,"Texarkana, TX-AR MSA",2024,9,62338,59704,2634,4.2
MT4846340000000,48,46340,"Tyler, TX MSA",2024,9,118929,114324,4605,3.9
MT4847020000000,48,47020,"Victoria, TX MSA",2024,9,45244,43355,1889,4.2
MT4847380000000,48,47380,"Waco, TX MSA",2024,9,147543,141768,5775,3.9
MT4848660000000,48,48660,"Wichita Falls, TX MSA",2024,9,67092,64479,2613,3.9
MT4930860000000,49,30860,"Logan, UT-ID MSA",2024,9,80633,78238,2395,3
MT4936260000000,49,36260,"Ogden, UT MSA",2024,9,353664,342650,11014,3.1
MT4939340000000,49,39340,"Provo-Orem-Lehi, UT MSA",2024,9,371781,359143,12638,3.4
MT4941100000000,49,41100,"St. George, UT MSA",2024,9,94990,91690,3300,3.5
MT4941620000000,49,41620,"Salt Lake City-Murray, UT MSA",2024,9,740213,715701,24512,3.3
MT5015540000000,50,15540,"Burlington-South Burlington, VT MSA",2024,9,131931,129066,2865,2.2
MT5113980000000,51,13980,"Blacksburg-Christiansburg-Radford, VA MSA",2024,9,92952,89890,3062,3.3
MT5116820000000,51,16820,"Charlottesville, VA MSA",2024,9,121170,118041,3129,2.6
MT5125500000000,51,25500,"Harrisonburg, VA MSA",2024,9,72176,70119,2057,2.8
MT5131340000000,51,31340,"Lynchburg, VA MSA",2024,9,126986,122767,4219,3.3
MT5140060000000,51,40060,"Richmond, VA MSA",2024,9,730620,708403,22217,3
MT5140220000000,51,40220,"Roanoke, VA MSA",2024,9,158974,154199,4775,3
MT5144420000000,51,44420,"Staunton-Stuarts Draft, VA MSA",2024,9,65298,63538,1760,2.7
MT5147260000000,51,47260,"Virginia Beach-Chesapeake-Norfolk, VA-NC MSA",2024,9,884066,856492,27574,3.1
MT5149020000000,51,49020,"Winchester, VA-WV MSA",2024,9,77555,75348,2207,2.8
MT5313380000000,53,13380,"Bellingham, WA MSA",2024,9,113514,108250,5264,4.6
MT5314740000000,53,14740,"Bremerton-Silverdale-Port Orchard, WA MSA",2024,9,121700,116150,5550,4.6
MT5328420000000,53,28420,"Kennewick-Richland, WA MSA",2024,9,148251,140770,7481,5
MT5331020000000,53,31020,"Longview-Kelso, WA MSA",2024,9,47042,44525,2517,5.4
MT5334580000000,53,34580,"Mount Vernon-Anacortes, WA MSA",2024,9,59668,56621,3047,5.1
MT5336500000000,53,36500,"Olympia-Lacey-Tumwater, WA MSA",2024,9,143518,136886,6632,4.6
MT5342660000000,53,42660,"Seattle-Tacoma-Bellevue, WA MSA",2024,9,2338691,2243652,95039,4.1
MT5344060000000,53,44060,"Spokane-Spokane Valley, WA MSA",2024,9,280043,266642,13401,4.8
MT5347460000000,53,47460,"Walla Walla, WA MSA",2024,9,29132,27901,1231,4.2
MT5348300000000,53,48300,"Wenatchee-East Wenatchee, WA MSA",2024,9,61789,58747,3042,4.9
MT5349420000000,53,49420,"Yakima, WA MSA",2024,9,124434,116461,7973,6.4
MT5413220000000,54,13220,"Beckley, WV MSA",2024,9,46095,44194,1901,4.1
MT5416620000000,54,16620,"Charleston, WV MSA",2024,9,90431,86720,3711,4.1
MT5426580000000,54,26580,"Huntington-Ashland, WV-KY-OH MSA",2024,9,157494,149503,7991,5.1
MT5434060000000,54,34060,"Morgantown, WV MSA",2024,9,70973,68562,2411,3.4
MT5437620000000,54,37620,"Parkersburg-Vienna, WV MSA",2024,9,39206,37532,1674,4.3
MT5448540000000,54,48540,"Wheeling, WV-OH MSA",2024,9,59560,56597,2963,5
MT5511540000000,55,11540,"Appleton, WI MSA",2024,9,138013,134460,3553,2.6
MT5520740000000,55,20740,"Eau Claire, WI MSA",2024,9,96767,93886,2881,3
MT5522540000000,55,22540,"Fond du Lac, WI MSA",2024,9,55298,53644,1654,3
MT5524580000000,55,24580,"Green Bay, WI MSA",2024,9,180944,176049,4895,2.7
MT5527500000000,55,27500,"Janesville-Beloit, WI MSA",2024,9,87598,84746,2852,3.3
MT5528450000000,55,28450,"Kenosha, WI MSA",2024,9,96115,93009,3106,3.2
MT5529100000000,55,29100,"La Crosse-Onalaska, WI-MN MSA",2024,9,91423,88892,2531,2.8
MT5531540000000,55,31540,"Madison, WI MSA",2024,9,412602,402421,10181,2.5
MT5533340000000,55,33340,"Milwaukee-Waukesha, WI MSA",2024,9,824303,797376,26927,3.3
MT5536780000000,55,36780,"Oshkosh-Neenah, WI MSA",2024,9,93329,90796,2533,2.7
MT5539540000000,55,39540,"Racine-Mount Pleasant, WI MSA",2024,9,101648,98007,3641,3.6
MT5543100000000,55,43100,"Sheboygan, WI MSA",2024,9,64163,62513,1650,2.6
MT5548140000000,55,48140,"Wausau, WI MSA",2024,9,75255,73287,1968,2.6
MT5616220000000,56,16220,"Casper, WY MSA",2024,9,42383,40892,1491,3.5
MT5616940000000,56,16940,"Cheyenne, WY MSA",2024,9,49244,47475,1769,3.6
MT7210380000000,72,10380,"Aguadilla, PR MSA",2024,9,90975,84605,6370,7
MT7211640000000,72,11640,"Arecibo, PR MSA",2024,9,67901,64264,3637,5.4
MT7225020000000,72,25020,"Guayama, PR MSA",2024,9,19186,17366,1820,9.5
MT7232420000000,72,32420,"Mayaguez, PR MSA",2024,9,67332,62357,4975,7.4
MT7238660000000,72,38660,"Ponce, PR MSA",2024,9,89820,82162,7658,8.5
MT7241980000000,72,41980,"San Juan-Bayamon-Caguas, PR MSA",2024,9,822037,783813,38224,4.6
MT0111500000000,1,11500,"Anniston-Oxford, AL MSA",2024,10,49988,48209,1779,3.6
MT0112220000000,1,12220,"Auburn-Opelika, AL MSA",2024,10,96829,93771,3058,3.2
MT0113820000000,1,13820,"Birmingham, AL MSA",2024,10,572914,554998,17916,3.1
MT0119300000000,1,19300,"Daphne-Fairhope-Foley, AL MSA",2024,10,118037,114553,3484,3
MT0119460000000,1,19460,"Decatur, AL MSA",2024,10,76873,74637,2236,2.9
MT0120020000000,1,20020,"Dothan, AL MSA",2024,10,68043,65721,2322,3.4
MT0122520000000,1,22520,"Florence-Muscle Shoals, AL MSA",2024,10,69747,67272,2475,3.5
MT0123460000000,1,23460,"Gadsden, AL MSA",2024,10,42335,40789,1546,3.7
MT0126620000000,1,26620,"Huntsville, AL MSA",2024,10,279218,271373,7845,2.8
MT0133660000000,1,33660,"Mobile, AL MSA",2024,10,188127,180725,7402,3.9
MT0133860000000,1,33860,"Montgomery, AL MSA",2024,10,179736,173770,5966,3.3
MT0146220000000,1,46220,"Tuscaloosa, AL MSA",2024,10,127162,122551,4611,3.6
MT0211260000000,2,11260,"Anchorage, AK MSA",2024,10,202122,193423,8699,4.3
MT0221820000000,2,21820,"Fairbanks-College, AK MSA",2024,10,46000,44065,1935,4.2
MT0422380000000,4,22380,"Flagstaff, AZ MSA",2024,10,75991,72813,3178,4.2
MT0429420000000,4,29420,"Lake Havasu City-Kingman, AZ MSA",2024,10,88145,84036,4109,4.7
MT0438060000000,4,38060,"Phoenix-Mesa-Chandler, AZ MSA",2024,10,2721289,2628527,92762,3.4
MT0439150000000,4,39150,"Prescott Valley-Prescott, AZ MSA",2024,10,107199,103343,3856,3.6
MT0443420000000,4,43420,"Sierra Vista-Douglas, AZ MSA",2024,10,47736,45606,2130,4.5
MT0446060000000,4,46060,"Tucson, AZ MSA",2024,10,494997,476191,18806,3.8
MT0449740000000,4,49740,"Yuma, AZ MSA",2024,10,98914,86411,12503,12.6
MT0522220000000,5,22220,"Fayetteville-Springdale-Rogers, AR MSA",2024,10,309554,301055,8499,2.7
MT0522900000000,5,22900,"Fort Smith, AR-OK MSA",2024,10,102055,98499,3556,3.5
MT0526300000000,5,26300,"Hot Springs, AR MSA",2024,10,43595,41978,1617,3.7
MT0527860000000,5,27860,"Jonesboro, AR MSA",2024,10,66639,64443,2196,3.3
MT0530780000000,5,30780,"Little Rock-North Little Rock-Conway, AR MSA",2024,10,382993,370369,12624,3.3
MT0612540000000,6,12540,"Bakersfield-Delano, CA MSA",2024,10,411556,375842,35714,8.7
MT0617020000000,6,17020,"Chico, CA MSA",2024,10,91778,86176,5602,6.1
MT0620940000000,6,20940,"El Centro, CA MSA",2024,10,73414,59716,13698,18.7
MT0623420000000,6,23420,"Fresno, CA MSA",2024,10,541851,498796,43055,7.9
MT0625260000000,6,25260,"Hanford-Corcoran, CA MSA",2024,10,58789,53500,5289,9
MT0631080000000,6,31080,"Los Angeles-Long Beach-Anaheim, CA MSA",2024,10,6755383,6373007,382376,5.7
MT0632900000000,6,32900,"Merced, CA MSA",2024,10,121432,109472,11960,9.8
MT0633700000000,6,33700,"Modesto, CA MSA",2024,10,256372,238385,17987,7
MT0634900000000,6,34900,"Napa, CA MSA",2024,10,75229,72193,3036,4
MT0637100000000,6,37100,"Oxnard-Thousand Oaks-Ventura, CA MSA",2024,10,421274,401299,19975,4.7
MT0639820000000,6,39820,"Redding, CA MSA",2024,10,79919,75561,4358,5.5
MT0640140000000,6,40140,"Riverside-San Bernardino-Ontario, CA MSA",2024,10,2221176,2101803,119373,5.4
MT0640900000000,6,40900,"Sacramento-Roseville-Folsom, CA MSA",2024,10,1185849,1128373,57476,4.8
MT0641500000000,6,41500,"Salinas, CA MSA",2024,10,222808,206640,16168,7.3
MT0641740000000,6,41740,"San Diego-Chula Vista-Carlsbad, CA MSA",2024,10,1652040,1577860,74180,4.5
MT0641860000000,6,41860,"San Francisco-Oakland-Fremont, CA MSA",2024,10,2500523,2391926,108597,4.3
MT0641940000000,6,41940,"San Jose-Sunnyvale-Santa Clara, CA MSA",2024,10,1058791,1012904,45887,4.3
MT0642020000000,6,42020,"San Luis Obispo-Paso Robles, CA MSA",2024,10,132242,126613,5629,4.3
MT0642100000000,6,42100,"Santa Cruz-Watsonville, CA MSA",2024,10,136452,128154,8298,6.1
MT0642200000000,6,42200,"Santa Maria-Santa Barbara, CA MSA",2024,10,221778,211646,10132,4.6
MT0642220000000,6,42220,"Santa Rosa-Petaluma, CA MSA",2024,10,246250,235686,10564,4.3
MT0644700000000,6,44700,"Stockton-Lodi, CA MSA",2024,10,371330,346792,24538,6.6
MT0646700000000,6,46700,"Vallejo, CA MSA",2024,10,216356,205071,11285,5.2
MT0647300000000,6,47300,"Visalia, CA MSA",2024,10,221821,198816,23005,10.4
MT0649700000000,6,49700,"Yuba City, CA MSA",2024,10,81942,75464,6478,7.9
MT0814500000000,8,14500,"Boulder, CO MSA",2024,10,193843,184927,8916,4.6
MT0817820000000,8,17820,"Colorado Springs, CO MSA",2024,10,398321,379720,18601,4.7
MT0819740000000,8,19740,"Denver-Aurora-Centennial, CO MSA",2024,10,1786893,1704450,82443,4.6
MT0822660000000,8,22660,"Fort Collins-Loveland, CO MSA",2024,10,207893,198589,9304,4.5
MT0824300000000,8,24300,"Grand Junction, CO MSA",2024,10,80636,76750,3886,4.8
MT0824540000000,8,24540,"Greeley, CO MSA",2024,10,178546,169761,8785,4.9
MT0839380000000,8,39380,"Pueblo, CO MSA",2024,10,73909,69196,4713,6.4
MT0914860000000,9,14860,"Bridgeport-Stamford-Danbury, CT MSA",2024,10,519359,503383,15976,3.1
MT0925540000000,9,25540,"Hartford-West Hartford-East Hartford, CT MSA",2024,10,616884,597097,19787,3.2
MT0935300000000,9,35300,"New Haven, CT MSA",2024,10,317941,307829,10112,3.2
MT0935980000000,9,35980,"Norwich-New London-Willimantic, CT MSA",2024,10,144222,139735,4487,3.1
MT0947930000000,9,47930,"Waterbury-Shelton, CT MSA",2024,10,242499,233585,8914,3.7
MT1020100000000,10,20100,"Dover, DE MSA",2024,10,85335,81967,3368,3.9
MT1147900000000,11,47900,"Washington-Arlington-Alexandria, DC-VA-MD-WV MSA",2024,10,3570703,3459622,111081,3.1
MT1215980000000,12,15980,"Cape Coral-Fort Myers, FL MSA",2024,10,375174,361421,13753,3.7
MT1218880000000,12,18880,"Crestview-Fort Walton Beach-Destin, FL MSA",2024,10,143908,139290,4618,3.2
MT1219660000000,12,19660,"Deltona-Daytona Beach-Ormond Beach, FL MSA",2024,10,322792,309802,12990,4
MT1223540000000,12,23540,"Gainesville, FL MSA",2024,10,170421,163835,6586,3.9
MT1226140000000,12,26140,"Homosassa Springs, FL MSA",2024,10,54085,51271,2814,5.2
MT1227260000000,12,27260,"Jacksonville, FL MSA",2024,10,857488,827161,30327,3.5
MT1229460000000,12,29460,"Lakeland-Winter Haven, FL MSA",2024,10,359567,344191,15376,4.3
MT1233100000000,12,33100,"Miami-Fort Lauderdale-West Palm Beach, FL MSA",2024,10,3309872,3212017,97855,3
MT1234940000000,12,34940,"Naples-Marco Island, FL MSA",2024,10,186028,179663,6365,3.4
MT1235840000000,12,35840,"North Port-Bradenton-Sarasota, FL MSA",2024,10,398885,384014,14871,3.7
MT1236100000000,12,36100,"Ocala, FL MSA",2024,10,159510,152596,6914,4.3
MT1236740000000,12,36740,"Orlando-Kissimmee-Sanford, FL MSA",2024,10,1537296,1485608,51688,3.4
MT1237340000000,12,37340,"Palm Bay-Melbourne-Titusville, FL MSA",2024,10,306307,295219,11088,3.6
MT1237460000000,12,37460,"Panama City-Panama City Beach, FL MSA",2024,10,102210,98695,3515,3.4
MT1237860000000,12,37860,"Pensacola-Ferry Pass-Brent, FL MSA",2024,10,240351,231592,8759,3.6
MT1238940000000,12,38940,"Port St. Lucie, FL MSA",2024,10,242244,232861,9383,3.9
MT1239460000000,12,39460,"Punta Gorda, FL MSA",2024,10,77360,73969,3391,4.4
MT1242680000000,12,42680,"Sebastian-Vero Beach-West Vero Corridor, FL MSA",2024,10,67850,65022,2828,4.2
MT1242700000000,12,42700,"Sebring, FL MSA",2024,10,36838,35004,1834,5
MT1245220000000,12,45220,"Tallahassee, FL MSA",2024,10,209345,201870,7475,3.6
MT1245300000000,12,45300,"Tampa-St. Petersburg-Clearwater, FL MSA",2024,10,1701847,1640271,61576,3.6
MT1248680000000,12,48680,"Wildwood-The Villages, FL MSA",2024,10,34393,32427,1966,5.7
MT1310500000000,13,10500,"Albany, GA MSA",2024,10,62408,59753,2655,4.3
MT1312020000000,13,12020,"Athens-Clarke County, GA MSA",2024,10,108820,105106,3714,3.4
MT1312060000000,13,12060,"Atlanta-Sandy Springs-Roswell, GA MSA",2024,10,3306978,3189570,117408,3.6
MT1312260000000,13,12260,"Augusta-Richmond County, GA-SC MSA",2024,10,268386,255896,12490,4.7
MT1315260000000,13,15260,"Brunswick-St. Simons, GA MSA",2024,10,55998,54220,1778,3.2
MT1317980000000,13,17980,"Columbus, GA-AL MSA",2024,10,128880,123524,5356,4.2
MT1319140000000,13,19140,"Dalton, GA MSA",2024,10,68167,65423,2744,4
MT1323580000000,13,23580,"Gainesville, GA MSA",2024,10,109346,106183,3163,2.9
MT1325980000000,13,25980,"Hinesville, GA MSA",2024,10,31429,30187,1242,4
MT1331420000000,13,31420,"Macon-Bibb County, GA MSA",2024,10,97214,92992,4222,4.3
MT1340660000000,13,40660,"Rome, GA MSA",2024,10,48059,46326,1733,3.6
MT1342340000000,13,42340,"Savannah, GA MSA",2024,10,209891,203354,6537,3.1
MT1346660000000,13,46660,"Valdosta, GA MSA",2024,10,61866,59349,2517,4.1
MT1347580000000,13,47580,"Warner Robins, GA MSA",2024,10,90385,87498,2887,3.2
MT1527980000000,15,27980,"Kahului-Wailuku, HI MSA",2024,10,81384,78189,3195,3.9
MT1546520000000,15,46520,"Urban Honolulu, HI MSA",2024,10,472661,458878,13783,2.9
MT1614260000000,16,14260,"Boise City, ID MSA",2024,10,451506,435274,16232,3.6
MT1617660000000,16,17660,"Coeur d'Alene, ID MSA",2024,10,90912,86795,4117,4.5
MT1626820000000,16,26820,"Idaho Falls, ID MSA",2024,10,85065,82339,2726,3.2
MT1630300000000,16,30300,"Lewiston, ID-WA MSA",2024,10,31021,29867,1154,3.7
MT1638540000000,16,38540,"Pocatello, ID MSA",2024,10,41208,39508,1700,4.1
MT1646300000000,16,46300,"Twin Falls, ID MSA",2024,10,60663,58449,2214,3.6
MT1714010000000,17,14010,"Bloomington, IL MSA",2024,10,95993,92331,3662,3.8
MT1716580000000,17,16580,"Champaign-Urbana, IL MSA",2024,10,125555,120615,4940,3.9
MT1716980000000,17,16980,"Chicago-Naperville-Elgin, IL-IN MSA",2024,10,5049200,4788304,260896,5.2
MT1719340000000,17,19340,"Davenport-Moline-Rock Island, IA-IL MSA",2024,10,189846,180376,9470,5
MT1719500000000,17,19500,"Decatur, IL MSA",2024,10,44435,41924,2511,5.7
MT1728100000000,17,28100,"Kankakee, IL MSA",2024,10,51167,48399,2768,5.4
MT1737900000000,17,37900,"Peoria, IL MSA",2024,10,178182,169851,8331,4.7
MT1740420000000,17,40420,"Rockford, IL MSA",2024,10,160547,152016,8531,5.3
MT1744100000000,17,44100,"Springfield, IL MSA",2024,10,103726,99449,4277,4.1
MT1814020000000,18,14020,"Bloomington, IN MSA",2024,10,86064,82664,3400,4
MT1818020000000,18,18020,"Columbus, IN MSA",2024,10,39860,38162,1698,4.3
MT1821140000000,18,21140,"Elkhart-Goshen, IN MSA",2024,10,98616,93710,4906,5
MT1821780000000,18,21780,"Evansville, IN MSA",2024,10,136762,131206,5556,4.1
MT1823060000000,18,23060,"Fort Wayne, IN MSA",2024,10,233702,224235,9467,4.1
MT1826900000000,18,26900,"Indianapolis-Carmel-Greenwood, IN MSA",2024,10,1150637,1104333,46304,4
MT1829020000000,18,29020,"Kokomo, IN MSA",2024,10,36650,34328,2322,6.3
MT1829200000000,18,29200,"Lafayette-West Lafayette, IN MSA",2024,10,120466,115686,4780,4
MT1833140000000,18,33140,"Michigan City-La Porte, IN MSA",2024,10,51915,49304,2611,5
MT1834620000000,18,34620,"Muncie, IN MSA",2024,10,53360,50779,2581,4.8
MT1843780000000,18,43780,"South Bend-Mishawaka, IN-MI MSA",2024,10,156574,148608,7966,5.1
MT1845460000000,18,45460,"Terre Haute, IN MSA",2024,10,78237,74606,3631,4.6
MT1911180000000,19,11180,"Ames, IA MSA",2024,10,69738,67991,1747,2.5
MT1916300000000,19,16300,"Cedar Rapids, IA MSA",2024,10,145979,141056,4923,3.4
MT1919780000000,19,19780,"Des Moines-West Des Moines, IA MSA",2024,10,413920,400656,13264,3.2
MT1920220000000,19,20220,"Dubuque, IA MSA",2024,10,53541,51831,1710,3.2
MT1926980000000,19,26980,"Iowa City, IA MSA",2024,10,100520,98074,2446,2.4
MT1943580000000,19,43580,"Sioux City, IA-NE-SD MSA",2024,10,76539,74159,2380,3.1
MT1947940000000,19,47940,"Waterloo-Cedar Falls, IA MSA",2024,10,88625,85073,3552,4
MT2029940000000,20,29940,"Lawrence, KS MSA",2024,10,71866,69401,2465,3.4
MT2031740000000,20,31740,"Manhattan, KS MSA",2024,10,64938,62648,2290,3.5
MT2045820000000,20,45820,"Topeka, KS MSA",2024,10,119434,114831,4603,3.9
MT2048620000000,20,48620,"Wichita, KS MSA",2024,10,338733,324398,14335,4.2
MT2114540000000,21,14540,"Bowling Green, KY MSA",2024,10,94002,89338,4664,5
MT2121060000000,21,21060,"Elizabethtown, KY MSA",2024,10,55977,52851,3126,5.6
MT2130460000000,21,30460,"Lexington-Fayette, KY MSA",2024,10,279748,267241,12507,4.5
MT2131140000000,21,31140,"Louisville/Jefferson County, KY-IN MSA",2024,10,704435,670613,33822,4.8
MT2136980000000,21,36980,"Owensboro, KY MSA",2024,10,52962,50122,2840,5.4
MT2137140000000,21,37140,"Paducah, KY-IL MSA",2024,10,46344,43853,2491,5.4
MT2210780000000,22,10780,"Alexandria, LA MSA",2024,10,64570,61775,2795,4.3
MT2212940000000,22,12940,"Baton Rouge, LA MSA",2024,10,428073,409562,18511,4.3
MT2225220000000,22,25220,"Hammond, LA MSA",2024,10,61145,57988,3157,5.2
MT2226380000000,22,26380,"Houma-Bayou Cane-Thibodaux, LA MSA",2024,10,88305,84652,3653,4.1
MT2229180000000,22,29180,"Lafayette, LA MSA",2024,10,198285,190240,8045,4.1
MT2229340000000,22,29340,"Lake Charles, LA MSA",2024,10,98197,93359,4838,4.9
MT2233740000000,22,33740,"Monroe, LA MSA",2024,10,95977,90921,5056,5.3
MT2235380000000,22,35380,"New Orleans-Metairie, LA MSA",2024,10,468751,447304,21447,4.6
MT2243340000000,22,43340,"Shreveport-Bossier City, LA MSA",2024,10,168078,160300,7778,4.6
MT2243640000000,22,43640,"Slidell-Mandeville-Covington, LA MSA",2024,10,129788,124421,5367,4.1
MT2312620000000,23,12620,"Bangor, ME MSA",2024,10,76519,73614,2905,3.8
MT2330340000000,23,30340,"Lewiston-Auburn, ME MSA",2024,10,55862,53875,1987,3.6
MT2338860000000,23,38860,"Portland-South Portland, ME MSA",2024,10,317311,307910,9401,3
MT2412580000000,24,12580,"Baltimore-Columbia-Towson, MD MSA",2024,10,1499061,1450900,48161,3.2
MT2425180000000,24,25180,"Hagerstown-Martinsburg, MD-WV MSA",2024,10,144248,139375,4873,3.4
MT2430500000000,24,30500,"Lexington Park, MD MSA",2024,10,110027,106928,3099,2.8
MT2441540000000,24,41540,"Salisbury, MD MSA",2024,10,64534,62247,2287,3.5
MT2511200000000,25,11200,"Amherst Town-Northampton, MA MSA",2024,10,86183,82746,3437,4
MT2512700000000,25,12700,"Barnstable Town, MA MSA",2024,10,119226,113384,5842,4.9
MT2514460000000,25,14460,"Boston-Cambridge-Newton, MA-NH MSA",2024,10,2846318,2735747,110571,3.9
MT2538340000000,25,38340,"Pittsfield, MA MSA",2024,10,64372,61664,2708,4.2
MT2544140000000,25,44140,"Springfield, MA MSA",2024,10,226524,214615,11909,5.3
MT2549340000000,25,49340,"Worcester, MA MSA",2024,10,469877,449499,20378,4.3
MT2611460000000,26,11460,"Ann Arbor, MI MSA",2024,10,210249,201675,8574,4.1
MT2612980000000,26,12980,"Battle Creek, MI MSA",2024,10,65006,61315,3691,5.7
MT2613020000000,26,13020,"Bay City, MI MSA",2024,10,50916,47872,3044,6
MT2619820000000,26,19820,"Detroit-Warren-Dearborn, MI MSA",2024,10,2175733,2066426,109307,5
MT2622420000000,26,22420,"Flint, MI MSA",2024,10,191777,179959,11818,6.2
MT2624340000000,26,24340,"Grand Rapids-Wyoming-Kentwood, MI MSA",2024,10,635940,608082,27858,4.4
MT2627100000000,26,27100,"Jackson, MI MSA",2024,10,75653,71616,4037,5.3
MT2628020000000,26,28020,"Kalamazoo-Portage, MI MSA",2024,10,142072,135613,6459,4.5
MT2629620000000,26,29620,"Lansing-East Lansing, MI MSA",2024,10,258985,246940,12045,4.7
MT2633220000000,26,33220,"Midland, MI MSA",2024,10,43556,41429,2127,4.9
MT2633780000000,26,33780,"Monroe, MI MSA",2024,10,80274,75479,4795,6
MT2634740000000,26,34740,"Muskegon-Norton Shores, MI MSA",2024,10,86498,81576,4922,5.7
MT2635660000000,26,35660,"Niles, MI MSA",2024,10,77926,73600,4326,5.6
MT2640980000000,26,40980,"Saginaw, MI MSA",2024,10,86023,80509,5514,6.4
MT2645900000000,26,45900,"Traverse City, MI MSA",2024,10,83416,79488,3928,4.7
MT2720260000000,27,20260,"Duluth, MN-WI MSA",2024,10,139791,134914,4877,3.5
MT2731860000000,27,31860,"Mankato, MN MSA",2024,10,60341,58795,1546,2.6
MT2733460000000,27,33460,"Minneapolis-St. Paul-Bloomington, MN-WI MSA",2024,10,2071438,2012086,59352,2.9
MT2740340000000,27,40340,"Rochester, MN MSA",2024,10,128987,125752,3235,2.5
MT2741060000000,27,41060,"St. Cloud, MN MSA",2024,10,111417,107884,3533,3.2
MT2825060000000,28,25060,"Gulfport-Biloxi, MS MSA",2024,10,190448,184197,6251,3.3
MT2825620000000,28,25620,"Hattiesburg, MS MSA",2024,10,70702,68315,2387,3.4
MT2827140000000,28,27140,"Jackson, MS MSA",2024,10,286880,277624,9256,3.2
MT2916020000000,29,16020,"Cape Girardeau, MO-IL MSA",2024,10,49219,47536,1683,3.4
MT2917860000000,29,17860,"Columbia, MO MSA",2024,10,113318,109776,3542,3.1
MT2927620000000,29,27620,"Jefferson City, MO MSA",2024,10,76983,74609,2374,3.1
MT2927900000000,29,27900,"Joplin, MO-KS MSA",2024,10,98651,95172,3479,3.5
MT2928140000000,29,28140,"Kansas City, MO-KS MSA",2024,10,1204681,1160969,43712,3.6
MT2941140000000,29,41140,"St. Joseph, MO-KS MSA",2024,10,54951,52892,2059,3.7
MT2941180000000,29,41180,"St. Louis, MO-IL MSA",2024,10,1487667,1433206,54461,3.7
MT2944180000000,29,44180,"Springfield, MO MSA",2024,10,244959,236860,8099,3.3
MT3013740000000,30,13740,"Billings, MT MSA",2024,10,99429,96653,2776,2.8
MT3014580000000,30,14580,"Bozeman, MT MSA",2024,10,78270,76500,1770,2.3
MT3024500000000,30,24500,"Great Falls, MT MSA",2024,10,39648,38481,1167,2.9
MT3025740000000,30,25740,"Helena, MT MSA",2024,10,47852,46577,1275,2.7
MT3033540000000,30,33540,"Missoula, MT MSA",2024,10,74583,72447,2136,2.9
MT3124260000000,31,24260,"Grand Island, NE MSA",2024,10,43017,41776,1241,2.9
MT3130700000000,31,30700,"Lincoln, NE MSA",2024,10,195160,189931,5229,2.7
MT3136540000000,31,36540,"Omaha, NE-IA MSA",2024,10,529969,513672,16297,3.1
MT3216180000000,32,16180,"Carson City, NV MSA",2024,10,29501,28057,1444,4.9
MT3229820000000,32,29820,"Las Vegas-Henderson-North Las Vegas, NV MSA",2024,10,1224556,1150779,73777,6
MT3239900000000,32,39900,"Reno, NV MSA",2024,10,301262,286331,14931,5
MT3331700000000,33,31700,"Manchester-Nashua, NH MSA",2024,10,242627,235223,7404,3.1
MT3412100000000,34,12100,"Atlantic City-Hammonton, NJ MSA",2024,10,181829,170164,11665,6.4
MT3445940000000,34,45940,"Trenton-Princeton, NJ MSA",2024,10,199554,190576,8978,4.5
MT3447220000000,34,47220,"Vineland, NJ MSA",2024,10,66246,61497,4749,7.2
MT3510740000000,35,10740,"Albuquerque, NM MSA",2024,10,466644,447658,18986,4.1
MT3522140000000,35,22140,"Farmington, NM MSA",2024,10,50118,47677,2441,4.9
MT3529740000000,35,29740,"Las Cruces, NM MSA",2024,10,102386,97175,5211,5.1
MT3542140000000,35,42140,"Santa Fe, NM MSA",2024,10,74485,71526,2959,4
MT3610580000000,36,10580,"Albany-Schenectady-Troy, NY MSA",2024,10,456028,440929,15099,3.3
MT3613780000000,36,13780,"Binghamton, NY MSA",2024,10,106170,101991,4179,3.9
MT3615380000000,36,15380,"Buffalo-Cheektowaga, NY MSA",2024,10,554808,533178,21630,3.9
MT3621300000000,36,21300,"Elmira, NY MSA",2024,10,35047,33702,1345,3.8
MT3624020000000,36,24020,"Glens Falls, NY MSA",2024,10,59505,57430,2075,3.5
MT3627060000000,36,27060,"Ithaca, NY MSA",2024,10,48170,46565,1605,3.3
MT3628740000000,36,28740,"Kingston, NY MSA",2024,10,87083,84038,3045,3.5
MT3628880000000,36,28880,"Kiryas Joel-Poughkeepsie-Newburgh, NY MSA",2024,10,339275,327615,11660,3.4
MT3635620000000,36,35620,"New York-Newark-Jersey City, NY-NJ MSA",2024,10,10241735,9759988,481747,4.7
MT3640380000000,36,40380,"Rochester, NY MSA",2024,10,511824,493545,18279,3.6
MT3645060000000,36,45060,"Syracuse, NY MSA",2024,10,312093,300895,11198,3.6
MT3646540000000,36,46540,"Utica-Rome, NY MSA",2024,10,126559,121692,4867,3.8
MT3648060000000,36,48060,"Watertown-Fort Drum, NY MSA",2024,10,44799,42869,1930,4.3
MT3711700000000,37,11700,"Asheville, NC MSA",2024,10,220217,199757,20460,9.3
MT3715500000000,37,15500,"Burlington, NC MSA",2024,10,85962,82878,3084,3.6
MT3716740000000,37,16740,"Charlotte-Concord-Gastonia, NC-SC MSA",2024,10,1482957,1428289,54668,3.7
MT3720500000000,37,20500,"Durham-Chapel Hill, NC MSA",2024,10,323595,313302,10293,3.2
MT3722180000000,37,22180,"Fayetteville, NC MSA",2024,10,153450,146567,6883,4.5
MT3724140000000,37,24140,"Goldsboro, NC MSA",2024,10,51276,49398,1878,3.7
MT3724660000000,37,24660,"Greensboro-High Point, NC MSA",2024,10,370476,355640,14836,4
MT3724780000000,37,24780,"Greenville, NC MSA",2024,10,83300,79971,3329,4
MT3725860000000,37,25860,"Hickory-Lenoir-Morganton, NC MSA",2024,10,170361,164153,6208,3.6
MT3727340000000,37,27340,"Jacksonville, NC MSA",2024,10,73939,71205,2734,3.7
MT3738240000000,37,38240,"Pinehurst-Southern Pines, NC MSA",2024,10,44832,43303,1529,3.4
MT3739580000000,37,39580,"Raleigh-Cary, NC MSA",2024,10,848226,822022,26204,3.1
MT3740580000000,37,40580,"Rocky Mount, NC MSA",2024,10,63203,60155,3048,4.8
MT3748900000000,37,48900,"Wilmington, NC MSA",2024,10,223714,215856,7858,3.5
MT3749180000000,37,49180,"Winston-Salem, NC MSA",2024,10,324921,313026,11895,3.7
MT3813900000000,38,13900,"Bismarck, ND MSA",2024,10,73553,71798,1755,2.4
MT3822020000000,38,22020,"Fargo, ND-MN MSA",2024,10,154250,150566,3684,2.4
MT3824220000000,38,24220,"Grand Forks, ND-MN MSA",2024,10,57285,55842,1443,2.5
MT3833500000000,38,33500,"Minot, ND MSA",2024,10,40027,38981,1046,2.6
MT3910420000000,39,10420,"Akron, OH MSA",2024,10,359738,343129,16609,4.6
MT3915940000000,39,15940,"Canton-Massillon, OH MSA",2024,10,195652,186423,9229,4.7
MT3917140000000,39,17140,"Cincinnati, OH-KY-IN MSA",2024,10,1179505,1128157,51348,4.4
MT3917410000000,39,17410,"Cleveland, OH MSA",2024,10,1105534,1063038,42496,3.8
MT3918140000000,39,18140,"Columbus, OH MSA",2024,10,1163401,1115337,48064,4.1
MT3919430000000,39,19430,"Dayton-Kettering-Beavercreek, OH MSA",2024,10,395948,377982,17966,4.5
MT3930620000000,39,30620,"Lima, OH MSA",2024,10,47629,45452,2177,4.6
MT3931900000000,39,31900,"Mansfield, OH MSA",2024,10,53704,50962,2742,5.1
MT3941780000000,39,41780,"Sandusky, OH MSA",2024,10,58169,55035,3134,5.4
MT3944220000000,39,44220,"Springfield, OH MSA",2024,10,62202,59207,2995,4.8
MT3945780000000,39,45780,"Toledo, OH MSA",2024,10,294344,280996,13348,4.5
MT3948260000000,39,48260,"Weirton-Steubenville, WV-OH MSA",2024,10,50771,47786,2985,5.9
MT3949660000000,39,49660,"Youngstown-Warren, OH MSA",2024,10,193370,183266,10104,5.2
MT4021420000000,40,21420,"Enid, OK MSA",2024,10,28304,27416,888,3.1
MT4030020000000,40,30020,"Lawton, OK MSA",2024,10,52424,50566,1858,3.5
MT4036420000000,40,36420,"Oklahoma City, OK MSA",2024,10,775891,751966,23925,3.1
MT4046140000000,40,46140,"Tulsa, OK MSA",2024,10,526871,509685,17186,3.3
MT4110540000000,41,10540,"Albany, OR MSA",2024,10,62282,59331,2951,4.7
MT4113460000000,41,13460,"Bend, OR MSA",2024,10,133603,127864,5739,4.3
MT4118700000000,41,18700,"Corvallis, OR MSA",2024,10,49301,47426,1875,3.8
MT4121660000000,41,21660,"Eugene-Springfield, OR MSA",2024,10,188823,180587,8236,4.4
MT4124420000000,41,24420,"Grants Pass, OR MSA",2024,10,34999,32902,2097,6
MT4132780000000,41,32780,"Medford, OR MSA",2024,10,105914,100624,5290,5
MT4138900000000,41,38900,"Portland-Vancouver-Hillsboro, OR-WA MSA",2024,10,1386339,1328708,57631,4.2
MT4141420000000,41,41420,"Salem, OR MSA",2024,10,224720,215243,9477,4.2
MT4210900000000,42,10900,"Allentown-Bethlehem-Easton, PA-NJ MSA",2024,10,452116,434415,17701,3.9
MT4211020000000,42,11020,"Altoona, PA MSA",2024,10,57674,55583,2091,3.6
MT4216540000000,42,16540,"Chambersburg, PA MSA",2024,10,77520,75058,2462,3.2
MT4221500000000,42,21500,"Erie, PA MSA",2024,10,125930,120929,5001,4
MT4223900000000,42,23900,"Gettysburg, PA MSA",2024,10,51468,49836,1632,3.2
MT4225420000000,42,25420,"Harrisburg-Carlisle, PA MSA",2024,10,313841,303420,10421,3.3
MT4227780000000,42,27780,"Johnstown, PA MSA",2024,10,56194,53747,2447,4.4
MT4229540000000,42,29540,"Lancaster, PA MSA",2024,10,290989,282387,8602,3
MT4230140000000,42,30140,"Lebanon, PA MSA",2024,10,73731,71399,2332,3.2
MT4237980000000,42,37980,"Philadelphia-Camden-Wilmington, PA-NJ-DE-MD MSA",2024,10,3286592,3158499,128093,3.9
MT4238300000000,42,38300,"Pittsburgh, PA MSA",2024,10,1230857,1185206,45651,3.7
MT4239740000000,42,39740,"Reading, PA MSA",2024,10,218950,210815,8135,3.7
MT4242540000000,42,42540,"Scranton--Wilkes-Barre, PA MSA",2024,10,278729,266911,11818,4.2
MT4244300000000,42,44300,"State College, PA MSA",2024,10,75878,73673,2205,2.9
MT4248700000000,42,48700,"Williamsport, PA MSA",2024,10,52777,50643,2134,4
MT4249620000000,42,49620,"York-Hanover, PA MSA",2024,10,239025,230582,8443,3.5
MT4439300000000,44,39300,"Providence-Warwick, RI-MA MSA",2024,10,905288,863182,42106,4.7
MT4516700000000,45,16700,"Charleston-North Charleston, SC MSA",2024,10,448925,431989,16936,3.8
MT4517900000000,45,17900,"Columbia, SC MSA",2024,10,423884,405648,18236,4.3
MT4522500000000,45,22500,"Florence, SC MSA",2024,10,92702,88228,4474,4.8
MT4524860000000,45,24860,"Greenville-Anderson-Greer, SC MSA",2024,10,482371,462668,19703,4.1
MT4525940000000,45,25940,"Hilton Head Island-Bluffton-Port Royal, SC MSA",2024,10,99257,95191,4066,4.1
MT4534820000000,45,34820,"Myrtle Beach-Conway-North Myrtle Beach, SC MSA",2024,10,172054,163420,8634,5
MT4543900000000,45,43900,"Spartanburg, SC MSA",2024,10,178972,170754,8218,4.6
MT4544940000000,45,44940,"Sumter, SC MSA",2024,10,41809,39440,2369,5.7
MT4639660000000,46,39660,"Rapid City, SD MSA",2024,10,80834,79362,1472,1.8
MT4643620000000,46,43620,"Sioux Falls, SD-MN MSA",2024,10,175933,172856,3077,1.7
MT4716860000000,47,16860,"Chattanooga, TN-GA MSA",2024,10,292670,282631,10039,3.4
MT4717300000000,47,17300,"Clarksville, TN-KY MSA",2024,10,140561,134415,6146,4.4
MT4717420000000,47,17420,"Cleveland, TN MSA",2024,10,56133,53856,2277,4.1
MT4727180000000,47,27180,"Jackson, TN MSA",2024,10,78613,75297,3316,4.2
MT4727740000000,47,27740,"Johnson City, TN MSA",2024,10,97287,93473,3814,3.9
MT4728700000000,47,28700,"Kingsport-Bristol, TN-VA MSA",2024,10,133501,128357,5144,3.9
MT4728940000000,47,28940,"Knoxville, TN MSA",2024,10,456389,440828,15561,3.4
MT4732820000000,47,32820,"Memphis, TN-MS-AR MSA",2024,10,627429,599255,28174,4.5
MT4734100000000,47,34100,"Morristown, TN MSA",2024,10,54261,52208,2053,3.8
MT4734980000000,47,34980,"Nashville-Davidson--Murfreesboro--Franklin, TN MSA",2024,10,1165603,1129280,36323,3.1
MT4810180000000,48,10180,"Abilene, TX MSA",2024,10,87423,84368,3055,3.5
MT4811100000000,48,11100,"Amarillo, TX MSA",2024,10,139145,134750,4395,3.2
MT4812420000000,48,12420,"Austin-Round Rock-San Marcos, TX MSA",2024,10,1517160,1463006,54154,3.6
MT4813140000000,48,13140,"Beaumont-Port Arthur, TX MSA",2024,10,185119,174962,10157,5.5
MT4815180000000,48,15180,"Brownsville-Harlingen, TX MSA",2024,10,191581,181417,10164,5.3
MT4817780000000,48,17780,"College Station-Bryan, TX MSA",2024,10,152851,147516,5335,3.5
MT4818580000000,48,18580,"Corpus Christi, TX MSA",2024,10,211726,202427,9299,4.4
MT4819100000000,48,19100,"Dallas-Fort Worth-Arlington, TX MSA",2024,10,4520597,4341430,179167,4
MT4820580000000,48,20580,"Eagle Pass, TX MSA",2024,10,24403,22450,1953,8
MT4821340000000,48,21340,"El Paso, TX MSA",2024,10,418759,401127,17632,4.2
MT4826420000000,48,26420,"Houston-Pasadena-The Woodlands, TX MSA",2024,10,3865475,3692479,172996,4.5
MT4828660000000,48,28660,"Killeen-Temple, TX MSA",2024,10,202927,193579,9348,4.6
MT4829700000000,48,29700,"Laredo, TX MSA",2024,10,119877,114822,5055,4.2
MT4830980000000,48,30980,"Longview, TX MSA",2024,10,129368,122991,6377,4.9
MT4831180000000,48,31180,"Lubbock, TX MSA",2024,10,185578,178868,6710,3.6
MT4832580000000,48,32580,"McAllen-Edinburg-Mission, TX MSA",2024,10,399287,375039,24248,6.1
MT4833260000000,48,33260,"Midland, TX MSA",2024,10,104546,101412,3134,3
MT4836220000000,48,36220,"Odessa, TX MSA",2024,10,87069,83911,3158,3.6
MT4841660000000,48,41660,"San Angelo, TX MSA",2024,10,62802,60707,2095,3.3
MT4841700000000,48,41700,"San Antonio-New Braunfels, TX MSA",2024,10,1350699,1298500,52199,3.9
MT4843300000000,48,43300,"Sherman-Denison, TX MSA",2024,10,71911,69075,2836,3.9
MT4845500000000,48,45500,"Texarkana, TX-AR MSA",2024,10,62395,59754,2641,4.2
MT4846340000000,48,46340,"Tyler, TX MSA",2024,10,119045,114476,4569,3.8
MT4847020000000,48,47020,"Victoria, TX MSA",2024,10,45301,43415,1886,4.2
MT4847380000000,48,47380,"Waco, TX MSA",2024,10,147772,142010,5762,3.9
MT4848660000000,48,48660,"Wichita Falls, TX MSA",2024,10,67115,64518,2597,3.9
MT4930860000000,49,30860,"Logan, UT-ID MSA",2024,10,80676,78303,2373,2.9
MT4936260000000,49,36260,"Ogden, UT MSA",2024,10,354053,343107,10946,3.1
MT4939340000000,49,39340,"Provo-Orem-Lehi, UT MSA",2024,10,371969,359444,12525,3.4
MT4941100000000,49,41100,"St. George, UT MSA",2024,10,95200,91937,3263,3.4
MT4941620000000,49,41620,"Salt Lake City-Murray, UT MSA",2024,10,740127,715695,24432,3.3
MT5015540000000,50,15540,"Burlington-South Burlington, VT MSA",2024,10,131972,129063,2909,2.2
MT5113980000000,51,13980,"Blacksburg-Christiansburg-Radford, VA MSA",2024,10,93072,90010,3062,3.3
MT5116820000000,51,16820,"Charlottesville, VA MSA",2024,10,121162,118033,3129,2.6
MT5125500000000,51,25500,"Harrisonburg, VA MSA",2024,10,72071,70029,2042,2.8
MT5131340000000,51,31340,"Lynchburg, VA MSA",2024,10,127002,122786,4216,3.3
MT5140060000000,51,40060,"Richmond, VA MSA",2024,10,730424,708261,22163,3
MT5140220000000,51,40220,"Roanoke, VA MSA",2024,10,159071,154313,4758,3
MT5144420000000,51,44420,"Staunton-Stuarts Draft, VA MSA",2024,10,65249,63500,1749,2.7
MT5147260000000,51,47260,"Virginia Beach-Chesapeake-Norfolk, VA-NC MSA",2024,10,884394,856810,27584,3.1
MT5149020000000,51,49020,"Winchester, VA-WV MSA",2024,10,77613,75412,2201,2.8
MT5313380000000,53,13380,"Bellingham, WA MSA",2024,10,113080,107873,5207,4.6
MT5314740000000,53,14740,"Bremerton-Silverdale-Port Orchard, WA MSA",2024,10,121404,115889,5515,4.5
MT5328420000000,53,28420,"Kennewick-Richland, WA MSA",2024,10,148346,140963,7383,5
MT5331020000000,53,31020,"Longview-Kelso, WA MSA",2024,10,46856,44350,2506,5.3
MT5334580000000,53,34580,"Mount Vernon-Anacortes, WA MSA",2024,10,59574,56561,3013,5.1
MT5336500000000,53,36500,"Olympia-Lacey-Tumwater, WA MSA",2024,10,143317,136703,6614,4.6
MT5342660000000,53,42660,"Seattle-Tacoma-Bellevue, WA MSA",2024,10,2343554,2248737,94817,4
MT5344060000000,53,44060,"Spokane-Spokane Valley, WA MSA",2024,10,279071,265821,13250,4.7
MT5347460000000,53,47460,"Walla Walla, WA MSA",2024,10,29207,28004,1203,4.1
MT5348300000000,53,48300,"Wenatchee-East Wenatchee, WA MSA",2024,10,61727,58729,2998,4.9
MT5349420000000,53,49420,"Yakima, WA MSA",2024,10,124297,116420,7877,6.3
MT5413220000000,54,13220,"Beckley, WV MSA",2024,10,45997,44130,1867,4.1
MT5416620000000,54,16620,"Charleston, WV MSA",2024,10,90220,86545,3675,4.1
MT5426580000000,54,26580,"Huntington-Ashland, WV-KY-OH MSA",2024,10,157487,149466,8021,5.1
MT5434060000000,54,34060,"Morgantown, WV MSA",2024,10,71039,68635,2404,3.4
MT5437620000000,54,37620,"Parkersburg-Vienna, WV MSA",2024,10,39098,37443,1655,4.2
MT5448540000000,54,48540,"Wheeling, WV-OH MSA",2024,10,59461,56536,2925,4.9
MT5511540000000,55,11540,"Appleton, WI MSA",2024,10,138184,134582,3602,2.6
MT5520740000000,55,20740,"Eau Claire, WI MSA",2024,10,96926,93997,2929,3
MT5522540000000,55,22540,"Fond du Lac, WI MSA",2024,10,55245,53574,1671,3
MT5524580000000,55,24580,"Green Bay, WI MSA",2024,10,181369,176393,4976,2.7
MT5527500000000,55,27500,"Janesville-Beloit, WI MSA",2024,10,87769,84892,2877,3.3
MT5528450000000,55,28450,"Kenosha, WI MSA",2024,10,96227,93055,3172,3.3
MT5529100000000,55,29100,"La Crosse-Onalaska, WI-MN MSA",2024,10,91564,89013,2551,2.8
MT5531540000000,55,31540,"Madison, WI MSA",2024,10,412769,402487,10282,2.5
MT5533340000000,55,33340,"Milwaukee-Waukesha, WI MSA",2024,10,825639,798165,27474,3.3
MT5536780000000,55,36780,"Oshkosh-Neenah, WI MSA",2024,10,93410,90837,2573,2.8
MT5539540000000,55,39540,"Racine-Mount Pleasant, WI MSA",2024,10,101733,98046,3687,3.6
MT5543100000000,55,43100,"Sheboygan, WI MSA",2024,10,64227,62552,1675,2.6
MT5548140000000,55,48140,"Wausau, WI MSA",2024,10,75230,73240,1990,2.6
MT5616220000000,56,16220,"Casper, WY MSA",2024,10,42391,40868,1523,3.6
MT5616940000000,56,16940,"Cheyenne, WY MSA",2024,10,49283,47487,1796,3.6
MT7210380000000,72,10380,"Aguadilla, PR MSA",2024,10,91130,84729,6401,7
MT7211640000000,72,11640,"Arecibo, PR MSA",2024,10,67973,64413,3560,5.2
MT7225020000000,72,25020,"Guayama, PR MSA",2024,10,19222,17422,1800,9.4
MT7232420000000,72,32420,"Mayaguez, PR MSA",2024,10,67594,62585,5009,7.4
MT7238660000000,72,38660,"Ponce, PR MSA",2024,10,90082,82429,7653,8.5
MT7241980000000,72,41980,"San Juan-Bayamon-Caguas, PR MSA",2024,10,824350,786324,38026,4.6
MT0111500000000,1,11500,"Anniston-Oxford, AL MSA",2024,11,49975,48193,1782,3.6
MT0112220000000,1,12220,"Auburn-Opelika, AL MSA",2024,11,96840,93790,3050,3.1
MT0113820000000,1,13820,"Birmingham, AL MSA",2024,11,572630,554686,17944,3.1
MT0119300000000,1,19300,"Daphne-Fairhope-Foley, AL MSA",2024,11,118125,114642,3483,2.9
MT0119460000000,1,19460,"Decatur, AL MSA",2024,11,76898,74664,2234,2.9
MT0120020000000,1,20020,"Dothan, AL MSA",2024,11,68047,65722,2325,3.4
MT0122520000000,1,22520,"Florence-Muscle Shoals, AL MSA",2024,11,69756,67280,2476,3.5
MT0123460000000,1,23460,"Gadsden, AL MSA",2024,11,42337,40787,1550,3.7
MT0126620000000,1,26620,"Huntsville, AL MSA",2024,11,279212,271361,7851,2.8
MT0133660000000,1,33660,"Mobile, AL MSA",2024,11,188146,180701,7445,4
MT0133860000000,1,33860,"Montgomery, AL MSA",2024,11,179691,173712,5979,3.3
MT0146220000000,1,46220,"Tuscaloosa, AL MSA",2024,11,127167,122586,4581,3.6
MT0211260000000,2,11260,"Anchorage, AK MSA",2024,11,202040,193395,8645,4.3
MT0221820000000,2,21820,"Fairbanks-College, AK MSA",2024,11,45998,44077,1921,4.2
MT0422380000000,4,22380,"Flagstaff, AZ MSA",2024,11,75989,72826,3163,4.2
MT0429420000000,4,29420,"Lake Havasu City-Kingman, AZ MSA",2024,11,88142,84050,4092,4.6
MT0438060000000,4,38060,"Phoenix-Mesa-Chandler, AZ MSA",2024,11,2721389,2629064,92325,3.4
MT0439150000000,4,39150,"Prescott Valley-Prescott, AZ MSA",2024,11,107177,103336,3841,3.6
MT0443420000000,4,43420,"Sierra Vista-Douglas, AZ MSA",2024,11,47728,45598,2130,4.5
MT0446060000000,4,46060,"Tucson, AZ MSA",2024,11,494926,476199,18727,3.8
MT0449740000000,4,49740,"Yuma, AZ MSA",2024,11,98916,86391,12525,12.7
MT0522220000000,5,22220,"Fayetteville-Springdale-Rogers, AR MSA",2024,11,309668,301135,8533,2.8
MT0522900000000,5,22900,"Fort Smith, AR-OK MSA",2024,11,102084,98527,3557,3.5
MT0526300000000,5,26300,"Hot Springs, AR MSA",2024,11,43601,41980,1621,3.7
MT0527860000000,5,27860,"Jonesboro, AR MSA",2024,11,66669,64465,2204,3.3
MT0530780000000,5,30780,"Little Rock-North Little Rock-Conway, AR MSA",2024,11,383011,370356,12655,3.3
MT0612540000000,6,12540,"Bakersfield-Delano, CA MSA",2024,11,411593,375919,35674,8.7
MT0617020000000,6,17020,"Chico, CA MSA",2024,11,91786,86206,5580,6.1
MT0620940000000,6,20940,"El Centro, CA MSA",2024,11,73403,59705,13698,18.7
MT0623420000000,6,23420,"Fresno, CA MSA",2024,11,541843,498851,42992,7.9
MT0625260000000,6,25260,"Hanford-Corcoran, CA MSA",2024,11,58788,53515,5273,9
MT0631080000000,6,31080,"Los Angeles-Long Beach-Anaheim, CA MSA",2024,11,6751505,6371216,380289,5.6
MT0632900000000,6,32900,"Merced, CA MSA",2024,11,121501,109557,11944,9.8
MT0633700000000,6,33700,"Modesto, CA MSA",2024,11,256491,238538,17953,7
MT0634900000000,6,34900,"Napa, CA MSA",2024,11,75304,72281,3023,4
MT0637100000000,6,37100,"Oxnard-Thousand Oaks-Ventura, CA MSA",2024,11,420881,400950,19931,4.7
MT0639820000000,6,39820,"Redding, CA MSA",2024,11,79933,75596,4337,5.4
MT0640140000000,6,40140,"Riverside-San Bernardino-Ontario, CA MSA",2024,11,2220780,2101815,118965,5.4
MT0640900000000,6,40900,"Sacramento-Roseville-Folsom, CA MSA",2024,11,1185579,1128340,57239,4.8
MT0641500000000,6,41500,"Salinas, CA MSA",2024,11,223081,206943,16138,7.2
MT0641740000000,6,41740,"San Diego-Chula Vista-Carlsbad, CA MSA",2024,11,1652025,1578030,73995,4.5
MT0641860000000,6,41860,"San Francisco-Oakland-Fremont, CA MSA",2024,11,2499933,2391589,108344,4.3
MT0641940000000,6,41940,"San Jose-Sunnyvale-Santa Clara, CA MSA",2024,11,1058528,1012808,45720,4.3
MT0642020000000,6,42020,"San Luis Obispo-Paso Robles, CA MSA",2024,11,132231,126628,5603,4.2
MT0642100000000,6,42100,"Santa Cruz-Watsonville, CA MSA",2024,11,136477,128207,8270,6.1
MT0642200000000,6,42200,"Santa Maria-Santa Barbara, CA MSA",2024,11,221830,211742,10088,4.5
MT0642220000000,6,42220,"Santa Rosa-Petaluma, CA MSA",2024,11,246288,235753,10535,4.3
MT0644700000000,6,44700,"Stockton-Lodi, CA MSA",2024,11,371468,347014,24454,6.6
MT0646700000000,6,46700,"Vallejo, CA MSA",2024,11,216297,205052,11245,5.2
MT0647300000000,6,47300,"Visalia, CA MSA",2024,11,221895,198894,23001,10.4
MT0649700000000,6,49700,"Yuba City, CA MSA",2024,11,81963,75508,6455,7.9
MT0814500000000,8,14500,"Boulder, CO MSA",2024,11,193829,184955,8874,4.6
MT0817820000000,8,17820,"Colorado Springs, CO MSA",2024,11,398286,379727,18559,4.7
MT0819740000000,8,19740,"Denver-Aurora-Centennial, CO MSA",2024,11,1786331,1704028,82303,4.6
MT0822660000000,8,22660,"Fort Collins-Loveland, CO MSA",2024,11,207958,198687,9271,4.5
MT0824300000000,8,24300,"Grand Junction, CO MSA",2024,11,80638,76766,3872,4.8
MT0824540000000,8,24540,"Greeley, CO MSA",2024,11,178463,169706,8757,4.9
MT0839380000000,8,39380,"Pueblo, CO MSA",2024,11,73897,69201,4696,6.4
MT0914860000000,9,14860,"Bridgeport-Stamford-Danbury, CT MSA",2024,11,519462,503495,15967,3.1
MT0925540000000,9,25540,"Hartford-West Hartford-East Hartford, CT MSA",2024,11,616867,597077,19790,3.2
MT0935300000000,9,35300,"New Haven, CT MSA",2024,11,318018,307904,10114,3.2
MT0935980000000,9,35980,"Norwich-New London-Willimantic, CT MSA",2024,11,144243,139748,4495,3.1
MT0947930000000,9,47930,"Waterbury-Shelton, CT MSA",2024,11,242506,233602,8904,3.7
MT1020100000000,10,20100,"Dover, DE MSA",2024,11,85267,81902,3365,3.9
MT1147900000000,11,47900,"Washington-Arlington-Alexandria, DC-VA-MD-WV MSA",2024,11,3570167,3459439,110728,3.1
MT1215980000000,12,15980,"Cape Coral-Fort Myers, FL MSA",2024,11,375031,361308,13723,3.7
MT1218880000000,12,18880,"Crestview-Fort Walton Beach-Destin, FL MSA",2024,11,143967,139367,4600,3.2
MT1219660000000,12,19660,"Deltona-Daytona Beach-Ormond Beach, FL MSA",2024,11,322863,309932,12931,4
MT1223540000000,12,23540,"Gainesville, FL MSA",2024,11,170436,163852,6584,3.9
MT1226140000000,12,26140,"Homosassa Springs, FL MSA",2024,11,54047,51246,2801,5.2
MT1227260000000,12,27260,"Jacksonville, FL MSA",2024,11,857666,827392,30274,3.5
MT1229460000000,12,29460,"Lakeland-Winter Haven, FL MSA",2024,11,359489,344151,15338,4.3
MT1233100000000,12,33100,"Miami-Fort Lauderdale-West Palm Beach, FL MSA",2024,11,3308493,3210868,97625,3
MT1234940000000,12,34940,"Naples-Marco Island, FL MSA",2024,11,185712,179341,6371,3.4
MT1235840000000,12,35840,"North Port-Bradenton-Sarasota, FL MSA",2024,11,398807,383972,14835,3.7
MT1236100000000,12,36100,"Ocala, FL MSA",2024,11,159505,152635,6870,4.3
MT1236740000000,12,36740,"Orlando-Kissimmee-Sanford, FL MSA",2024,11,1537905,1486334,51571,3.4
MT1237340000000,12,37340,"Palm Bay-Melbourne-Titusville, FL MSA",2024,11,306344,295304,11040,3.6
MT1237460000000,12,37460,"Panama City-Panama City Beach, FL MSA",2024,11,102246,98741,3505,3.4
MT1237860000000,12,37860,"Pensacola-Ferry Pass-Brent, FL MSA",2024,11,240379,231637,8742,3.6
MT1238940000000,12,38940,"Port St. Lucie, FL MSA",2024,11,242046,232680,9366,3.9
MT1239460000000,12,39460,"Punta Gorda, FL MSA",2024,11,77322,73932,3390,4.4
MT1242680000000,12,42680,"Sebastian-Vero Beach-West Vero Corridor, FL MSA",2024,11,67761,64930,2831,4.2
MT1242700000000,12,42700,"Sebring, FL MSA",2024,11,36820,34986,1834,5
MT1245220000000,12,45220,"Tallahassee, FL MSA",2024,11,209382,201906,7476,3.6
MT1245300000000,12,45300,"Tampa-St. Petersburg-Clearwater, FL MSA",2024,11,1702212,1640772,61440,3.6
MT1248680000000,12,48680,"Wildwood-The Villages, FL MSA",2024,11,34382,32415,1967,5.7
MT1310500000000,13,10500,"Albany, GA MSA",2024,11,62366,59722,2644,4.2
MT1312020000000,13,12020,"Athens-Clarke County, GA MSA",2024,11,108835,105163,3672,3.4
MT1312060000000,13,12060,"Atlanta-Sandy Springs-Roswell, GA MSA",2024,11,3306088,3188906,117182,3.5
MT1312260000000,13,12260,"Augusta-Richmond County, GA-SC MSA",2024,11,268226,255822,12404,4.6
MT1315260000000,13,15260,"Brunswick-St. Simons, GA MSA",2024,11,55968,54199,1769,3.2
MT1317980000000,13,17980,"Columbus, GA-AL MSA",2024,11,128816,123465,5351,4.2
MT1319140000000,13,19140,"Dalton, GA MSA",2024,11,68154,65419,2735,4
MT1323580000000,13,23580,"Gainesville, GA MSA",2024,11,109294,106154,3140,2.9
MT1325980000000,13,25980,"Hinesville, GA MSA",2024,11,31408,30168,1240,3.9
MT1331420000000,13,31420,"Macon-Bibb County, GA MSA",2024,11,97175,92963,4212,4.3
MT1340660000000,13,40660,"Rome, GA MSA",2024,11,48068,46339,1729,3.6
MT1342340000000,13,42340,"Savannah, GA MSA",2024,11,209842,203336,6506,3.1
MT1346660000000,13,46660,"Valdosta, GA MSA",2024,11,61851,59344,2507,4.1
MT1347580000000,13,47580,"Warner Robins, GA MSA",2024,11,90331,87456,2875,3.2
MT1527980000000,15,27980,"Kahului-Wailuku, HI MSA",2024,11,81382,78204,3178,3.9
MT1546520000000,15,46520,"Urban Honolulu, HI MSA",2024,11,472589,458838,13751,2.9
MT1614260000000,16,14260,"Boise City, ID MSA",2024,11,451572,435394,16178,3.6
MT1617660000000,16,17660,"Coeur d'Alene, ID MSA",2024,11,90943,86840,4103,4.5
MT1626820000000,16,26820,"Idaho Falls, ID MSA",2024,11,85051,82330,2721,3.2
MT1630300000000,16,30300,"Lewiston, ID-WA MSA",2024,11,31024,29875,1149,3.7
MT1638540000000,16,38540,"Pocatello, ID MSA",2024,11,41204,39505,1699,4.1
MT1646300000000,16,46300,"Twin Falls, ID MSA",2024,11,60604,58399,2205,3.6
MT1714010000000,17,14010,"Bloomington, IL MSA",2024,11,96002,92363,3639,3.8
MT1716580000000,17,16580,"Champaign-Urbana, IL MSA",2024,11,125643,120742,4901,3.9
MT1716980000000,17,16980,"Chicago-Naperville-Elgin, IL-IN MSA",2024,11,5048120,4788792,259328,5.1
MT1719340000000,17,19340,"Davenport-Moline-Rock Island, IA-IL MSA",2024,11,189783,180422,9361,4.9
MT1719500000000,17,19500,"Decatur, IL MSA",2024,11,44439,41936,2503,5.6
MT1728100000000,17,28100,"Kankakee, IL MSA",2024,11,51175,48429,2746,5.4
MT1737900000000,17,37900,"Peoria, IL MSA",2024,11,178173,169859,8314,4.7
MT1740420000000,17,40420,"Rockford, IL MSA",2024,11,160598,152092,8506,5.3
MT1744100000000,17,44100,"Springfield, IL MSA",2024,11,103842,99580,4262,4.1
MT1814020000000,18,14020,"Bloomington, IN MSA",2024,11,86035,82631,3404,4
MT1818020000000,18,18020,"Columbus, IN MSA",2024,11,39910,38215,1695,4.2
MT1821140000000,18,21140,"Elkhart-Goshen, IN MSA",2024,11,98570,93693,4877,4.9
MT1821780000000,18,21780,"Evansville, IN MSA",2024,11,136696,131151,5545,4.1
MT1823060000000,18,23060,"Fort Wayne, IN MSA",2024,11,233723,224250,9473,4.1
MT1826900000000,18,26900,"Indianapolis-Carmel-Greenwood, IN MSA",2024,11,1150607,1104323,46284,4
MT1829020000000,18,29020,"Kokomo, IN MSA",2024,11,36656,34339,2317,6.3
MT1829200000000,18,29200,"Lafayette-West Lafayette, IN MSA",2024,11,120446,115658,4788,4
MT1833140000000,18,33140,"Michigan City-La Porte, IN MSA",2024,11,51917,49314,2603,5
MT1834620000000,18,34620,"Muncie, IN MSA",2024,11,53371,50789,2582,4.8
MT1843780000000,18,43780,"South Bend-Mishawaka, IN-MI MSA",2024,11,156582,148634,7948,5.1
MT1845460000000,18,45460,"Terre Haute, IN MSA",2024,11,78222,74590,3632,4.6
MT1911180000000,19,11180,"Ames, IA MSA",2024,11,69770,68021,1749,2.5
MT1916300000000,19,16300,"Cedar Rapids, IA MSA",2024,11,146006,141079,4927,3.4
MT1919780000000,19,19780,"Des Moines-West Des Moines, IA MSA",2024,11,414023,400806,13217,3.2
MT1920220000000,19,20220,"Dubuque, IA MSA",2024,11,53534,51817,1717,3.2
MT1926980000000,19,26980,"Iowa City, IA MSA",2024,11,100583,98130,2453,2.4
MT1943580000000,19,43580,"Sioux City, IA-NE-SD MSA",2024,11,76497,74133,2364,3.1
MT1947940000000,19,47940,"Waterloo-Cedar Falls, IA MSA",2024,11,88574,85063,3511,4
MT2029940000000,20,29940,"Lawrence, KS MSA",2024,11,71887,69429,2458,3.4
MT2031740000000,20,31740,"Manhattan, KS MSA",2024,11,64932,62645,2287,3.5
MT2045820000000,20,45820,"Topeka, KS MSA",2024,11,119422,114827,4595,3.8
MT2048620000000,20,48620,"Wichita, KS MSA",2024,11,338699,324397,14302,4.2
MT2114540000000,21,14540,"Bowling Green, KY MSA",2024,11,93936,89278,4658,5
MT2121060000000,21,21060,"Elizabethtown, KY MSA",2024,11,55970,52848,3122,5.6
MT2130460000000,21,30460,"Lexington-Fayette, KY MSA",2024,11,279614,267127,12487,4.5
MT2131140000000,21,31140,"Louisville/Jefferson County, KY-IN MSA",2024,11,704254,670498,33756,4.8
MT2136980000000,21,36980,"Owensboro, KY MSA",2024,11,52919,50088,2831,5.3
MT2137140000000,21,37140,"Paducah, KY-IL MSA",2024,11,46322,43838,2484,5.4
MT2210780000000,22,10780,"Alexandria, LA MSA",2024,11,64558,61762,2796,4.3
MT2212940000000,22,12940,"Baton Rouge, LA MSA",2024,11,428264,409766,18498,4.3
MT2225220000000,22,25220,"Hammond, LA MSA",2024,11,61144,57993,3151,5.2
MT2226380000000,22,26380,"Houma-Bayou Cane-Thibodaux, LA MSA",2024,11,88291,84649,3642,4.1
MT2229180000000,22,29180,"Lafayette, LA MSA",2024,11,198283,190253,8030,4
MT2229340000000,22,29340,"Lake Charles, LA MSA",2024,11,98228,93401,4827,4.9
MT2233740000000,22,33740,"Monroe, LA MSA",2024,11,95959,90906,5053,5.3
MT2235380000000,22,35380,"New Orleans-Metairie, LA MSA",2024,11,468612,447181,21431,4.6
MT2243340000000,22,43340,"Shreveport-Bossier City, LA MSA",2024,11,168044,160276,7768,4.6
MT2243640000000,22,43640,"Slidell-Mandeville-Covington, LA MSA",2024,11,129747,124391,5356,4.1
MT2312620000000,23,12620,"Bangor, ME MSA",2024,11,76500,73588,2912,3.8
MT2330340000000,23,30340,"Lewiston-Auburn, ME MSA",2024,11,55813,53821,1992,3.6
MT2338860000000,23,38860,"Portland-South Portland, ME MSA",2024,11,317223,307833,9390,3
MT2412580000000,24,12580,"Baltimore-Columbia-Towson, MD MSA",2024,11,1498527,1450583,47944,3.2
MT2425180000000,24,25180,"Hagerstown-Martinsburg, MD-WV MSA",2024,11,144189,139337,4852,3.4
MT2430500000000,24,30500,"Lexington Park, MD MSA",2024,11,109992,106914,3078,2.8
MT2441540000000,24,41540,"Salisbury, MD MSA",2024,11,64516,62237,2279,3.5
MT2511200000000,25,11200,"Amherst Town-Northampton, MA MSA",2024,11,86200,82756,3444,4
MT2512700000000,25,12700,"Barnstable Town, MA MSA",2024,11,119290,113438,5852,4.9
MT2514460000000,25,14460,"Boston-Cambridge-Newton, MA-NH MSA",2024,11,2846754,2735977,110777,3.9
MT2538340000000,25,38340,"Pittsfield, MA MSA",2024,11,64381,61673,2708,4.2
MT2544140000000,25,44140,"Springfield, MA MSA",2024,11,226496,214595,11901,5.3
MT2549340000000,25,49340,"Worcester, MA MSA",2024,11,469842,449431,20411,4.3
MT2611460000000,26,11460,"Ann Arbor, MI MSA",2024,11,210314,201698,8616,4.1
MT2612980000000,26,12980,"Battle Creek, MI MSA",2024,11,65001,61303,3698,5.7
MT2613020000000,26,13020,"Bay City, MI MSA",2024,11,50918,47874,3044,6
MT2619820000000,26,19820,"Detroit-Warren-Dearborn, MI MSA",2024,11,2175828,2066209,109619,5
MT2622420000000,26,22420,"Flint, MI MSA",2024,11,191743,179884,11859,6.2
MT2624340000000,26,24340,"Grand Rapids-Wyoming-Kentwood, MI MSA",2024,11,635736,607829,27907,4.4
MT2627100000000,26,27100,"Jackson, MI MSA",2024,11,75656,71609,4047,5.3
MT2628020000000,26,28020,"Kalamazoo-Portage, MI MSA",2024,11,142078,135592,6486,4.6
MT2629620000000,26,29620,"Lansing-East Lansing, MI MSA",2024,11,259156,247022,12134,4.7
MT2633220000000,26,33220,"Midland, MI MSA",2024,11,43568,41436,2132,4.9
MT2633780000000,26,33780,"Monroe, MI MSA",2024,11,80263,75487,4776,6
MT2634740000000,26,34740,"Muskegon-Norton Shores, MI MSA",2024,11,86502,81554,4948,5.7
MT2635660000000,26,35660,"Niles, MI MSA",2024,11,77990,73658,4332,5.6
MT2640980000000,26,40980,"Saginaw, MI MSA",2024,11,86015,80480,5535,6.4
MT2645900000000,26,45900,"Traverse City, MI MSA",2024,11,83457,79528,3929,4.7
MT2720260000000,27,20260,"Duluth, MN-WI MSA",2024,11,139829,134994,4835,3.5
MT2731860000000,27,31860,"Mankato, MN MSA",2024,11,60299,58766,1533,2.5
MT2733460000000,27,33460,"Minneapolis-St. Paul-Bloomington, MN-WI MSA",2024,11,2072066,2013191,58875,2.8
MT2740340000000,27,40340,"Rochester, MN MSA",2024,11,129106,125898,3208,2.5
MT2741060000000,27,41060,"St. Cloud, MN MSA",2024,11,111343,107842,3501,3.1
MT2825060000000,28,25060,"Gulfport-Biloxi, MS MSA",2024,11,190423,184152,6271,3.3
MT2825620000000,28,25620,"Hattiesburg, MS MSA",2024,11,70705,68309,2396,3.4
MT2827140000000,28,27140,"Jackson, MS MSA",2024,11,286826,277550,9276,3.2
MT2916020000000,29,16020,"Cape Girardeau, MO-IL MSA",2024,11,49231,47556,1675,3.4
MT2917860000000,29,17860,"Columbia, MO MSA",2024,11,113346,109816,3530,3.1
MT2927620000000,29,27620,"Jefferson City, MO MSA",2024,11,76993,74632,2361,3.1
MT2927900000000,29,27900,"Joplin, MO-KS MSA",2024,11,98641,95169,3472,3.5
MT2928140000000,29,28140,"Kansas City, MO-KS MSA",2024,11,1204546,1160781,43765,3.6
MT2941140000000,29,41140,"St. Joseph, MO-KS MSA",2024,11,54936,52882,2054,3.7
MT2941180000000,29,41180,"St. Louis, MO-IL MSA",2024,11,1487309,1433009,54300,3.7
MT2944180000000,29,44180,"Springfield, MO MSA",2024,11,244961,236889,8072,3.3
MT3013740000000,30,13740,"Billings, MT MSA",2024,11,99448,96675,2773,2.8
MT3014580000000,30,14580,"Bozeman, MT MSA",2024,11,78221,76465,1756,2.2
MT3024500000000,30,24500,"Great Falls, MT MSA",2024,11,39666,38509,1157,2.9
MT3025740000000,30,25740,"Helena, MT MSA",2024,11,47871,46601,1270,2.7
MT3033540000000,30,33540,"Missoula, MT MSA",2024,11,74599,72473,2126,2.8
MT3124260000000,31,24260,"Grand Island, NE MSA",2024,11,43032,41790,1242,2.9
MT3130700000000,31,30700,"Lincoln, NE MSA",2024,11,195183,189978,5205,2.7
MT3136540000000,31,36540,"Omaha, NE-IA MSA",2024,11,529941,513714,16227,3.1
MT3216180000000,32,16180,"Carson City, NV MSA",2024,11,29490,28053,1437,4.9
MT3229820000000,32,29820,"Las Vegas-Henderson-North Las Vegas, NV MSA",2024,11,1224669,1150940,73729,6
MT3239900000000,32,39900,"Reno, NV MSA",2024,11,301289,286393,14896,4.9
MT3331700000000,33,31700,"Manchester-Nashua, NH MSA",2024,11,242616,235149,7467,3.1
MT3412100000000,34,12100,"Atlantic City-Hammonton, NJ MSA",2024,11,181925,170307,11618,6.4
MT3445940000000,34,45940,"Trenton-Princeton, NJ MSA",2024,11,199508,190534,8974,4.5
MT3447220000000,34,47220,"Vineland, NJ MSA",2024,11,66227,61494,4733,7.1
MT3510740000000,35,10740,"Albuquerque, NM MSA",2024,11,466665,447754,18911,4.1
MT3522140000000,35,22140,"Farmington, NM MSA",2024,11,50100,47668,2432,4.9
MT3529740000000,35,29740,"Las Cruces, NM MSA",2024,11,102396,97198,5198,5.1
MT3542140000000,35,42140,"Santa Fe, NM MSA",2024,11,74430,71487,2943,4
MT3610580000000,36,10580,"Albany-Schenectady-Troy, NY MSA",2024,11,455839,440746,15093,3.3
MT3613780000000,36,13780,"Binghamton, NY MSA",2024,11,106155,101983,4172,3.9
MT3615380000000,36,15380,"Buffalo-Cheektowaga, NY MSA",2024,11,554929,533296,21633,3.9
MT3621300000000,36,21300,"Elmira, NY MSA",2024,11,35030,33687,1343,3.8
MT3624020000000,36,24020,"Glens Falls, NY MSA",2024,11,59480,57417,2063,3.5
MT3627060000000,36,27060,"Ithaca, NY MSA",2024,11,48177,46569,1608,3.3
MT3628740000000,36,28740,"Kingston, NY MSA",2024,11,87080,84038,3042,3.5
MT3628880000000,36,28880,"Kiryas Joel-Poughkeepsie-Newburgh, NY MSA",2024,11,339235,327564,11671,3.4
MT3635620000000,36,35620,"New York-Newark-Jersey City, NY-NJ MSA",2024,11,10238608,9757889,480719,4.7
MT3640380000000,36,40380,"Rochester, NY MSA",2024,11,511694,493405,18289,3.6
MT3645060000000,36,45060,"Syracuse, NY MSA",2024,11,312028,300850,11178,3.6
MT3646540000000,36,46540,"Utica-Rome, NY MSA",2024,11,126543,121692,4851,3.8
MT3648060000000,36,48060,"Watertown-Fort Drum, NY MSA",2024,11,44816,42892,1924,4.3
MT3711700000000,37,11700,"Asheville, NC MSA",2024,11,215888,201413,14475,6.7
MT3715500000000,37,15500,"Burlington, NC MSA",2024,11,85952,82871,3081,3.6
MT3716740000000,37,16740,"Charlotte-Concord-Gastonia, NC-SC MSA",2024,11,1482752,1428293,54459,3.7
MT3720500000000,37,20500,"Durham-Chapel Hill, NC MSA",2024,11,323633,313334,10299,3.2
MT3722180000000,37,22180,"Fayetteville, NC MSA",2024,11,153399,146532,6867,4.5
MT3724140000000,37,24140,"Goldsboro, NC MSA",2024,11,51261,49391,1870,3.6
MT3724660000000,37,24660,"Greensboro-High Point, NC MSA",2024,11,370494,355682,14812,4
MT3724780000000,37,24780,"Greenville, NC MSA",2024,11,83303,79976,3327,4
MT3725860000000,37,25860,"Hickory-Lenoir-Morganton, NC MSA",2024,11,170320,164117,6203,3.6
MT3727340000000,37,27340,"Jacksonville, NC MSA",2024,11,73982,71252,2730,3.7
MT3738240000000,37,38240,"Pinehurst-Southern Pines, NC MSA",2024,11,44824,43297,1527,3.4
MT3739580000000,37,39580,"Raleigh-Cary, NC MSA",2024,11,848316,822102,26214,3.1
MT3740580000000,37,40580,"Rocky Mount, NC MSA",2024,11,63157,60122,3035,4.8
MT3748900000000,37,48900,"Wilmington, NC MSA",2024,11,223719,215881,7838,3.5
MT3749180000000,37,49180,"Winston-Salem, NC MSA",2024,11,324922,313053,11869,3.7
MT3813900000000,38,13900,"Bismarck, ND MSA",2024,11,73575,71826,1749,2.4
MT3822020000000,38,22020,"Fargo, ND-MN MSA",2024,11,154245,150567,3678,2.4
MT3824220000000,38,24220,"Grand Forks, ND-MN MSA",2024,11,57287,55851,1436,2.5
MT3833500000000,38,33500,"Minot, ND MSA",2024,11,40046,39005,1041,2.6
MT3910420000000,39,10420,"Akron, OH MSA",2024,11,359761,343089,16672,4.6
MT3915940000000,39,15940,"Canton-Massillon, OH MSA",2024,11,195610,186377,9233,4.7
MT3917140000000,39,17140,"Cincinnati, OH-KY-IN MSA",2024,11,1179351,1127887,51464,4.4
MT3917410000000,39,17410,"Cleveland, OH MSA",2024,11,1105579,1062932,42647,3.9
MT3918140000000,39,18140,"Columbus, OH MSA",2024,11,1162629,1114436,48193,4.1
MT3919430000000,39,19430,"Dayton-Kettering-Beavercreek, OH MSA",2024,11,395822,377831,17991,4.5
MT3930620000000,39,30620,"Lima, OH MSA",2024,11,47632,45448,2184,4.6
MT3931900000000,39,31900,"Mansfield, OH MSA",2024,11,53711,50964,2747,5.1
MT3941780000000,39,41780,"Sandusky, OH MSA",2024,11,58293,55160,3133,5.4
MT3944220000000,39,44220,"Springfield, OH MSA",2024,11,62204,59209,2995,4.8
MT3945780000000,39,45780,"Toledo, OH MSA",2024,11,294330,280982,13348,4.5
MT3948260000000,39,48260,"Weirton-Steubenville, WV-OH MSA",2024,11,50759,47789,2970,5.9
MT3949660000000,39,49660,"Youngstown-Warren, OH MSA",2024,11,193364,183224,10140,5.2
MT4021420000000,40,21420,"Enid, OK MSA",2024,11,28295,27409,886,3.1
MT4030020000000,40,30020,"Lawton, OK MSA",2024,11,52421,50570,1851,3.5
MT4036420000000,40,36420,"Oklahoma City, OK MSA",2024,11,775995,752085,23910,3.1
MT4046140000000,40,46140,"Tulsa, OK MSA",2024,11,526918,509806,17112,3.2
MT4110540000000,41,10540,"Albany, OR MSA",2024,11,62288,59341,2947,4.7
MT4113460000000,41,13460,"Bend, OR MSA",2024,11,133708,127985,5723,4.3
MT4118700000000,41,18700,"Corvallis, OR MSA",2024,11,49333,47444,1889,3.8
MT4121660000000,41,21660,"Eugene-Springfield, OR MSA",2024,11,188896,180640,8256,4.4
MT4124420000000,41,24420,"Grants Pass, OR MSA",2024,11,34997,32908,2089,6
MT4132780000000,41,32780,"Medford, OR MSA",2024,11,105851,100560,5291,5
MT4138900000000,41,38900,"Portland-Vancouver-Hillsboro, OR-WA MSA",2024,11,1385706,1327995,57711,4.2
MT4141420000000,41,41420,"Salem, OR MSA",2024,11,224818,215333,9485,4.2
MT4210900000000,42,10900,"Allentown-Bethlehem-Easton, PA-NJ MSA",2024,11,452090,434379,17711,3.9
MT4211020000000,42,11020,"Altoona, PA MSA",2024,11,57685,55597,2088,3.6
MT4216540000000,42,16540,"Chambersburg, PA MSA",2024,11,77466,75002,2464,3.2
MT4221500000000,42,21500,"Erie, PA MSA",2024,11,125971,120943,5028,4
MT4223900000000,42,23900,"Gettysburg, PA MSA",2024,11,51463,49833,1630,3.2
MT4225420000000,42,25420,"Harrisburg-Carlisle, PA MSA",2024,11,313882,303449,10433,3.3
MT4227780000000,42,27780,"Johnstown, PA MSA",2024,11,56188,53743,2445,4.4
MT4229540000000,42,29540,"Lancaster, PA MSA",2024,11,290890,282287,8603,3
MT4230140000000,42,30140,"Lebanon, PA MSA",2024,11,73706,71370,2336,3.2
MT4237980000000,42,37980,"Philadelphia-Camden-Wilmington, PA-NJ-DE-MD MSA",2024,11,3286247,3158291,127956,3.9
MT4238300000000,42,38300,"Pittsburgh, PA MSA",2024,11,1230902,1185256,45646,3.7
MT4239740000000,42,39740,"Reading, PA MSA",2024,11,218919,210780,8139,3.7
MT4242540000000,42,42540,"Scranton--Wilkes-Barre, PA MSA",2024,11,278676,266865,11811,4.2
MT4244300000000,42,44300,"State College, PA MSA",2024,11,75924,73722,2202,2.9
MT4248700000000,42,48700,"Williamsport, PA MSA",2024,11,52785,50655,2130,4
MT4249620000000,42,49620,"York-Hanover, PA MSA",2024,11,238926,230498,8428,3.5
MT4439300000000,44,39300,"Providence-Warwick, RI-MA MSA",2024,11,905166,863091,42075,4.6
MT4516700000000,45,16700,"Charleston-North Charleston, SC MSA",2024,11,448835,432084,16751,3.7
MT4517900000000,45,17900,"Columbia, SC MSA",2024,11,423546,405478,18068,4.3
MT4522500000000,45,22500,"Florence, SC MSA",2024,11,92682,88248,4434,4.8
MT4524860000000,45,24860,"Greenville-Anderson-Greer, SC MSA",2024,11,482334,462856,19478,4
MT4525940000000,45,25940,"Hilton Head Island-Bluffton-Port Royal, SC MSA",2024,11,99238,95229,4009,4
MT4534820000000,45,34820,"Myrtle Beach-Conway-North Myrtle Beach, SC MSA",2024,11,172140,163561,8579,5
MT4543900000000,45,43900,"Spartanburg, SC MSA",2024,11,178917,170789,8128,4.5
MT4544940000000,45,44940,"Sumter, SC MSA",2024,11,41807,39461,2346,5.6
MT4639660000000,46,39660,"Rapid City, SD MSA",2024,11,80909,79441,1468,1.8
MT4643620000000,46,43620,"Sioux Falls, SD-MN MSA",2024,11,175924,172843,3081,1.8
MT4716860000000,47,16860,"Chattanooga, TN-GA MSA",2024,11,292563,282523,10040,3.4
MT4717300000000,47,17300,"Clarksville, TN-KY MSA",2024,11,140522,134375,6147,4.4
MT4717420000000,47,17420,"Cleveland, TN MSA",2024,11,56165,53884,2281,4.1
MT4727180000000,47,27180,"Jackson, TN MSA",2024,11,78670,75354,3316,4.2
MT4727740000000,47,27740,"Johnson City, TN MSA",2024,11,97292,93476,3816,3.9
MT4728700000000,47,28700,"Kingsport-Bristol, TN-VA MSA",2024,11,133485,128345,5140,3.9
MT4728940000000,47,28940,"Knoxville, TN MSA",2024,11,456426,440866,15560,3.4
MT4732820000000,47,32820,"Memphis, TN-MS-AR MSA",2024,11,627372,599153,28219,4.5
MT4734100000000,47,34100,"Morristown, TN MSA",2024,11,54251,52204,2047,3.8
MT4734980000000,47,34980,"Nashville-Davidson--Murfreesboro--Franklin, TN MSA",2024,11,1165483,1129145,36338,3.1
MT4810180000000,48,10180,"Abilene, TX MSA",2024,11,87427,84395,3032,3.5
MT4811100000000,48,11100,"Amarillo, TX MSA",2024,11,139138,134772,4366,3.1
MT4812420000000,48,12420,"Austin-Round Rock-San Marcos, TX MSA",2024,11,1516750,1462875,53875,3.6
MT4813140000000,48,13140,"Beaumont-Port Arthur, TX MSA",2024,11,185068,174962,10106,5.5
MT4815180000000,48,15180,"Brownsville-Harlingen, TX MSA",2024,11,191520,181397,10123,5.3
MT4817780000000,48,17780,"College Station-Bryan, TX MSA",2024,11,152868,147570,5298,3.5
MT4818580000000,48,18580,"Corpus Christi, TX MSA",2024,11,211614,202358,9256,4.4
MT4819100000000,48,19100,"Dallas-Fort Worth-Arlington, TX MSA",2024,11,4519540,4341298,178242,3.9
MT4820580000000,48,20580,"Eagle Pass, TX MSA",2024,11,24383,22440,1943,8
MT4821340000000,48,21340,"El Paso, TX MSA",2024,11,418668,401095,17573,4.2
MT4826420000000,48,26420,"Houston-Pasadena-The Woodlands, TX MSA",2024,11,3864993,3693026,171967,4.4
MT4828660000000,48,28660,"Killeen-Temple, TX MSA",2024,11,202873,193581,9292,4.6
MT4829700000000,48,29700,"Laredo, TX MSA",2024,11,119864,114818,5046,4.2
MT4830980000000,48,30980,"Longview, TX MSA",2024,11,129352,122995,6357,4.9
MT4831180000000,48,31180,"Lubbock, TX MSA",2024,11,185595,178916,6679,3.6
MT4832580000000,48,32580,"McAllen-Edinburg-Mission, TX MSA",2024,11,399194,374991,24203,6.1
MT4833260000000,48,33260,"Midland, TX MSA",2024,11,104536,101415,3121,3
MT4836220000000,48,36220,"Odessa, TX MSA",2024,11,87063,83917,3146,3.6
MT4841660000000,48,41660,"San Angelo, TX MSA",2024,11,62818,60730,2088,3.3
MT4841700000000,48,41700,"San Antonio-New Braunfels, TX MSA",2024,11,1350617,1298663,51954,3.8
MT4843300000000,48,43300,"Sherman-Denison, TX MSA",2024,11,71897,69082,2815,3.9
MT4845500000000,48,45500,"Texarkana, TX-AR MSA",2024,11,62392,59754,2638,4.2
MT4846340000000,48,46340,"Tyler, TX MSA",2024,11,119024,114477,4547,3.8
MT4847020000000,48,47020,"Victoria, TX MSA",2024,11,45304,43426,1878,4.1
MT4847380000000,48,47380,"Waco, TX MSA",2024,11,147791,142055,5736,3.9
MT4848660000000,48,48660,"Wichita Falls, TX MSA",2024,11,67092,64510,2582,3.8
MT4930860000000,49,30860,"Logan, UT-ID MSA",2024,11,80655,78292,2363,2.9
MT4936260000000,49,36260,"Ogden, UT MSA",2024,11,354105,343190,10915,3.1
MT4939340000000,49,39340,"Provo-Orem-Lehi, UT MSA",2024,11,371983,359518,12465,3.4
MT4941100000000,49,41100,"St. George, UT MSA",2024,11,95208,91965,3243,3.4
MT4941620000000,49,41620,"Salt Lake City-Murray, UT MSA",2024,11,739952,715609,24343,3.3
MT5015540000000,50,15540,"Burlington-South Burlington, VT MSA",2024,11,131962,129051,2911,2.2
MT5113980000000,51,13980,"Blacksburg-Christiansburg-Radford, VA MSA",2024,11,93140,90099,3041,3.3
MT5116820000000,51,16820,"Charlottesville, VA MSA",2024,11,121160,118033,3127,2.6
MT5125500000000,51,25500,"Harrisonburg, VA MSA",2024,11,72036,70000,2036,2.8
MT5131340000000,51,31340,"Lynchburg, VA MSA",2024,11,127017,122811,4206,3.3
MT5140060000000,51,40060,"Richmond, VA MSA",2024,11,730156,708064,22092,3
MT5140220000000,51,40220,"Roanoke, VA MSA",2024,11,159083,154340,4743,3
MT5144420000000,51,44420,"Staunton-Stuarts Draft, VA MSA",2024,11,65242,63502,1740,2.7
MT5147260000000,51,47260,"Virginia Beach-Chesapeake-Norfolk, VA-NC MSA",2024,11,884450,856879,27571,3.1
MT5149020000000,51,49020,"Winchester, VA-WV MSA",2024,11,77645,75452,2193,2.8
MT5313380000000,53,13380,"Bellingham, WA MSA",2024,11,112963,107787,5176,4.6
MT5314740000000,53,14740,"Bremerton-Silverdale-Port Orchard, WA MSA",2024,11,121348,115857,5491,4.5
MT5328420000000,53,28420,"Kennewick-Richland, WA MSA",2024,11,148311,140976,7335,4.9
MT5331020000000,53,31020,"Longview-Kelso, WA MSA",2024,11,46813,44315,2498,5.3
MT5334580000000,53,34580,"Mount Vernon-Anacortes, WA MSA",2024,11,59528,56535,2993,5
MT5336500000000,53,36500,"Olympia-Lacey-Tumwater, WA MSA",2024,11,143294,136701,6593,4.6
MT5342660000000,53,42660,"Seattle-Tacoma-Bellevue, WA MSA",2024,11,2344735,2249819,94916,4
MT5344060000000,53,44060,"Spokane-Spokane Valley, WA MSA",2024,11,278911,265756,13155,4.7
MT5347460000000,53,47460,"Walla Walla, WA MSA",2024,11,29267,28072,1195,4.1
MT5348300000000,53,48300,"Wenatchee-East Wenatchee, WA MSA",2024,11,61716,58737,2979,4.8
MT5349420000000,53,49420,"Yakima, WA MSA",2024,11,124257,116451,7806,6.3
MT5413220000000,54,13220,"Beckley, WV MSA",2024,11,45979,44129,1850,4
MT5416620000000,54,16620,"Charleston, WV MSA",2024,11,90149,86494,3655,4.1
MT5426580000000,54,26580,"Huntington-Ashland, WV-KY-OH MSA",2024,11,157496,149479,8017,5.1
MT5434060000000,54,34060,"Morgantown, WV MSA",2024,11,71052,68651,2401,3.4
MT5437620000000,54,37620,"Parkersburg-Vienna, WV MSA",2024,11,39069,37423,1646,4.2
MT5448540000000,54,48540,"Wheeling, WV-OH MSA",2024,11,59432,56527,2905,4.9
MT5511540000000,55,11540,"Appleton, WI MSA",2024,11,138187,134572,3615,2.6
MT5520740000000,55,20740,"Eau Claire, WI MSA",2024,11,96953,94015,2938,3
MT5522540000000,55,22540,"Fond du Lac, WI MSA",2024,11,55252,53581,1671,3
MT5524580000000,55,24580,"Green Bay, WI MSA",2024,11,181399,176397,5002,2.8
MT5527500000000,55,27500,"Janesville-Beloit, WI MSA",2024,11,87785,84895,2890,3.3
MT5528450000000,55,28450,"Kenosha, WI MSA",2024,11,96238,93041,3197,3.3
MT5529100000000,55,29100,"La Crosse-Onalaska, WI-MN MSA",2024,11,91542,88988,2554,2.8
MT5531540000000,55,31540,"Madison, WI MSA",2024,11,412635,402329,10306,2.5
MT5533340000000,55,33340,"Milwaukee-Waukesha, WI MSA",2024,11,825698,798053,27645,3.3
MT5536780000000,55,36780,"Oshkosh-Neenah, WI MSA",2024,11,93410,90823,2587,2.8
MT5539540000000,55,39540,"Racine-Mount Pleasant, WI MSA",2024,11,101759,98058,3701,3.6
MT5543100000000,55,43100,"Sheboygan, WI MSA",2024,11,64270,62592,1678,2.6
MT5548140000000,55,48140,"Wausau, WI MSA",2024,11,75215,73214,2001,2.7
MT5616220000000,56,16220,"Casper, WY MSA",2024,11,42374,40848,1526,3.6
MT5616940000000,56,16940,"Cheyenne, WY MSA",2024,11,49275,47476,1799,3.7
MT7210380000000,72,10380,"Aguadilla, PR MSA",2024,11,91182,84755,6427,7
MT7211640000000,72,11640,"Arecibo, PR MSA",2024,11,67978,64437,3541,5.2
MT7225020000000,72,25020,"Guayama, PR MSA",2024,11,19216,17420,1796,9.3
MT7232420000000,72,32420,"Mayaguez, PR MSA",2024,11,67609,62576,5033,7.4
MT7238660000000,72,38660,"Ponce, PR MSA",2024,11,90105,82412,7693,8.5
MT7241980000000,72,41980,"San Juan-Bayamon-Caguas, PR MSA",2024,11,824044,786064,37980,4.6
MT0111500000000,1,11500,"Anniston-Oxford, AL MSA",2024,12,49950,48178,1772,3.5
MT0112220000000,1,12220,"Auburn-Opelika, AL MSA",2024,12,96818,93779,3039,3.1
MT0113820000000,1,13820,"Birmingham, AL MSA",2024,12,572532,554668,17864,3.1
MT0119300000000,1,19300,"Daphne-Fairhope-Foley, AL MSA",2024,12,118057,114585,3472,2.9
MT0119460000000,1,19460,"Decatur, AL MSA",2024,12,76852,74630,2222,2.9
MT0120020000000,1,20020,"Dothan, AL MSA",2024,12,68039,65726,2313,3.4
MT0122520000000,1,22520,"Florence-Muscle Shoals, AL MSA",2024,12,69725,67259,2466,3.5
MT0123460000000,1,23460,"Gadsden, AL MSA",2024,12,42324,40782,1542,3.6
MT0126620000000,1,26620,"Huntsville, AL MSA",2024,12,279098,271286,7812,2.8
MT0133660000000,1,33660,"Mobile, AL MSA",2024,12,188047,180627,7420,3.9
MT0133860000000,1,33860,"Montgomery, AL MSA",2024,12,179618,173662,5956,3.3
MT0146220000000,1,46220,"Tuscaloosa, AL MSA",2024,12,127144,122597,4547,3.6
MT0211260000000,2,11260,"Anchorage, AK MSA",2024,12,201985,193359,8626,4.3
MT0221820000000,2,21820,"Fairbanks-College, AK MSA",2024,12,45988,44073,1915,4.2
MT0422380000000,4,22380,"Flagstaff, AZ MSA",2024,12,75977,72828,3149,4.1
MT0429420000000,4,29420,"Lake Havasu City-Kingman, AZ MSA",2024,12,88118,84034,4084,4.6
MT0438060000000,4,38060,"Phoenix-Mesa-Chandler, AZ MSA",2024,12,2721103,2629029,92074,3.4
MT0439150000000,4,39150,"Prescott Valley-Prescott, AZ MSA",2024,12,107129,103291,3838,3.6
MT0443420000000,4,43420,"Sierra Vista-Douglas, AZ MSA",2024,12,47741,45613,2128,4.5
MT0446060000000,4,46060,"Tucson, AZ MSA",2024,12,494824,476146,18678,3.8
MT0449740000000,4,49740,"Yuma, AZ MSA",2024,12,98908,86401,12507,12.6
MT0522220000000,5,22220,"Fayetteville-Springdale-Rogers, AR MSA",2024,12,309570,301038,8532,2.8
MT0522900000000,5,22900,"Fort Smith, AR-OK MSA",2024,12,102064,98506,3558,3.5
MT0526300000000,5,26300,"Hot Springs, AR MSA",2024,12,43600,41980,1620,3.7
MT0527860000000,5,27860,"Jonesboro, AR MSA",2024,12,66667,64465,2202,3.3
MT0530780000000,5,30780,"Little Rock-North Little Rock-Conway, AR MSA",2024,12,382930,370279,12651,3.3
MT0612540000000,6,12540,"Bakersfield-Delano, CA MSA",2024,12,411411,375745,35666,8.7
MT0617020000000,6,17020,"Chico, CA MSA",2024,12,91771,86206,5565,6.1
MT0620940000000,6,20940,"El Centro, CA MSA",2024,12,73384,59698,13686,18.6
MT0623420000000,6,23420,"Fresno, CA MSA",2024,12,541746,498774,42972,7.9
MT0625260000000,6,25260,"Hanford-Corcoran, CA MSA",2024,12,58775,53509,5266,9
MT0631080000000,6,31080,"Los Angeles-Long Beach-Anaheim, CA MSA",2024,12,6750229,6370947,379282,5.6
MT0632900000000,6,32900,"Merced, CA MSA",2024,12,121486,109548,11938,9.8
MT0633700000000,6,33700,"Modesto, CA MSA",2024,12,256412,238480,17932,7
MT0634900000000,6,34900,"Napa, CA MSA",2024,12,75302,72287,3015,4
MT0637100000000,6,37100,"Oxnard-Thousand Oaks-Ventura, CA MSA",2024,12,420797,400903,19894,4.7
MT0639820000000,6,39820,"Redding, CA MSA",2024,12,79902,75574,4328,5.4
MT0640140000000,6,40140,"Riverside-San Bernardino-Ontario, CA MSA",2024,12,2220177,2101466,118711,5.3
MT0640900000000,6,40900,"Sacramento-Roseville-Folsom, CA MSA",2024,12,1185313,1128233,57080,4.8
MT0641500000000,6,41500,"Salinas, CA MSA",2024,12,223037,206914,16123,7.2
MT0641740000000,6,41740,"San Diego-Chula Vista-Carlsbad, CA MSA",2024,12,1651885,1578076,73809,4.5
MT0641860000000,6,41860,"San Francisco-Oakland-Fremont, CA MSA",2024,12,2499870,2391785,108085,4.3
MT0641940000000,6,41940,"San Jose-Sunnyvale-Santa Clara, CA MSA",2024,12,1058448,1012830,45618,4.3
MT0642020000000,6,42020,"San Luis Obispo-Paso Robles, CA MSA",2024,12,132245,126660,5585,4.2
MT0642100000000,6,42100,"Santa Cruz-Watsonville, CA MSA",2024,12,136468,128215,8253,6
MT0642200000000,6,42200,"Santa Maria-Santa Barbara, CA MSA",2024,12,221837,211771,10066,4.5
MT0642220000000,6,42220,"Santa Rosa-Petaluma, CA MSA",2024,12,246308,235799,10509,4.3
MT0644700000000,6,44700,"Stockton-Lodi, CA MSA",2024,12,371395,346989,24406,6.6
MT0646700000000,6,46700,"Vallejo, CA MSA",2024,12,216291,205075,11216,5.2
MT0647300000000,6,47300,"Visalia, CA MSA",2024,12,221854,198859,22995,10.4
MT0649700000000,6,49700,"Yuba City, CA MSA",2024,12,81937,75488,6449,7.9
MT0814500000000,8,14500,"Boulder, CO MSA",2024,12,193838,184992,8846,4.6
MT0817820000000,8,17820,"Colorado Springs, CO MSA",2024,12,398189,379703,18486,4.6
MT0819740000000,8,19740,"Denver-Aurora-Centennial, CO MSA",2024,12,1785716,1703713,82003,4.6
MT0822660000000,8,22660,"Fort Collins-Loveland, CO MSA",2024,12,207991,198757,9234,4.4
MT0824300000000,8,24300,"Grand Junction, CO MSA",2024,12,80606,76748,3858,4.8
MT0824540000000,8,24540,"Greeley, CO MSA",2024,12,178471,169745,8726,4.9
MT0839380000000,8,39380,"Pueblo, CO MSA",2024,12,73887,69209,4678,6.3
MT0914860000000,9,14860,"Bridgeport-Stamford-Danbury, CT MSA",2024,12,519390,503427,15963,3.1
MT0925540000000,9,25540,"Hartford-West Hartford-East Hartford, CT MSA",2024,12,616796,597027,19769,3.2
MT0935300000000,9,35300,"New Haven, CT MSA",2024,12,317978,307871,10107,3.2
MT0935980000000,9,35980,"Norwich-New London-Willimantic, CT MSA",2024,12,144210,139721,4489,3.1
MT0947930000000,9,47930,"Waterbury-Shelton, CT MSA",2024,12,242434,233547,8887,3.7
MT1020100000000,10,20100,"Dover, DE MSA",2024,12,85261,81888,3373,4
MT1147900000000,11,47900,"Washington-Arlington-Alexandria, DC-VA-MD-WV MSA",2024,12,3569542,3459010,110532,3.1
MT1215980000000,12,15980,"Cape Coral-Fort Myers, FL MSA",2024,12,375060,361359,13701,3.7
MT1218880000000,12,18880,"Crestview-Fort Walton Beach-Destin, FL MSA",2024,12,143945,139352,4593,3.2
MT1219660000000,12,19660,"Deltona-Daytona Beach-Ormond Beach, FL MSA",2024,12,322864,309956,12908,4
MT1223540000000,12,23540,"Gainesville, FL MSA",2024,12,170399,163820,6579,3.9
MT1226140000000,12,26140,"Homosassa Springs, FL MSA",2024,12,54028,51235,2793,5.2
MT1227260000000,12,27260,"Jacksonville, FL MSA",2024,12,857586,827345,30241,3.5
MT1229460000000,12,29460,"Lakeland-Winter Haven, FL MSA",2024,12,359426,344093,15333,4.3
MT1233100000000,12,33100,"Miami-Fort Lauderdale-West Palm Beach, FL MSA",2024,12,3308263,3210722,97541,2.9
MT1234940000000,12,34940,"Naples-Marco Island, FL MSA",2024,12,185688,179322,6366,3.4
MT1235840000000,12,35840,"North Port-Bradenton-Sarasota, FL MSA",2024,12,398849,384052,14797,3.7
MT1236100000000,12,36100,"Ocala, FL MSA",2024,12,159477,152622,6855,4.3
MT1236740000000,12,36740,"Orlando-Kissimmee-Sanford, FL MSA",2024,12,1537944,1486422,51522,3.4
MT1237340000000,12,37340,"Palm Bay-Melbourne-Titusville, FL MSA",2024,12,306288,295265,11023,3.6
MT1237460000000,12,37460,"Panama City-Panama City Beach, FL MSA",2024,12,102252,98750,3502,3.4
MT1237860000000,12,37860,"Pensacola-Ferry Pass-Brent, FL MSA",2024,12,240386,231656,8730,3.6
MT1238940000000,12,38940,"Port St. Lucie, FL MSA",2024,12,241919,232561,9358,3.9
MT1239460000000,12,39460,"Punta Gorda, FL MSA",2024,12,77321,73940,3381,4.4
MT1242680000000,12,42680,"Sebastian-Vero Beach-West Vero Corridor, FL MSA",2024,12,67744,64916,2828,4.2
MT1242700000000,12,42700,"Sebring, FL MSA",2024,12,36810,34977,1833,5
MT1245220000000,12,45220,"Tallahassee, FL MSA",2024,12,209327,201855,7472,3.6
MT1245300000000,12,45300,"Tampa-St. Petersburg-Clearwater, FL MSA",2024,12,1702293,1640991,61302,3.6
MT1248680000000,12,48680,"Wildwood-The Villages, FL MSA",2024,12,34370,32405,1965,5.7
MT1310500000000,13,10500,"Albany, GA MSA",2024,12,62359,59718,2641,4.2
MT1312020000000,13,12020,"Athens-Clarke County, GA MSA",2024,12,108826,105161,3665,3.4
MT1312060000000,13,12060,"Atlanta-Sandy Springs-Roswell, GA MSA",2024,12,3306161,3189086,117075,3.5
MT1312260000000,13,12260,"Augusta-Richmond County, GA-SC MSA",2024,12,268228,255867,12361,4.6
MT1315260000000,13,15260,"Brunswick-St. Simons, GA MSA",2024,12,55949,54181,1768,3.2
MT1317980000000,13,17980,"Columbus, GA-AL MSA",2024,12,128794,123449,5345,4.2
MT1319140000000,13,19140,"Dalton, GA MSA",2024,12,68117,65386,2731,4
MT1323580000000,13,23580,"Gainesville, GA MSA",2024,12,109280,106138,3142,2.9
MT1325980000000,13,25980,"Hinesville, GA MSA",2024,12,31401,30160,1241,4
MT1331420000000,13,31420,"Macon-Bibb County, GA MSA",2024,12,97157,92947,4210,4.3
MT1340660000000,13,40660,"Rome, GA MSA",2024,12,48055,46326,1729,3.6
MT1342340000000,13,42340,"Savannah, GA MSA",2024,12,209848,203341,6507,3.1
MT1346660000000,13,46660,"Valdosta, GA MSA",2024,12,61843,59337,2506,4.1
MT1347580000000,13,47580,"Warner Robins, GA MSA",2024,12,90301,87422,2879,3.2
MT1527980000000,15,27980,"Kahului-Wailuku, HI MSA",2024,12,81392,78215,3177,3.9
MT1546520000000,15,46520,"Urban Honolulu, HI MSA",2024,12,472526,458827,13699,2.9
MT1614260000000,16,14260,"Boise City, ID MSA",2024,12,451425,435266,16159,3.6
MT1617660000000,16,17660,"Coeur d'Alene, ID MSA",2024,12,90911,86814,4097,4.5
MT1626820000000,16,26820,"Idaho Falls, ID MSA",2024,12,85032,82312,2720,3.2
MT1630300000000,16,30300,"Lewiston, ID-WA MSA",2024,12,31029,29880,1149,3.7
MT1638540000000,16,38540,"Pocatello, ID MSA",2024,12,41190,39492,1698,4.1
MT1646300000000,16,46300,"Twin Falls, ID MSA",2024,12,60583,58383,2200,3.6
MT1714010000000,17,14010,"Bloomington, IL MSA",2024,12,96054,92408,3646,3.8
MT1716580000000,17,16580,"Champaign-Urbana, IL MSA",2024,12,125653,120738,4915,3.9
MT1716980000000,17,16980,"Chicago-Naperville-Elgin, IL-IN MSA",2024,12,5046355,4787064,259291,5.1
MT1719340000000,17,19340,"Davenport-Moline-Rock Island, IA-IL MSA",2024,12,189732,180429,9303,4.9
MT1719500000000,17,19500,"Decatur, IL MSA",2024,12,44456,41948,2508,5.6
MT1728100000000,17,28100,"Kankakee, IL MSA",2024,12,51186,48433,2753,5.4
MT1737900000000,17,37900,"Peoria, IL MSA",2024,12,178205,169863,8342,4.7
MT1740420000000,17,40420,"Rockford, IL MSA",2024,12,160624,152098,8526,5.3
MT1744100000000,17,44100,"Springfield, IL MSA",2024,12,103886,99610,4276,4.1
MT1814020000000,18,14020,"Bloomington, IN MSA",2024,12,86055,82648,3407,4
MT1818020000000,18,18020,"Columbus, IN MSA",2024,12,39952,38259,1693,4.2
MT1821140000000,18,21140,"Elkhart-Goshen, IN MSA",2024,12,98529,93658,4871,4.9
MT1821780000000,18,21780,"Evansville, IN MSA",2024,12,136642,131107,5535,4.1
MT1823060000000,18,23060,"Fort Wayne, IN MSA",2024,12,233685,224228,9457,4
MT1826900000000,18,26900,"Indianapolis-Carmel-Greenwood, IN MSA",2024,12,1150205,1103983,46222,4
MT1829020000000,18,29020,"Kokomo, IN MSA",2024,12,36657,34348,2309,6.3
MT1829200000000,18,29200,"Lafayette-West Lafayette, IN MSA",2024,12,120455,115664,4791,4
MT1833140000000,18,33140,"Michigan City-La Porte, IN MSA",2024,12,51909,49315,2594,5
MT1834620000000,18,34620,"Muncie, IN MSA",2024,12,53360,50777,2583,4.8
MT1843780000000,18,43780,"South Bend-Mishawaka, IN-MI MSA",2024,12,156509,148571,7938,5.1
MT1845460000000,18,45460,"Terre Haute, IN MSA",2024,12,78204,74579,3625,4.6
MT1911180000000,19,11180,"Ames, IA MSA",2024,12,69770,68026,1744,2.5
MT1916300000000,19,16300,"Cedar Rapids, IA MSA",2024,12,146005,141073,4932,3.4
MT1919780000000,19,19780,"Des Moines-West Des Moines, IA MSA",2024,12,414027,400851,13176,3.2
MT1920220000000,19,20220,"Dubuque, IA MSA",2024,12,53521,51803,1718,3.2
MT1926980000000,19,26980,"Iowa City, IA MSA",2024,12,100560,98110,2450,2.4
MT1943580000000,19,43580,"Sioux City, IA-NE-SD MSA",2024,12,76483,74131,2352,3.1
MT1947940000000,19,47940,"Waterloo-Cedar Falls, IA MSA",2024,12,88542,85061,3481,3.9
MT2029940000000,20,29940,"Lawrence, KS MSA",2024,12,71868,69415,2453,3.4
MT2031740000000,20,31740,"Manhattan, KS MSA",2024,12,64917,62634,2283,3.5
MT2045820000000,20,45820,"Topeka, KS MSA",2024,12,119407,114819,4588,3.8
MT2048620000000,20,48620,"Wichita, KS MSA",2024,12,338674,324412,14262,4.2
MT2114540000000,21,14540,"Bowling Green, KY MSA",2024,12,93891,89245,4646,4.9
MT2121060000000,21,21060,"Elizabethtown, KY MSA",2024,12,55955,52842,3113,5.6
MT2130460000000,21,30460,"Lexington-Fayette, KY MSA",2024,12,279494,267039,12455,4.5
MT2131140000000,21,31140,"Louisville/Jefferson County, KY-IN MSA",2024,12,704156,670471,33685,4.8
MT2136980000000,21,36980,"Owensboro, KY MSA",2024,12,52880,50061,2819,5.3
MT2137140000000,21,37140,"Paducah, KY-IL MSA",2024,12,46309,43833,2476,5.3
MT2210780000000,22,10780,"Alexandria, LA MSA",2024,12,64536,61756,2780,4.3
MT2212940000000,22,12940,"Baton Rouge, LA MSA",2024,12,428287,409874,18413,4.3
MT2225220000000,22,25220,"Hammond, LA MSA",2024,12,61127,57991,3136,5.1
MT2226380000000,22,26380,"Houma-Bayou Cane-Thibodaux, LA MSA",2024,12,88271,84650,3621,4.1
MT2229180000000,22,29180,"Lafayette, LA MSA",2024,12,198245,190259,7986,4
MT2229340000000,22,29340,"Lake Charles, LA MSA",2024,12,98222,93425,4797,4.9
MT2233740000000,22,33740,"Monroe, LA MSA",2024,12,95945,90918,5027,5.2
MT2235380000000,22,35380,"New Orleans-Metairie, LA MSA",2024,12,468511,447153,21358,4.6
MT2243340000000,22,43340,"Shreveport-Bossier City, LA MSA",2024,12,168008,160272,7736,4.6
MT2243640000000,22,43640,"Slidell-Mandeville-Covington, LA MSA",2024,12,129712,124383,5329,4.1
MT2312620000000,23,12620,"Bangor, ME MSA",2024,12,76481,73587,2894,3.8
MT2330340000000,23,30340,"Lewiston-Auburn, ME MSA",2024,12,55793,53810,1983,3.6
MT2338860000000,23,38860,"Portland-South Portland, ME MSA",2024,12,317122,307780,9342,2.9
MT2412580000000,24,12580,"Baltimore-Columbia-Towson, MD MSA",2024,12,1498395,1450585,47810,3.2
MT2425180000000,24,25180,"Hagerstown-Martinsburg, MD-WV MSA",2024,12,144178,139333,4845,3.4
MT2430500000000,24,30500,"Lexington Park, MD MSA",2024,12,109975,106907,3068,2.8
MT2441540000000,24,41540,"Salisbury, MD MSA",2024,12,64508,62232,2276,3.5
MT2511200000000,25,11200,"Amherst Town-Northampton, MA MSA",2024,12,86188,82749,3439,4
MT2512700000000,25,12700,"Barnstable Town, MA MSA",2024,12,119248,113397,5851,4.9
MT2514460000000,25,14460,"Boston-Cambridge-Newton, MA-NH MSA",2024,12,2846523,2735846,110677,3.9
MT2538340000000,25,38340,"Pittsfield, MA MSA",2024,12,64381,61675,2706,4.2
MT2544140000000,25,44140,"Springfield, MA MSA",2024,12,226467,214581,11886,5.2
MT2549340000000,25,49340,"Worcester, MA MSA",2024,12,469781,449394,20387,4.3
MT2611460000000,26,11460,"Ann Arbor, MI MSA",2024,12,210303,201696,8607,4.1
MT2612980000000,26,12980,"Battle Creek, MI MSA",2024,12,64967,61277,3690,5.7
MT2613020000000,26,13020,"Bay City, MI MSA",2024,12,50903,47867,3036,6
MT2619820000000,26,19820,"Detroit-Warren-Dearborn, MI MSA",2024,12,2176055,2066749,109306,5
MT2622420000000,26,22420,"Flint, MI MSA",2024,12,191700,179868,11832,6.2
MT2624340000000,26,24340,"Grand Rapids-Wyoming-Kentwood, MI MSA",2024,12,635552,607696,27856,4.4
MT2627100000000,26,27100,"Jackson, MI MSA",2024,12,75648,71613,4035,5.3
MT2628020000000,26,28020,"Kalamazoo-Portage, MI MSA",2024,12,142052,135579,6473,4.6
MT2629620000000,26,29620,"Lansing-East Lansing, MI MSA",2024,12,259069,246915,12154,4.7
MT2633220000000,26,33220,"Midland, MI MSA",2024,12,43557,41429,2128,4.9
MT2633780000000,26,33780,"Monroe, MI MSA",2024,12,80245,75487,4758,5.9
MT2634740000000,26,34740,"Muskegon-Norton Shores, MI MSA",2024,12,86487,81553,4934,5.7
MT2635660000000,26,35660,"Niles, MI MSA",2024,12,77988,73668,4320,5.5
MT2640980000000,26,40980,"Saginaw, MI MSA",2024,12,85990,80468,5522,6.4
MT2645900000000,26,45900,"Traverse City, MI MSA",2024,12,83428,79509,3919,4.7
MT2720260000000,27,20260,"Duluth, MN-WI MSA",2024,12,139851,135008,4843,3.5
MT2731860000000,27,31860,"Mankato, MN MSA",2024,12,60299,58762,1537,2.5
MT2733460000000,27,33460,"Minneapolis-St. Paul-Bloomington, MN-WI MSA",2024,12,2072280,2013349,58931,2.8
MT2740340000000,27,40340,"Rochester, MN MSA",2024,12,129095,125887,3208,2.5
MT2741060000000,27,41060,"St. Cloud, MN MSA",2024,12,111328,107823,3505,3.1
MT2825060000000,28,25060,"Gulfport-Biloxi, MS MSA",2024,12,190324,184077,6247,3.3
MT2825620000000,28,25620,"Hattiesburg, MS MSA",2024,12,70698,68314,2384,3.4
MT2827140000000,28,27140,"Jackson, MS MSA",2024,12,286635,277411,9224,3.2
MT2916020000000,29,16020,"Cape Girardeau, MO-IL MSA",2024,12,49237,47558,1679,3.4
MT2917860000000,29,17860,"Columbia, MO MSA",2024,12,113327,109790,3537,3.1
MT2927620000000,29,27620,"Jefferson City, MO MSA",2024,12,76981,74618,2363,3.1
MT2927900000000,29,27900,"Joplin, MO-KS MSA",2024,12,98621,95142,3479,3.5
MT2928140000000,29,28140,"Kansas City, MO-KS MSA",2024,12,1204431,1160659,43772,3.6
MT2941140000000,29,41140,"St. Joseph, MO-KS MSA",2024,12,54927,52869,2058,3.7
MT2941180000000,29,41180,"St. Louis, MO-IL MSA",2024,12,1487391,1433005,54386,3.7
MT2944180000000,29,44180,"Springfield, MO MSA",2024,12,244934,236846,8088,3.3
MT3013740000000,30,13740,"Billings, MT MSA",2024,12,99457,96679,2778,2.8
MT3014580000000,30,14580,"Bozeman, MT MSA",2024,12,78216,76458,1758,2.2
MT3024500000000,30,24500,"Great Falls, MT MSA",2024,12,39686,38529,1157,2.9
MT3025740000000,30,25740,"Helena, MT MSA",2024,12,47881,46609,1272,2.7
MT3033540000000,30,33540,"Missoula, MT MSA",2024,12,74600,72473,2127,2.9
MT3124260000000,31,24260,"Grand Island, NE MSA",2024,12,43035,41794,1241,2.9
MT3130700000000,31,30700,"Lincoln, NE MSA",2024,12,195143,189949,5194,2.7
MT3136540000000,31,36540,"Omaha, NE-IA MSA",2024,12,529839,513640,16199,3.1
MT3216180000000,32,16180,"Carson City, NV MSA",2024,12,29483,28048,1435,4.9
MT3229820000000,32,29820,"Las Vegas-Henderson-North Las Vegas, NV MSA",2024,12,1224508,1150870,73638,6
MT3239900000000,32,39900,"Reno, NV MSA",2024,12,301212,286320,14892,4.9
MT3331700000000,33,31700,"Manchester-Nashua, NH MSA",2024,12,242540,235091,7449,3.1
MT3412100000000,34,12100,"Atlantic City-Hammonton, NJ MSA",2024,12,181914,170315,11599,6.4
MT3445940000000,34,45940,"Trenton-Princeton, NJ MSA",2024,12,199509,190539,8970,4.5
MT3447220000000,34,47220,"Vineland, NJ MSA",2024,12,66203,61476,4727,7.1
MT3510740000000,35,10740,"Albuquerque, NM MSA",2024,12,466586,447712,18874,4
MT3522140000000,35,22140,"Farmington, NM MSA",2024,12,50089,47663,2426,4.8
MT3529740000000,35,29740,"Las Cruces, NM MSA",2024,12,102403,97210,5193,5.1
MT3542140000000,35,42140,"Santa Fe, NM MSA",2024,12,74410,71477,2933,3.9
MT3610580000000,36,10580,"Albany-Schenectady-Troy, NY MSA",2024,12,455860,440752,15108,3.3
MT3613780000000,36,13780,"Binghamton, NY MSA",2024,12,106164,101988,4176,3.9
MT3615380000000,36,15380,"Buffalo-Cheektowaga, NY MSA",2024,12,555054,533398,21656,3.9
MT3621300000000,36,21300,"Elmira, NY MSA",2024,12,35029,33687,1342,3.8
MT3624020000000,36,24020,"Glens Falls, NY MSA",2024,12,59483,57419,2064,3.5
MT3627060000000,36,27060,"Ithaca, NY MSA",2024,12,48188,46577,1611,3.3
MT3628740000000,36,28740,"Kingston, NY MSA",2024,12,87082,84035,3047,3.5
MT3628880000000,36,28880,"Kiryas Joel-Poughkeepsie-Newburgh, NY MSA",2024,12,339231,327544,11687,3.4
MT3635620000000,36,35620,"New York-Newark-Jersey City, NY-NJ MSA",2024,12,10237011,9756826,480185,4.7
MT3640380000000,36,40380,"Rochester, NY MSA",2024,12,511787,493470,18317,3.6
MT3645060000000,36,45060,"Syracuse, NY MSA",2024,12,312003,300814,11189,3.6
MT3646540000000,36,46540,"Utica-Rome, NY MSA",2024,12,126557,121706,4851,3.8
MT3648060000000,36,48060,"Watertown-Fort Drum, NY MSA",2024,12,44820,42893,1927,4.3
MT3711700000000,37,11700,"Asheville, NC MSA",2024,12,214590,202619,11971,5.6
MT3715500000000,37,15500,"Burlington, NC MSA",2024,12,85966,82883,3083,3.6
MT3716740000000,37,16740,"Charlotte-Concord-Gastonia, NC-SC MSA",2024,12,1482784,1428344,54440,3.7
MT3720500000000,37,20500,"Durham-Chapel Hill, NC MSA",2024,12,323651,313338,10313,3.2
MT3722180000000,37,22180,"Fayetteville, NC MSA",2024,12,153403,146529,6874,4.5
MT3724140000000,37,24140,"Goldsboro, NC MSA",2024,12,51249,49379,1870,3.6
MT3724660000000,37,24660,"Greensboro-High Point, NC MSA",2024,12,370575,355743,14832,4
MT3724780000000,37,24780,"Greenville, NC MSA",2024,12,83328,80000,3328,4
MT3725860000000,37,25860,"Hickory-Lenoir-Morganton, NC MSA",2024,12,170342,164137,6205,3.6
MT3727340000000,37,27340,"Jacksonville, NC MSA",2024,12,74000,71267,2733,3.7
MT3738240000000,37,38240,"Pinehurst-Southern Pines, NC MSA",2024,12,44831,43304,1527,3.4
MT3739580000000,37,39580,"Raleigh-Cary, NC MSA",2024,12,848319,822077,26242,3.1
MT3740580000000,37,40580,"Rocky Mount, NC MSA",2024,12,63187,60154,3033,4.8
MT3748900000000,37,48900,"Wilmington, NC MSA",2024,12,223736,215897,7839,3.5
MT3749180000000,37,49180,"Winston-Salem, NC MSA",2024,12,324935,313060,11875,3.7
MT3813900000000,38,13900,"Bismarck, ND MSA",2024,12,73570,71823,1747,2.4
MT3822020000000,38,22020,"Fargo, ND-MN MSA",2024,12,154248,150573,3675,2.4
MT3824220000000,38,24220,"Grand Forks, ND-MN MSA",2024,12,57270,55836,1434,2.5
MT3833500000000,38,33500,"Minot, ND MSA",2024,12,40052,39014,1038,2.6
MT3910420000000,39,10420,"Akron, OH MSA",2024,12,359815,343136,16679,4.6
MT3915940000000,39,15940,"Canton-Massillon, OH MSA",2024,12,195611,186380,9231,4.7
MT3917140000000,39,17140,"Cincinnati, OH-KY-IN MSA",2024,12,1179137,1127672,51465,4.4
MT3917410000000,39,17410,"Cleveland, OH MSA",2024,12,1105165,1062473,42692,3.9
MT3918140000000,39,18140,"Columbus, OH MSA",2024,12,1162482,1114273,48209,4.1
MT3919430000000,39,19430,"Dayton-Kettering-Beavercreek, OH MSA",2024,12,395805,377811,17994,4.5
MT3930620000000,39,30620,"Lima, OH MSA",2024,12,47641,45456,2185,4.6
MT3931900000000,39,31900,"Mansfield, OH MSA",2024,12,53714,50968,2746,5.1
MT3941780000000,39,41780,"Sandusky, OH MSA",2024,12,58295,55159,3136,5.4
MT3944220000000,39,44220,"Springfield, OH MSA",2024,12,62214,59221,2993,4.8
MT3945780000000,39,45780,"Toledo, OH MSA",2024,12,294386,281002,13384,4.5
MT3948260000000,39,48260,"Weirton-Steubenville, WV-OH MSA",2024,12,50791,47821,2970,5.8
MT3949660000000,39,49660,"Youngstown-Warren, OH MSA",2024,12,193363,183215,10148,5.2
MT4021420000000,40,21420,"Enid, OK MSA",2024,12,28296,27409,887,3.1
MT4030020000000,40,30020,"Lawton, OK MSA",2024,12,52419,50567,1852,3.5
MT4036420000000,40,36420,"Oklahoma City, OK MSA",2024,12,775894,751995,23899,3.1
MT4046140000000,40,46140,"Tulsa, OK MSA",2024,12,526822,509712,17110,3.2
MT4110540000000,41,10540,"Albany, OR MSA",2024,12,62262,59321,2941,4.7
MT4113460000000,41,13460,"Bend, OR MSA",2024,12,133719,128001,5718,4.3
MT4118700000000,41,18700,"Corvallis, OR MSA",2024,12,49345,47459,1886,3.8
MT4121660000000,41,21660,"Eugene-Springfield, OR MSA",2024,12,188908,180662,8246,4.4
MT4124420000000,41,24420,"Grants Pass, OR MSA",2024,12,35008,32922,2086,6
MT4132780000000,41,32780,"Medford, OR MSA",2024,12,105843,100558,5285,5
MT4138900000000,41,38900,"Portland-Vancouver-Hillsboro, OR-WA MSA",2024,12,1385477,1327853,57624,4.2
MT4141420000000,41,41420,"Salem, OR MSA",2024,12,224678,215216,9462,4.2
MT4210900000000,42,10900,"Allentown-Bethlehem-Easton, PA-NJ MSA",2024,12,452121,434416,17705,3.9
MT4211020000000,42,11020,"Altoona, PA MSA",2024,12,57679,55592,2087,3.6
MT4216540000000,42,16540,"Chambersburg, PA MSA",2024,12,77449,74987,2462,3.2
MT4221500000000,42,21500,"Erie, PA MSA",2024,12,126028,121002,5026,4
MT4223900000000,42,23900,"Gettysburg, PA MSA",2024,12,51473,49846,1627,3.2
MT4225420000000,42,25420,"Harrisburg-Carlisle, PA MSA",2024,12,313862,303432,10430,3.3
MT4227780000000,42,27780,"Johnstown, PA MSA",2024,12,56202,53757,2445,4.4
MT4229540000000,42,29540,"Lancaster, PA MSA",2024,12,290906,282312,8594,3
MT4230140000000,42,30140,"Lebanon, PA MSA",2024,12,73691,71356,2335,3.2
MT4237980000000,42,37980,"Philadelphia-Camden-Wilmington, PA-NJ-DE-MD MSA",2024,12,3286640,3158756,127884,3.9
MT4238300000000,42,38300,"Pittsburgh, PA MSA",2024,12,1231200,1185572,45628,3.7
MT4239740000000,42,39740,"Reading, PA MSA",2024,12,218916,210778,8138,3.7
MT4242540000000,42,42540,"Scranton--Wilkes-Barre, PA MSA",2024,12,278734,266920,11814,4.2
MT4244300000000,42,44300,"State College, PA MSA",2024,12,75953,73753,2200,2.9
MT4248700000000,42,48700,"Williamsport, PA MSA",2024,12,52788,50660,2128,4
MT4249620000000,42,49620,"York-Hanover, PA MSA",2024,12,238957,230548,8409,3.5
MT4439300000000,44,39300,"Providence-Warwick, RI-MA MSA",2024,12,905159,863124,42035,4.6
MT4516700000000,45,16700,"Charleston-North Charleston, SC MSA",2024,12,448673,431981,16692,3.7
MT4517900000000,45,17900,"Columbia, SC MSA",2024,12,423353,405339,18014,4.3
MT4522500000000,45,22500,"Florence, SC MSA",2024,12,92662,88240,4422,4.8
MT4524860000000,45,24860,"Greenville-Anderson-Greer, SC MSA",2024,12,482227,462797,19430,4
MT4525940000000,45,25940,"Hilton Head Island-Bluffton-Port Royal, SC MSA",2024,12,99204,95205,3999,4
MT4534820000000,45,34820,"Myrtle Beach-Conway-North Myrtle Beach, SC MSA",2024,12,172129,163564,8565,5
MT4543900000000,45,43900,"Spartanburg, SC MSA",2024,12,178866,170763,8103,4.5
MT4544940000000,45,44940,"Sumter, SC MSA",2024,12,41811,39475,2336,5.6
MT4639660000000,46,39660,"Rapid City, SD MSA",2024,12,80888,79422,1466,1.8
MT4643620000000,46,43620,"Sioux Falls, SD-MN MSA",2024,12,175915,172834,3081,1.8
MT4716860000000,47,16860,"Chattanooga, TN-GA MSA",2024,12,292523,282509,10014,3.4
MT4717300000000,47,17300,"Clarksville, TN-KY MSA",2024,12,140465,134336,6129,4.4
MT4717420000000,47,17420,"Cleveland, TN MSA",2024,12,56177,53904,2273,4
MT4727180000000,47,27180,"Jackson, TN MSA",2024,12,78658,75356,3302,4.2
MT4727740000000,47,27740,"Johnson City, TN MSA",2024,12,97282,93484,3798,3.9
MT4728700000000,47,28700,"Kingsport-Bristol, TN-VA MSA",2024,12,133453,128330,5123,3.8
MT4728940000000,47,28940,"Knoxville, TN MSA",2024,12,456273,440769,15504,3.4
MT4732820000000,47,32820,"Memphis, TN-MS-AR MSA",2024,12,627247,599134,28113,4.5
MT4734100000000,47,34100,"Morristown, TN MSA",2024,12,54234,52194,2040,3.8
MT4734980000000,47,34980,"Nashville-Davidson--Murfreesboro--Franklin, TN MSA",2024,12,1165409,1129216,36193,3.1
MT4810180000000,48,10180,"Abilene, TX MSA",2024,12,87406,84380,3026,3.5
MT4811100000000,48,11100,"Amarillo, TX MSA",2024,12,139078,134721,4357,3.1
MT4812420000000,48,12420,"Austin-Round Rock-San Marcos, TX MSA",2024,12,1516271,1462485,53786,3.5
MT4813140000000,48,13140,"Beaumont-Port Arthur, TX MSA",2024,12,184991,174892,10099,5.5
MT4815180000000,48,15180,"Brownsville-Harlingen, TX MSA",2024,12,191449,181333,10116,5.3
MT4817780000000,48,17780,"College Station-Bryan, TX MSA",2024,12,152825,147539,5286,3.5
MT4818580000000,48,18580,"Corpus Christi, TX MSA",2024,12,211478,202231,9247,4.4
MT4819100000000,48,19100,"Dallas-Fort Worth-Arlington, TX MSA",2024,12,4518286,4340358,177928,3.9
MT4820580000000,48,20580,"Eagle Pass, TX MSA",2024,12,24369,22429,1940,8
MT4821340000000,48,21340,"El Paso, TX MSA",2024,12,418560,401009,17551,4.2
MT4826420000000,48,26420,"Houston-Pasadena-The Woodlands, TX MSA",2024,12,3863899,3692286,171613,4.4
MT4828660000000,48,28660,"Killeen-Temple, TX MSA",2024,12,202849,193581,9268,4.6
MT4829700000000,48,29700,"Laredo, TX MSA",2024,12,119828,114788,5040,4.2
MT4830980000000,48,30980,"Longview, TX MSA",2024,12,129333,122998,6335,4.9
MT4831180000000,48,31180,"Lubbock, TX MSA",2024,12,185544,178880,6664,3.6
MT4832580000000,48,32580,"McAllen-Edinburg-Mission, TX MSA",2024,12,399076,374879,24197,6.1
MT4833260000000,48,33260,"Midland, TX MSA",2024,12,104494,101381,3113,3
MT4836220000000,48,36220,"Odessa, TX MSA",2024,12,87053,83915,3138,3.6
MT4841660000000,48,41660,"San Angelo, TX MSA",2024,12,62795,60714,2081,3.3
MT4841700000000,48,41700,"San Antonio-New Braunfels, TX MSA",2024,12,1350109,1298261,51848,3.8
MT4843300000000,48,43300,"Sherman-Denison, TX MSA",2024,12,71873,69064,2809,3.9
MT4845500000000,48,45500,"Texarkana, TX-AR MSA",2024,12,62378,59743,2635,4.2
MT4846340000000,48,46340,"Tyler, TX MSA",2024,12,118988,114445,4543,3.8
MT4847020000000,48,47020,"Victoria, TX MSA",2024,12,45295,43420,1875,4.1
MT4847380000000,48,47380,"Waco, TX MSA",2024,12,147756,142031,5725,3.9
MT4848660000000,48,48660,"Wichita Falls, TX MSA",2024,12,67073,64495,2578,3.8
MT4930860000000,49,30860,"Logan, UT-ID MSA",2024,12,80634,78269,2365,2.9
MT4936260000000,49,36260,"Ogden, UT MSA",2024,12,354049,343133,10916,3.1
MT4939340000000,49,39340,"Provo-Orem-Lehi, UT MSA",2024,12,371960,359495,12465,3.4
MT4941100000000,49,41100,"St. George, UT MSA",2024,12,95168,91928,3240,3.4
MT4941620000000,49,41620,"Salt Lake City-Murray, UT MSA",2024,12,739891,715582,24309,3.3
MT5015540000000,50,15540,"Burlington-South Burlington, VT MSA",2024,12,131947,129045,2902,2.2
MT5113980000000,51,13980,"Blacksburg-Christiansburg-Radford, VA MSA",2024,12,93153,90124,3029,3.3
MT5116820000000,51,16820,"Charlottesville, VA MSA",2024,12,121164,118039,3125,2.6
MT5125500000000,51,25500,"Harrisonburg, VA MSA",2024,12,72039,70003,2036,2.8
MT5131340000000,51,31340,"Lynchburg, VA MSA",2024,12,127018,122818,4200,3.3
MT5140060000000,51,40060,"Richmond, VA MSA",2024,12,730080,708017,22063,3
MT5140220000000,51,40220,"Roanoke, VA MSA",2024,12,159071,154334,4737,3
MT5144420000000,51,44420,"Staunton-Stuarts Draft, VA MSA",2024,12,65247,63511,1736,2.7
MT5147260000000,51,47260,"Virginia Beach-Chesapeake-Norfolk, VA-NC MSA",2024,12,884412,856849,27563,3.1
MT5149020000000,51,49020,"Winchester, VA-WV MSA",2024,12,77650,75462,2188,2.8
MT5313380000000,53,13380,"Bellingham, WA MSA",2024,12,113003,107829,5174,4.6
MT5314740000000,53,14740,"Bremerton-Silverdale-Port Orchard, WA MSA",2024,12,121396,115908,5488,4.5
MT5328420000000,53,28420,"Kennewick-Richland, WA MSA",2024,12,148275,140942,7333,4.9
MT5331020000000,53,31020,"Longview-Kelso, WA MSA",2024,12,46835,44338,2497,5.3
MT5334580000000,53,34580,"Mount Vernon-Anacortes, WA MSA",2024,12,59529,56539,2990,5
MT5336500000000,53,36500,"Olympia-Lacey-Tumwater, WA MSA",2024,12,143346,136758,6588,4.6
MT5342660000000,53,42660,"Seattle-Tacoma-Bellevue, WA MSA",2024,12,2343860,2248850,95010,4.1
MT5344060000000,53,44060,"Spokane-Spokane Valley, WA MSA",2024,12,279075,265933,13142,4.7
MT5347460000000,53,47460,"Walla Walla, WA MSA",2024,12,29290,28093,1197,4.1
MT5348300000000,53,48300,"Wenatchee-East Wenatchee, WA MSA",2024,12,61731,58752,2979,4.8
MT5349420000000,53,49420,"Yakima, WA MSA",2024,12,124263,116476,7787,6.3
MT5413220000000,54,13220,"Beckley, WV MSA",2024,12,45997,44148,1849,4
MT5416620000000,54,16620,"Charleston, WV MSA",2024,12,90161,86509,3652,4.1
MT5426580000000,54,26580,"Huntington-Ashland, WV-KY-OH MSA",2024,12,157505,149497,8008,5.1
MT5434060000000,54,34060,"Morgantown, WV MSA",2024,12,71043,68641,2402,3.4
MT5437620000000,54,37620,"Parkersburg-Vienna, WV MSA",2024,12,39076,37432,1644,4.2
MT5448540000000,54,48540,"Wheeling, WV-OH MSA",2024,12,59448,56546,2902,4.9
MT5511540000000,55,11540,"Appleton, WI MSA",2024,12,138156,134543,3613,2.6
MT5520740000000,55,20740,"Eau Claire, WI MSA",2024,12,96928,93993,2935,3
MT5522540000000,55,22540,"Fond du Lac, WI MSA",2024,12,55268,53602,1666,3
MT5524580000000,55,24580,"Green Bay, WI MSA",2024,12,181325,176328,4997,2.8
MT5527500000000,55,27500,"Janesville-Beloit, WI MSA",2024,12,87756,84866,2890,3.3
MT5528450000000,55,28450,"Kenosha, WI MSA",2024,12,96221,93024,3197,3.3
MT5529100000000,55,29100,"La Crosse-Onalaska, WI-MN MSA",2024,12,91493,88941,2552,2.8
MT5531540000000,55,31540,"Madison, WI MSA",2024,12,412505,402206,10299,2.5
MT5533340000000,55,33340,"Milwaukee-Waukesha, WI MSA",2024,12,825423,797805,27618,3.3
MT5536780000000,55,36780,"Oshkosh-Neenah, WI MSA",2024,12,93394,90808,2586,2.8
MT5539540000000,55,39540,"Racine-Mount Pleasant, WI MSA",2024,12,101759,98060,3699,3.6
MT5543100000000,55,43100,"Sheboygan, WI MSA",2024,12,64283,62608,1675,2.6
MT5548140000000,55,48140,"Wausau, WI MSA",2024,12,75214,73211,2003,2.7
MT5616220000000,56,16220,"Casper, WY MSA",2024,12,42362,40842,1520,3.6
MT5616940000000,56,16940,"Cheyenne, WY MSA",2024,12,49264,47470,1794,3.6
MT7210380000000,72,10380,"Aguadilla, PR MSA",2024,12,91185,84752,6433,7.1
MT7211640000000,72,11640,"Arecibo, PR MSA",2024,12,67968,64421,3547,5.2
MT7225020000000,72,25020,"Guayama, PR MSA",2024,12,19207,17408,1799,9.4
MT7232420000000,72,32420,"Mayaguez, PR MSA",2024,12,67564,62524,5040,7.5
MT7238660000000,72,38660,"Ponce, PR MSA",2024,12,90060,82343,7717,8.6
MT7241980000000,72,41980,"San Juan-Bayamon-Caguas, PR MSA",2024,12,823381,785381,38000,4.6
MT0111500000000,1,11500,"Anniston-Oxford, AL MSA",2025,1,50022,48258,1764,3.5
MT0112220000000,1,12220,"Auburn-Opelika, AL MSA",2025,1,97135,94163,2972,3.1
MT0113820000000,1,13820,"Birmingham, AL MSA",2025,1,572795,555087,17708,3.1
MT0119300000000,1,19300,"Daphne-Fairhope-Foley, AL MSA",2025,1,118484,115067,3417,2.9
MT0119460000000,1,19460,"Decatur, AL MSA",2025,1,77112,74935,2177,2.8
MT0120020000000,1,20020,"Dothan, AL MSA",2025,1,68170,65879,2291,3.4
MT0122520000000,1,22520,"Florence-Muscle Shoals, AL MSA",2025,1,69888,67456,2432,3.5
MT0123460000000,1,23460,"Gadsden, AL MSA",2025,1,42412,40890,1522,3.6
MT0126620000000,1,26620,"Huntsville, AL MSA",2025,1,280006,272232,7774,2.8
MT0133660000000,1,33660,"Mobile, AL MSA",2025,1,188430,181008,7422,3.9
MT0133860000000,1,33860,"Montgomery, AL MSA",2025,1,180010,174093,5917,3.3
MT0146220000000,1,46220,"Tuscaloosa, AL MSA",2025,1,127287,122842,4445,3.5
MT0211260000000,2,11260,"Anchorage, AK MSA",2025,1,202439,193833,8606,4.3
MT0221820000000,2,21820,"Fairbanks-College, AK MSA",2025,1,46148,44256,1892,4.1
MT0422380000000,4,22380,"Flagstaff, AZ MSA",2025,1,76419,73257,3162,4.1
MT0429420000000,4,29420,"Lake Havasu City-Kingman, AZ MSA",2025,1,88276,84252,4024,4.6
MT0438060000000,4,38060,"Phoenix-Mesa-Chandler, AZ MSA",2025,1,2727530,2635450,92080,3.4
MT0439150000000,4,39150,"Prescott Valley-Prescott, AZ MSA",2025,1,107392,103541,3851,3.6
MT0443420000000,4,43420,"Sierra Vista-Douglas, AZ MSA",2025,1,47847,45703,2144,4.5
MT0446060000000,4,46060,"Tucson, AZ MSA",2025,1,495566,476808,18758,3.8
MT0449740000000,4,49740,"Yuma, AZ MSA",2025,1,99427,86768,12659,12.7
MT0522220000000,5,22220,"Fayetteville-Springdale-Rogers, AR MSA",2025,1,310590,302016,8574,2.8
MT0522900000000,5,22900,"Fort Smith, AR-OK MSA",2025,1,102193,98680,3513,3.4
MT0526300000000,5,26300,"Hot Springs, AR MSA",2025,1,43637,42033,1604,3.7
MT0527860000000,5,27860,"Jonesboro, AR MSA",2025,1,66843,64632,2211,3.3
MT0530780000000,5,30780,"Little Rock-North Little Rock-Conway, AR MSA",2025,1,383729,371115,12614,3.3
MT0612540000000,6,12540,"Bakersfield-Delano, CA MSA",2025,1,411982,376553,35429,8.6
MT0617020000000,6,17020,"Chico, CA MSA",2025,1,92004,86549,5455,5.9
MT0620940000000,6,20940,"El Centro, CA MSA",2025,1,73368,59715,13653,18.6
MT0623420000000,6,23420,"Fresno, CA MSA",2025,1,542970,500348,42622,7.8
MT0625260000000,6,25260,"Hanford-Corcoran, CA MSA",2025,1,58886,53666,5220,8.9
MT0631080000000,6,31080,"Los Angeles-Long Beach-Anaheim, CA MSA",2025,1,6744395,6372949,371446,5.5
MT0632900000000,6,32900,"Merced, CA MSA",2025,1,122006,110102,11904,9.8
MT0633700000000,6,33700,"Modesto, CA MSA",2025,1,257347,239525,17822,6.9
MT0634900000000,6,34900,"Napa, CA MSA",2025,1,75829,72838,2991,3.9
MT0637100000000,6,37100,"Oxnard-Thousand Oaks-Ventura, CA MSA",2025,1,420643,400901,19742,4.7
MT0639820000000,6,39820,"Redding, CA MSA",2025,1,80049,75779,4270,5.3
MT0640140000000,6,40140,"Riverside-San Bernardino-Ontario, CA MSA",2025,1,2221588,2103971,117617,5.3
MT0640900000000,6,40900,"Sacramento-Roseville-Folsom, CA MSA",2025,1,1186948,1130495,56453,4.8
MT0641500000000,6,41500,"Salinas, CA MSA",2025,1,224507,208408,16099,7.2
MT0641740000000,6,41740,"San Diego-Chula Vista-Carlsbad, CA MSA",2025,1,1654698,1581278,73420,4.4
MT0641860000000,6,41860,"San Francisco-Oakland-Fremont, CA MSA",2025,1,2501586,2394130,107456,4.3
MT0641940000000,6,41940,"San Jose-Sunnyvale-Santa Clara, CA MSA",2025,1,1059040,1013850,45190,4.3
MT0642020000000,6,42020,"San Luis Obispo-Paso Robles, CA MSA",2025,1,132609,127086,5523,4.2
MT0642100000000,6,42100,"Santa Cruz-Watsonville, CA MSA",2025,1,136884,128679,8205,6
MT0642200000000,6,42200,"Santa Maria-Santa Barbara, CA MSA",2025,1,222545,212581,9964,4.5
MT0642220000000,6,42220,"Santa Rosa-Petaluma, CA MSA",2025,1,246982,236555,10427,4.2
MT0644700000000,6,44700,"Stockton-Lodi, CA MSA",2025,1,372198,348071,24127,6.5
MT0646700000000,6,46700,"Vallejo, CA MSA",2025,1,216609,205513,11096,5.1
MT0647300000000,6,47300,"Visalia, CA MSA",2025,1,222455,199552,22903,10.3
MT0649700000000,6,49700,"Yuba City, CA MSA",2025,1,82211,75854,6357,7.7
MT0814500000000,8,14500,"Boulder, CO MSA",2025,1,194167,185310,8857,4.6
MT0817820000000,8,17820,"Colorado Springs, CO MSA",2025,1,398888,380198,18690,4.7
MT0819740000000,8,19740,"Denver-Aurora-Centennial, CO MSA",2025,1,1787356,1704744,82612,4.6
MT0822660000000,8,22660,"Fort Collins-Loveland, CO MSA",2025,1,208275,198961,9314,4.5
MT0824300000000,8,24300,"Grand Junction, CO MSA",2025,1,80751,76891,3860,4.8
MT0824540000000,8,24540,"Greeley, CO MSA",2025,1,178642,169876,8766,4.9
MT0839380000000,8,39380,"Pueblo, CO MSA",2025,1,73990,69331,4659,6.3
MT0914860000000,9,14860,"Bridgeport-Stamford-Danbury, CT MSA",2025,1,519926,503728,16198,3.1
MT0925540000000,9,25540,"Hartford-West Hartford-East Hartford, CT MSA",2025,1,616565,596484,20081,3.3
MT0935300000000,9,35300,"New Haven, CT MSA",2025,1,318251,307975,10276,3.2
MT0935980000000,9,35980,"Norwich-New London-Willimantic, CT MSA",2025,1,144346,139783,4563,3.2
MT0947930000000,9,47930,"Waterbury-Shelton, CT MSA",2025,1,242570,233544,9026,3.7
MT1020100000000,10,20100,"Dover, DE MSA",2025,1,85244,81882,3362,3.9
MT1147900000000,11,47900,"Washington-Arlington-Alexandria, DC-VA-MD-WV MSA",2025,1,3570567,3460560,110007,3.1
MT1215980000000,12,15980,"Cape Coral-Fort Myers, FL MSA",2025,1,375323,361398,13925,3.7
MT1218880000000,12,18880,"Crestview-Fort Walton Beach-Destin, FL MSA",2025,1,144487,139849,4638,3.2
MT1219660000000,12,19660,"Deltona-Daytona Beach-Ormond Beach, FL MSA",2025,1,323792,310775,13017,4
MT1223540000000,12,23540,"Gainesville, FL MSA",2025,1,170697,164062,6635,3.9
MT1226140000000,12,26140,"Homosassa Springs, FL MSA",2025,1,54097,51277,2820,5.2
MT1227260000000,12,27260,"Jacksonville, FL MSA",2025,1,860379,829835,30544,3.6
MT1229460000000,12,29460,"Lakeland-Winter Haven, FL MSA",2025,1,360121,344656,15465,4.3
MT1233100000000,12,33100,"Miami-Fort Lauderdale-West Palm Beach, FL MSA",2025,1,3309093,3211028,98065,3
MT1234940000000,12,34940,"Naples-Marco Island, FL MSA",2025,1,185333,178805,6528,3.5
MT1235840000000,12,35840,"North Port-Bradenton-Sarasota, FL MSA",2025,1,399725,384716,15009,3.8
MT1236100000000,12,36100,"Ocala, FL MSA",2025,1,159910,153049,6861,4.3
MT1236740000000,12,36740,"Orlando-Kissimmee-Sanford, FL MSA",2025,1,1543546,1491568,51978,3.4
MT1237340000000,12,37340,"Palm Bay-Melbourne-Titusville, FL MSA",2025,1,307060,295915,11145,3.6
MT1237460000000,12,37460,"Panama City-Panama City Beach, FL MSA",2025,1,102610,99077,3533,3.4
MT1237860000000,12,37860,"Pensacola-Ferry Pass-Brent, FL MSA",2025,1,240944,232126,8818,3.7
MT1238940000000,12,38940,"Port St. Lucie, FL MSA",2025,1,242001,232524,9477,3.9
MT1239460000000,12,39460,"Punta Gorda, FL MSA",2025,1,77426,73978,3448,4.5
MT1242680000000,12,42680,"Sebastian-Vero Beach-West Vero Corridor, FL MSA",2025,1,67672,64782,2890,4.3
MT1242700000000,12,42700,"Sebring, FL MSA",2025,1,36838,34971,1867,5.1
MT1245220000000,12,45220,"Tallahassee, FL MSA",2025,1,209780,202249,7531,3.6
MT1245300000000,12,45300,"Tampa-St. Petersburg-Clearwater, FL MSA",2025,1,1706008,1644267,61741,3.6
MT1248680000000,12,48680,"Wildwood-The Villages, FL MSA",2025,1,34512,32463,2049,5.9
MT1310500000000,13,10500,"Albany, GA MSA",2025,1,62178,59593,2585,4.2
MT1312020000000,13,12020,"Athens-Clarke County, GA MSA",2025,1,109245,105671,3574,3.3
MT1312060000000,13,12060,"Atlanta-Sandy Springs-Roswell, GA MSA",2025,1,3303015,3188126,114889,3.5
MT1312260000000,13,12260,"Augusta-Richmond County, GA-SC MSA",2025,1,267706,255691,12015,4.5
MT1315260000000,13,15260,"Brunswick-St. Simons, GA MSA",2025,1,55909,54182,1727,3.1
MT1317980000000,13,17980,"Columbus, GA-AL MSA",2025,1,128840,123549,5291,4.1
MT1319140000000,13,19140,"Dalton, GA MSA",2025,1,68015,65376,2639,3.9
MT1323580000000,13,23580,"Gainesville, GA MSA",2025,1,109274,106205,3069,2.8
MT1325980000000,13,25980,"Hinesville, GA MSA",2025,1,31316,30095,1221,3.9
MT1331420000000,13,31420,"Macon-Bibb County, GA MSA",2025,1,97117,93015,4102,4.2
MT1340660000000,13,40660,"Rome, GA MSA",2025,1,48102,46430,1672,3.5
MT1342340000000,13,42340,"Savannah, GA MSA",2025,1,209915,203561,6354,3
MT1346660000000,13,46660,"Valdosta, GA MSA",2025,1,61726,59272,2454,4
MT1347580000000,13,47580,"Warner Robins, GA MSA",2025,1,90271,87446,2825,3.1
MT1527980000000,15,27980,"Kahului-Wailuku, HI MSA",2025,1,81371,78302,3069,3.8
MT1546520000000,15,46520,"Urban Honolulu, HI MSA",2025,1,473084,459677,13407,2.8
MT1614260000000,16,14260,"Boise City, ID MSA",2025,1,453236,437304,15932,3.5
MT1617660000000,16,17660,"Coeur d'Alene, ID MSA",2025,1,91340,87267,4073,4.5
MT1626820000000,16,26820,"Idaho Falls, ID MSA",2025,1,85262,82562,2700,3.2
MT1630300000000,16,30300,"Lewiston, ID-WA MSA",2025,1,31064,29955,1109,3.6
MT1638540000000,16,38540,"Pocatello, ID MSA",2025,1,41299,39622,1677,4.1
MT1646300000000,16,46300,"Twin Falls, ID MSA",2025,1,60613,58454,2159,3.6
MT1714010000000,17,14010,"Bloomington, IL MSA",2025,1,95906,92354,3552,3.7
MT1716580000000,17,16580,"Champaign-Urbana, IL MSA",2025,1,125147,120423,4724,3.8
MT1716980000000,17,16980,"Chicago-Naperville-Elgin, IL-IN MSA",2025,1,5046956,4793280,253676,5
MT1719340000000,17,19340,"Davenport-Moline-Rock Island, IA-IL MSA",2025,1,189657,180593,9064,4.8
MT1719500000000,17,19500,"Decatur, IL MSA",2025,1,44375,41923,2452,5.5
MT1728100000000,17,28100,"Kankakee, IL MSA",2025,1,51094,48431,2663,5.2
MT1737900000000,17,37900,"Peoria, IL MSA",2025,1,178090,169863,8227,4.6
MT1740420000000,17,40420,"Rockford, IL MSA",2025,1,160560,152322,8238,5.1
MT1744100000000,17,44100,"Springfield, IL MSA",2025,1,104003,99816,4187,4
MT1814020000000,18,14020,"Bloomington, IN MSA",2025,1,86066,82723,3343,3.9
MT1818020000000,18,18020,"Columbus, IN MSA",2025,1,39991,38320,1671,4.2
MT1821140000000,18,21140,"Elkhart-Goshen, IN MSA",2025,1,98617,93916,4701,4.8
MT1821780000000,18,21780,"Evansville, IN MSA",2025,1,136816,131355,5461,4
MT1823060000000,18,23060,"Fort Wayne, IN MSA",2025,1,234153,224779,9374,4
MT1826900000000,18,26900,"Indianapolis-Carmel-Greenwood, IN MSA",2025,1,1152078,1106428,45650,4
MT1829020000000,18,29020,"Kokomo, IN MSA",2025,1,36977,34401,2576,7
MT1829200000000,18,29200,"Lafayette-West Lafayette, IN MSA",2025,1,121115,116373,4742,3.9
MT1833140000000,18,33140,"Michigan City-La Porte, IN MSA",2025,1,52050,49492,2558,4.9
MT1834620000000,18,34620,"Muncie, IN MSA",2025,1,53499,50964,2535,4.7
MT1843780000000,18,43780,"South Bend-Mishawaka, IN-MI MSA",2025,1,156913,149141,7772,5
MT1845460000000,18,45460,"Terre Haute, IN MSA",2025,1,78353,74780,3573,4.6
MT1911180000000,19,11180,"Ames, IA MSA",2025,1,70293,68511,1782,2.5
MT1916300000000,19,16300,"Cedar Rapids, IA MSA",2025,1,146244,141268,4976,3.4
MT1919780000000,19,19780,"Des Moines-West Des Moines, IA MSA",2025,1,414717,401395,13322,3.2
MT1920220000000,19,20220,"Dubuque, IA MSA",2025,1,53692,51918,1774,3.3
MT1926980000000,19,26980,"Iowa City, IA MSA",2025,1,100974,98492,2482,2.5
MT1943580000000,19,43580,"Sioux City, IA-NE-SD MSA",2025,1,76491,74127,2364,3.1
MT1947940000000,19,47940,"Waterloo-Cedar Falls, IA MSA",2025,1,88659,85193,3466,3.9
MT2029940000000,20,29940,"Lawrence, KS MSA",2025,1,71885,69439,2446,3.4
MT2031740000000,20,31740,"Manhattan, KS MSA",2025,1,64964,62670,2294,3.5
MT2045820000000,20,45820,"Topeka, KS MSA",2025,1,119554,114951,4603,3.9
MT2048620000000,20,48620,"Wichita, KS MSA",2025,1,338881,324684,14197,4.2
MT2114540000000,21,14540,"Bowling Green, KY MSA",2025,1,94218,89548,4670,5
MT2121060000000,21,21060,"Elizabethtown, KY MSA",2025,1,56020,52915,3105,5.5
MT2130460000000,21,30460,"Lexington-Fayette, KY MSA",2025,1,280184,267779,12405,4.4
MT2131140000000,21,31140,"Louisville/Jefferson County, KY-IN MSA",2025,1,704891,671753,33138,4.7
MT2136980000000,21,36980,"Owensboro, KY MSA",2025,1,52987,50216,2771,5.2
MT2137140000000,21,37140,"Paducah, KY-IL MSA",2025,1,46380,43946,2434,5.2
MT2210780000000,22,10780,"Alexandria, LA MSA",2025,1,64334,61636,2698,4.2
MT2212940000000,22,12940,"Baton Rouge, LA MSA",2025,1,427853,409805,18048,4.2
MT2225220000000,22,25220,"Hammond, LA MSA",2025,1,61041,57971,3070,5
MT2226380000000,22,26380,"Houma-Bayou Cane-Thibodaux, LA MSA",2025,1,87930,84427,3503,4
MT2229180000000,22,29180,"Lafayette, LA MSA",2025,1,197995,190211,7784,3.9
MT2229340000000,22,29340,"Lake Charles, LA MSA",2025,1,98019,93329,4690,4.8
MT2233740000000,22,33740,"Monroe, LA MSA",2025,1,95703,90775,4928,5.1
MT2235380000000,22,35380,"New Orleans-Metairie, LA MSA",2025,1,467693,446681,21012,4.5
MT2243340000000,22,43340,"Shreveport-Bossier City, LA MSA",2025,1,167736,160169,7567,4.5
MT2243640000000,22,43640,"Slidell-Mandeville-Covington, LA MSA",2025,1,129464,124264,5200,4
MT2312620000000,23,12620,"Bangor, ME MSA",2025,1,76535,73636,2899,3.8
MT2330340000000,23,30340,"Lewiston-Auburn, ME MSA",2025,1,55718,53739,1979,3.6
MT2338860000000,23,38860,"Portland-South Portland, ME MSA",2025,1,317344,308018,9326,2.9
MT2412580000000,24,12580,"Baltimore-Columbia-Towson, MD MSA",2025,1,1498294,1451967,46327,3.1
MT2425180000000,24,25180,"Hagerstown-Martinsburg, MD-WV MSA",2025,1,143904,139165,4739,3.3
MT2430500000000,24,30500,"Lexington Park, MD MSA",2025,1,109925,106988,2937,2.7
MT2441540000000,24,41540,"Salisbury, MD MSA",2025,1,64491,62280,2211,3.4
MT2511200000000,25,11200,"Amherst Town-Northampton, MA MSA",2025,1,86514,83083,3431,4
MT2512700000000,25,12700,"Barnstable Town, MA MSA",2025,1,120139,114209,5930,4.9
MT2514460000000,25,14460,"Boston-Cambridge-Newton, MA-NH MSA",2025,1,2852830,2741311,111519,3.9
MT2538340000000,25,38340,"Pittsfield, MA MSA",2025,1,64488,61790,2698,4.2
MT2544140000000,25,44140,"Springfield, MA MSA",2025,1,226992,215103,11889,5.2
MT2549340000000,25,49340,"Worcester, MA MSA",2025,1,470662,450109,20553,4.4
MT2611460000000,26,11460,"Ann Arbor, MI MSA",2025,1,210906,201957,8949,4.2
MT2612980000000,26,12980,"Battle Creek, MI MSA",2025,1,65058,61299,3759,5.8
MT2613020000000,26,13020,"Bay City, MI MSA",2025,1,51075,47967,3108,6.1
MT2619820000000,26,19820,"Detroit-Warren-Dearborn, MI MSA",2025,1,2181178,2069734,111444,5.1
MT2622420000000,26,22420,"Flint, MI MSA",2025,1,192112,179920,12192,6.3
MT2624340000000,26,24340,"Grand Rapids-Wyoming-Kentwood, MI MSA",2025,1,635979,607771,28208,4.4
MT2627100000000,26,27100,"Jackson, MI MSA",2025,1,75799,71651,4148,5.5
MT2628020000000,26,28020,"Kalamazoo-Portage, MI MSA",2025,1,142301,135684,6617,4.7
MT2629620000000,26,29620,"Lansing-East Lansing, MI MSA",2025,1,259361,247081,12280,4.7
MT2633220000000,26,33220,"Midland, MI MSA",2025,1,43734,41564,2170,5
MT2633780000000,26,33780,"Monroe, MI MSA",2025,1,80397,75547,4850,6
MT2634740000000,26,34740,"Muskegon-Norton Shores, MI MSA",2025,1,86610,81551,5059,5.8
MT2635660000000,26,35660,"Niles, MI MSA",2025,1,78232,73856,4376,5.6
MT2640980000000,26,40980,"Saginaw, MI MSA",2025,1,86199,80490,5709,6.6
MT2645900000000,26,45900,"Traverse City, MI MSA",2025,1,83739,79794,3945,4.7
MT2720260000000,27,20260,"Duluth, MN-WI MSA",2025,1,140281,135406,4875,3.5
MT2731860000000,27,31860,"Mankato, MN MSA",2025,1,60357,58831,1526,2.5
MT2733460000000,27,33460,"Minneapolis-St. Paul-Bloomington, MN-WI MSA",2025,1,2076116,2017405,58711,2.8
MT2740340000000,27,40340,"Rochester, MN MSA",2025,1,129995,126793,3202,2.5
MT2741060000000,27,41060,"St. Cloud, MN MSA",2025,1,111414,107912,3502,3.1
MT2825060000000,28,25060,"Gulfport-Biloxi, MS MSA",2025,1,190409,184109,6300,3.3
MT2825620000000,28,25620,"Hattiesburg, MS MSA",2025,1,70796,68375,2421,3.4
MT2827140000000,28,27140,"Jackson, MS MSA",2025,1,287052,277765,9287,3.2
MT2916020000000,29,16020,"Cape Girardeau, MO-IL MSA",2025,1,49342,47670,1672,3.4
MT2917860000000,29,17860,"Columbia, MO MSA",2025,1,113643,110107,3536,3.1
MT2927620000000,29,27620,"Jefferson City, MO MSA",2025,1,77279,74930,2349,3
MT2927900000000,29,27900,"Joplin, MO-KS MSA",2025,1,98738,95254,3484,3.5
MT2928140000000,29,28140,"Kansas City, MO-KS MSA",2025,1,1205245,1160567,44678,3.7
MT2941140000000,29,41140,"St. Joseph, MO-KS MSA",2025,1,55071,53019,2052,3.7
MT2941180000000,29,41180,"St. Louis, MO-IL MSA",2025,1,1486651,1432102,54549,3.7
MT2944180000000,29,44180,"Springfield, MO MSA",2025,1,245474,237386,8088,3.3
MT3013740000000,30,13740,"Billings, MT MSA",2025,1,99314,96620,2694,2.7
MT3014580000000,30,14580,"Bozeman, MT MSA",2025,1,78058,76381,1677,2.1
MT3024500000000,30,24500,"Great Falls, MT MSA",2025,1,39646,38554,1092,2.8
MT3025740000000,30,25740,"Helena, MT MSA",2025,1,47851,46644,1207,2.5
MT3033540000000,30,33540,"Missoula, MT MSA",2025,1,74573,72540,2033,2.7
MT3124260000000,31,24260,"Grand Island, NE MSA",2025,1,43088,41822,1266,2.9
MT3130700000000,31,30700,"Lincoln, NE MSA",2025,1,195842,190611,5231,2.7
MT3136540000000,31,36540,"Omaha, NE-IA MSA",2025,1,530746,514456,16290,3.1
MT3216180000000,32,16180,"Carson City, NV MSA",2025,1,29583,28193,1390,4.7
MT3229820000000,32,29820,"Las Vegas-Henderson-North Las Vegas, NV MSA",2025,1,1228596,1154789,73807,6
MT3239900000000,32,39900,"Reno, NV MSA",2025,1,302586,287992,14594,4.8
MT3331700000000,33,31700,"Manchester-Nashua, NH MSA",2025,1,242976,235294,7682,3.2
MT3412100000000,34,12100,"Atlantic City-Hammonton, NJ MSA",2025,1,182652,171188,11464,6.3
MT3445940000000,34,45940,"Trenton-Princeton, NJ MSA",2025,1,199236,190301,8935,4.5
MT3447220000000,34,47220,"Vineland, NJ MSA",2025,1,66245,61594,4651,7
MT3510740000000,35,10740,"Albuquerque, NM MSA",2025,1,467873,448914,18959,4.1
MT3522140000000,35,22140,"Farmington, NM MSA",2025,1,50109,47689,2420,4.8
MT3529740000000,35,29740,"Las Cruces, NM MSA",2025,1,102776,97574,5202,5.1
MT3542140000000,35,42140,"Santa Fe, NM MSA",2025,1,74580,71633,2947,4
MT3610580000000,36,10580,"Albany-Schenectady-Troy, NY MSA",2025,1,455648,440646,15002,3.3
MT3613780000000,36,13780,"Binghamton, NY MSA",2025,1,105914,101781,4133,3.9
MT3615380000000,36,15380,"Buffalo-Cheektowaga, NY MSA",2025,1,555567,533734,21833,3.9
MT3621300000000,36,21300,"Elmira, NY MSA",2025,1,34987,33647,1340,3.8
MT3624020000000,36,24020,"Glens Falls, NY MSA",2025,1,59379,57332,2047,3.4
MT3627060000000,36,27060,"Ithaca, NY MSA",2025,1,48383,46808,1575,3.3
MT3628740000000,36,28740,"Kingston, NY MSA",2025,1,87152,84131,3021,3.5
MT3628880000000,36,28880,"Kiryas Joel-Poughkeepsie-Newburgh, NY MSA",2025,1,339244,327511,11733,3.5
MT3635620000000,36,35620,"New York-Newark-Jersey City, NY-NJ MSA",2025,1,10225984,9753587,472397,4.6
MT3640380000000,36,40380,"Rochester, NY MSA",2025,1,511630,493322,18308,3.6
MT3645060000000,36,45060,"Syracuse, NY MSA",2025,1,311966,300876,11090,3.6
MT3646540000000,36,46540,"Utica-Rome, NY MSA",2025,1,126368,121570,4798,3.8
MT3648060000000,36,48060,"Watertown-Fort Drum, NY MSA",2025,1,44886,42954,1932,4.3
MT3711700000000,37,11700,"Asheville, NC MSA",2025,1,213684,203343,10341,4.8
MT3715500000000,37,15500,"Burlington, NC MSA",2025,1,86121,83046,3075,3.6
MT3716740000000,37,16740,"Charlotte-Concord-Gastonia, NC-SC MSA",2025,1,1484536,1430448,54088,3.6
MT3720500000000,37,20500,"Durham-Chapel Hill, NC MSA",2025,1,324095,313794,10301,3.2
MT3722180000000,37,22180,"Fayetteville, NC MSA",2025,1,153416,146553,6863,4.5
MT3724140000000,37,24140,"Goldsboro, NC MSA",2025,1,51371,49520,1851,3.6
MT3724660000000,37,24660,"Greensboro-High Point, NC MSA",2025,1,371050,356331,14719,4
MT3724780000000,37,24780,"Greenville, NC MSA",2025,1,83358,80045,3313,4
MT3725860000000,37,25860,"Hickory-Lenoir-Morganton, NC MSA",2025,1,170370,164160,6210,3.6
MT3727340000000,37,27340,"Jacksonville, NC MSA",2025,1,74067,71337,2730,3.7
MT3738240000000,37,38240,"Pinehurst-Southern Pines, NC MSA",2025,1,44831,43319,1512,3.4
MT3739580000000,37,39580,"Raleigh-Cary, NC MSA",2025,1,849901,823721,26180,3.1
MT3740580000000,37,40580,"Rocky Mount, NC MSA",2025,1,63095,60094,3001,4.8
MT3748900000000,37,48900,"Wilmington, NC MSA",2025,1,223966,216161,7805,3.5
MT3749180000000,37,49180,"Winston-Salem, NC MSA",2025,1,325215,313430,11785,3.6
MT3813900000000,38,13900,"Bismarck, ND MSA",2025,1,73788,72057,1731,2.3
MT3822020000000,38,22020,"Fargo, ND-MN MSA",2025,1,154372,150663,3709,2.4
MT3824220000000,38,24220,"Grand Forks, ND-MN MSA",2025,1,57408,55973,1435,2.5
MT3833500000000,38,33500,"Minot, ND MSA",2025,1,40145,39116,1029,2.6
MT3910420000000,39,10420,"Akron, OH MSA",2025,1,360593,343716,16877,4.7
MT3915940000000,39,15940,"Canton-Massillon, OH MSA",2025,1,195919,186645,9274,4.7
MT3917140000000,39,17140,"Cincinnati, OH-KY-IN MSA",2025,1,1179520,1127612,51908,4.4
MT3917410000000,39,17410,"Cleveland, OH MSA",2025,1,1106322,1062619,43703,4
MT3918140000000,39,18140,"Columbus, OH MSA",2025,1,1162032,1113167,48865,4.2
MT3919430000000,39,19430,"Dayton-Kettering-Beavercreek, OH MSA",2025,1,396233,378006,18227,4.6
MT3930620000000,39,30620,"Lima, OH MSA",2025,1,47728,45530,2198,4.6
MT3931900000000,39,31900,"Mansfield, OH MSA",2025,1,53781,51023,2758,5.1
MT3941780000000,39,41780,"Sandusky, OH MSA",2025,1,58733,55609,3124,5.3
MT3944220000000,39,44220,"Springfield, OH MSA",2025,1,62327,59133,3194,5.1
MT3945780000000,39,45780,"Toledo, OH MSA",2025,1,298455,281844,16611,5.6
MT3948260000000,39,48260,"Weirton-Steubenville, WV-OH MSA",2025,1,50755,47831,2924,5.8
MT3949660000000,39,49660,"Youngstown-Warren, OH MSA",2025,1,194011,183696,10315,5.3
MT4021420000000,40,21420,"Enid, OK MSA",2025,1,28309,27422,887,3.1
MT4030020000000,40,30020,"Lawton, OK MSA",2025,1,52478,50630,1848,3.5
MT4036420000000,40,36420,"Oklahoma City, OK MSA",2025,1,777213,753328,23885,3.1
MT4046140000000,40,46140,"Tulsa, OK MSA",2025,1,527601,510685,16916,3.2
MT4110540000000,41,10540,"Albany, OR MSA",2025,1,62337,59359,2978,4.8
MT4113460000000,41,13460,"Bend, OR MSA",2025,1,134180,128423,5757,4.3
MT4118700000000,41,18700,"Corvallis, OR MSA",2025,1,49413,47479,1934,3.9
MT4121660000000,41,21660,"Eugene-Springfield, OR MSA",2025,1,189048,180628,8420,4.5
MT4124420000000,41,24420,"Grants Pass, OR MSA",2025,1,35002,32893,2109,6
MT4132780000000,41,32780,"Medford, OR MSA",2025,1,105949,100591,5358,5.1
MT4138900000000,41,38900,"Portland-Vancouver-Hillsboro, OR-WA MSA",2025,1,1384694,1325487,59207,4.3
MT4141420000000,41,41420,"Salem, OR MSA",2025,1,225420,215755,9665,4.3
MT4210900000000,42,10900,"Allentown-Bethlehem-Easton, PA-NJ MSA",2025,1,451691,433820,17871,4
MT4211020000000,42,11020,"Altoona, PA MSA",2025,1,57690,55575,2115,3.7
MT4216540000000,42,16540,"Chambersburg, PA MSA",2025,1,77228,74730,2498,3.2
MT4221500000000,42,21500,"Erie, PA MSA",2025,1,126036,120952,5084,4
MT4223900000000,42,23900,"Gettysburg, PA MSA",2025,1,51380,49739,1641,3.2
MT4225420000000,42,25420,"Harrisburg-Carlisle, PA MSA",2025,1,313854,303276,10578,3.4
MT4227780000000,42,27780,"Johnstown, PA MSA",2025,1,56137,53672,2465,4.4
MT4229540000000,42,29540,"Lancaster, PA MSA",2025,1,290447,281741,8706,3
MT4230140000000,42,30140,"Lebanon, PA MSA",2025,1,73657,71276,2381,3.2
MT4237980000000,42,37980,"Philadelphia-Camden-Wilmington, PA-NJ-DE-MD MSA",2025,1,3283140,3154683,128457,3.9
MT4238300000000,42,38300,"Pittsburgh, PA MSA",2025,1,1229330,1183156,46174,3.8
MT4239740000000,42,39740,"Reading, PA MSA",2025,1,218579,210348,8231,3.8
MT4242540000000,42,42540,"Scranton--Wilkes-Barre, PA MSA",2025,1,278505,266626,11879,4.3
MT4244300000000,42,44300,"State College, PA MSA",2025,1,75989,73768,2221,2.9
MT4248700000000,42,48700,"Williamsport, PA MSA",2025,1,52790,50645,2145,4.1
MT4249620000000,42,49620,"York-Hanover, PA MSA",2025,1,238542,230047,8495,3.6
MT4439300000000,44,39300,"Providence-Warwick, RI-MA MSA",2025,1,905039,862728,42311,4.7
MT4516700000000,45,16700,"Charleston-North Charleston, SC MSA",2025,1,449151,432866,16285,3.6
MT4517900000000,45,17900,"Columbia, SC MSA",2025,1,423163,405567,17596,4.2
MT4522500000000,45,22500,"Florence, SC MSA",2025,1,92665,88411,4254,4.6
MT4524860000000,45,24860,"Greenville-Anderson-Greer, SC MSA",2025,1,482469,463627,18842,3.9
MT4525940000000,45,25940,"Hilton Head Island-Bluffton-Port Royal, SC MSA",2025,1,99408,95506,3902,3.9
MT4534820000000,45,34820,"Myrtle Beach-Conway-North Myrtle Beach, SC MSA",2025,1,172599,164154,8445,4.9
MT4543900000000,45,43900,"Spartanburg, SC MSA",2025,1,178993,171110,7883,4.4
MT4544940000000,45,44940,"Sumter, SC MSA",2025,1,41821,39549,2272,5.4
MT4639660000000,46,39660,"Rapid City, SD MSA",2025,1,81194,79721,1473,1.8
MT4643620000000,46,43620,"Sioux Falls, SD-MN MSA",2025,1,176094,172962,3132,1.8
MT4716860000000,47,16860,"Chattanooga, TN-GA MSA",2025,1,292419,282446,9973,3.4
MT4717300000000,47,17300,"Clarksville, TN-KY MSA",2025,1,140781,134650,6131,4.4
MT4717420000000,47,17420,"Cleveland, TN MSA",2025,1,56270,54003,2267,4
MT4727180000000,47,27180,"Jackson, TN MSA",2025,1,78904,75621,3283,4.2
MT4727740000000,47,27740,"Johnson City, TN MSA",2025,1,97389,93606,3783,3.9
MT4728700000000,47,28700,"Kingsport-Bristol, TN-VA MSA",2025,1,133585,128499,5086,3.8
MT4728940000000,47,28940,"Knoxville, TN MSA",2025,1,456707,441241,15466,3.4
MT4732820000000,47,32820,"Memphis, TN-MS-AR MSA",2025,1,627256,599134,28122,4.5
MT4734100000000,47,34100,"Morristown, TN MSA",2025,1,54284,52263,2021,3.7
MT4734980000000,47,34980,"Nashville-Davidson--Murfreesboro--Franklin, TN MSA",2025,1,1167025,1130765,36260,3.1
MT4810180000000,48,10180,"Abilene, TX MSA",2025,1,87651,84677,2974,3.4
MT4811100000000,48,11100,"Amarillo, TX MSA",2025,1,139431,135143,4288,3.1
MT4812420000000,48,12420,"Austin-Round Rock-San Marcos, TX MSA",2025,1,1517984,1465024,52960,3.5
MT4813140000000,48,13140,"Beaumont-Port Arthur, TX MSA",2025,1,185143,175301,9842,5.3
MT4815180000000,48,15180,"Brownsville-Harlingen, TX MSA",2025,1,191705,181768,9937,5.2
MT4817780000000,48,17780,"College Station-Bryan, TX MSA",2025,1,153618,148345,5273,3.4
MT4818580000000,48,18580,"Corpus Christi, TX MSA",2025,1,211538,202453,9085,4.3
MT4819100000000,48,19100,"Dallas-Fort Worth-Arlington, TX MSA",2025,1,4523279,4348041,175238,3.9
MT4820580000000,48,20580,"Eagle Pass, TX MSA",2025,1,24389,22484,1905,7.8
MT4821340000000,48,21340,"El Paso, TX MSA",2025,1,419305,401947,17358,4.1
MT4826420000000,48,26420,"Houston-Pasadena-The Woodlands, TX MSA",2025,1,3870467,3701816,168651,4.4
MT4828660000000,48,28660,"Killeen-Temple, TX MSA",2025,1,203013,193880,9133,4.5
MT4829700000000,48,29700,"Laredo, TX MSA",2025,1,120115,115109,5006,4.2
MT4830980000000,48,30980,"Longview, TX MSA",2025,1,129552,123290,6262,4.8
MT4831180000000,48,31180,"Lubbock, TX MSA",2025,1,186120,179519,6601,3.5
MT4832580000000,48,32580,"McAllen-Edinburg-Mission, TX MSA",2025,1,399336,375636,23700,5.9
MT4833260000000,48,33260,"Midland, TX MSA",2025,1,104700,101604,3096,3
MT4836220000000,48,36220,"Odessa, TX MSA",2025,1,87181,84052,3129,3.6
MT4841660000000,48,41660,"San Angelo, TX MSA",2025,1,62931,60871,2060,3.3
MT4841700000000,48,41700,"San Antonio-New Braunfels, TX MSA",2025,1,1352801,1301581,51220,3.8
MT4843300000000,48,43300,"Sherman-Denison, TX MSA",2025,1,71906,69165,2741,3.8
MT4845500000000,48,45500,"Texarkana, TX-AR MSA",2025,1,62483,59896,2587,4.1
MT4846340000000,48,46340,"Tyler, TX MSA",2025,1,119214,114730,4484,3.8
MT4847020000000,48,47020,"Victoria, TX MSA",2025,1,45321,43475,1846,4.1
MT4847380000000,48,47380,"Waco, TX MSA",2025,1,148217,142551,5666,3.8
MT4848660000000,48,48660,"Wichita Falls, TX MSA",2025,1,67105,64574,2531,3.8
MT4930860000000,49,30860,"Logan, UT-ID MSA",2025,1,80856,78540,2316,2.9
MT4936260000000,49,36260,"Ogden, UT MSA",2025,1,354728,344010,10718,3
MT4939340000000,49,39340,"Provo-Orem-Lehi, UT MSA",2025,1,372373,360160,12213,3.3
MT4941100000000,49,41100,"St. George, UT MSA",2025,1,95408,92273,3135,3.3
MT4941620000000,49,41620,"Salt Lake City-Murray, UT MSA",2025,1,740337,716386,23951,3.2
MT5015540000000,50,15540,"Burlington-South Burlington, VT MSA",2025,1,132114,129202,2912,2.2
MT5113980000000,51,13980,"Blacksburg-Christiansburg-Radford, VA MSA",2025,1,92978,89957,3021,3.2
MT5116820000000,51,16820,"Charlottesville, VA MSA",2025,1,121466,118315,3151,2.6
MT5125500000000,51,25500,"Harrisonburg, VA MSA",2025,1,71982,69923,2059,2.9
MT5131340000000,51,31340,"Lynchburg, VA MSA",2025,1,127193,122978,4215,3.3
MT5140060000000,51,40060,"Richmond, VA MSA",2025,1,730419,708335,22084,3
MT5140220000000,51,40220,"Roanoke, VA MSA",2025,1,159119,154374,4745,3
MT5144420000000,51,44420,"Staunton-Stuarts Draft, VA MSA",2025,1,65269,63534,1735,2.7
MT5147260000000,51,47260,"Virginia Beach-Chesapeake-Norfolk, VA-NC MSA",2025,1,885133,857301,27832,3.1
MT5149020000000,51,49020,"Winchester, VA-WV MSA",2025,1,77770,75587,2183,2.8
MT5313380000000,53,13380,"Bellingham, WA MSA",2025,1,112154,107147,5007,4.5
MT5314740000000,53,14740,"Bremerton-Silverdale-Port Orchard, WA MSA",2025,1,121237,115837,5400,4.5
MT5328420000000,53,28420,"Kennewick-Richland, WA MSA",2025,1,148503,141375,7128,4.8
MT5331020000000,53,31020,"Longview-Kelso, WA MSA",2025,1,46966,44516,2450,5.2
MT5334580000000,53,34580,"Mount Vernon-Anacortes, WA MSA",2025,1,59306,56441,2865,4.8
MT5336500000000,53,36500,"Olympia-Lacey-Tumwater, WA MSA",2025,1,143623,137145,6478,4.5
MT5342660000000,53,42660,"Seattle-Tacoma-Bellevue, WA MSA",2025,1,2350427,2255798,94629,4
MT5344060000000,53,44060,"Spokane-Spokane Valley, WA MSA",2025,1,278276,265554,12722,4.6
MT5347460000000,53,47460,"Walla Walla, WA MSA",2025,1,29116,27954,1162,4
MT5348300000000,53,48300,"Wenatchee-East Wenatchee, WA MSA",2025,1,61582,58695,2887,4.7
MT5349420000000,53,49420,"Yakima, WA MSA",2025,1,123798,116394,7404,6
MT5413220000000,54,13220,"Beckley, WV MSA",2025,1,45878,44064,1814,4
MT5416620000000,54,16620,"Charleston, WV MSA",2025,1,89992,86389,3603,4
MT5426580000000,54,26580,"Huntington-Ashland, WV-KY-OH MSA",2025,1,157476,149478,7998,5.1
MT5434060000000,54,34060,"Morgantown, WV MSA",2025,1,70918,68535,2383,3.4
MT5437620000000,54,37620,"Parkersburg-Vienna, WV MSA",2025,1,39024,37399,1625,4.2
MT5448540000000,54,48540,"Wheeling, WV-OH MSA",2025,1,59508,56684,2824,4.7
MT5511540000000,55,11540,"Appleton, WI MSA",2025,1,138008,134359,3649,2.6
MT5520740000000,55,20740,"Eau Claire, WI MSA",2025,1,97014,94024,2990,3.1
MT5522540000000,55,22540,"Fond du Lac, WI MSA",2025,1,55299,53623,1676,3
MT5524580000000,55,24580,"Green Bay, WI MSA",2025,1,181241,176207,5034,2.8
MT5527500000000,55,27500,"Janesville-Beloit, WI MSA",2025,1,87782,84841,2941,3.4
MT5528450000000,55,28450,"Kenosha, WI MSA",2025,1,96201,92920,3281,3.4
MT5529100000000,55,29100,"La Crosse-Onalaska, WI-MN MSA",2025,1,91524,88985,2539,2.8
MT5531540000000,55,31540,"Madison, WI MSA",2025,1,412275,402009,10266,2.5
MT5533340000000,55,33340,"Milwaukee-Waukesha, WI MSA",2025,1,824429,796252,28177,3.4
MT5536780000000,55,36780,"Oshkosh-Neenah, WI MSA",2025,1,93241,90617,2624,2.8
MT5539540000000,55,39540,"Racine-Mount Pleasant, WI MSA",2025,1,101604,97821,3783,3.7
MT5543100000000,55,43100,"Sheboygan, WI MSA",2025,1,64228,62540,1688,2.6
MT5548140000000,55,48140,"Wausau, WI MSA",2025,1,75087,73072,2015,2.7
MT5616220000000,56,16220,"Casper, WY MSA",2025,1,42387,40865,1522,3.6
MT5616940000000,56,16940,"Cheyenne, WY MSA",2025,1,49284,47483,1801,3.7
MT7210380000000,72,10380,"Aguadilla, PR MSA",2025,1,91318,84876,6442,7.1
MT7211640000000,72,11640,"Arecibo, PR MSA",2025,1,68252,64607,3645,5.3
MT7225020000000,72,25020,"Guayama, PR MSA",2025,1,19198,17425,1773,9.2
MT7232420000000,72,32420,"Mayaguez, PR MSA",2025,1,67837,62798,5039,7.4
MT7238660000000,72,38660,"Ponce, PR MSA",2025,1,90248,82555,7693,8.5
MT7241980000000,72,41980,"San Juan-Bayamon-Caguas, PR MSA",2025,1,824541,787130,37411,4.5
MT0111500000000,1,11500,"Anniston-Oxford, AL MSA",2025,2,50112,48349,1763,3.5
MT0112220000000,1,12220,"Auburn-Opelika, AL MSA",2025,2,97457,94508,2949,3
MT0113820000000,1,13820,"Birmingham, AL MSA",2025,2,573840,556204,17636,3.1
MT0119300000000,1,19300,"Daphne-Fairhope-Foley, AL MSA",2025,2,118787,115400,3387,2.9
MT0119460000000,1,19460,"Decatur, AL MSA",2025,2,77329,75189,2140,2.8
MT0120020000000,1,20020,"Dothan, AL MSA",2025,2,68318,66062,2256,3.3
MT0122520000000,1,22520,"Florence-Muscle Shoals, AL MSA",2025,2,70112,67702,2410,3.4
MT0123460000000,1,23460,"Gadsden, AL MSA",2025,2,42542,41048,1494,3.5
MT0126620000000,1,26620,"Huntsville, AL MSA",2025,2,281032,273275,7757,2.8
MT0133660000000,1,33660,"Mobile, AL MSA",2025,2,188956,181498,7458,3.9
MT0133860000000,1,33860,"Montgomery, AL MSA",2025,2,180534,174623,5911,3.3
MT0146220000000,1,46220,"Tuscaloosa, AL MSA",2025,2,127547,123129,4418,3.5
MT0211260000000,2,11260,"Anchorage, AK MSA",2025,2,202798,194262,8536,4.2
MT0221820000000,2,21820,"Fairbanks-College, AK MSA",2025,2,46247,44392,1855,4
MT0422380000000,4,22380,"Flagstaff, AZ MSA",2025,2,76784,73580,3204,4.2
MT0429420000000,4,29420,"Lake Havasu City-Kingman, AZ MSA",2025,2,88322,84272,4050,4.6
MT0438060000000,4,38060,"Phoenix-Mesa-Chandler, AZ MSA",2025,2,2733295,2639803,93492,3.4
MT0439150000000,4,39150,"Prescott Valley-Prescott, AZ MSA",2025,2,107440,103522,3918,3.6
MT0443420000000,4,43420,"Sierra Vista-Douglas, AZ MSA",2025,2,47940,45763,2177,4.5
MT0446060000000,4,46060,"Tucson, AZ MSA",2025,2,496100,477050,19050,3.8
MT0449740000000,4,49740,"Yuma, AZ MSA",2025,2,99868,86984,12884,12.9
MT0522220000000,5,22220,"Fayetteville-Springdale-Rogers, AR MSA",2025,2,311626,302805,8821,2.8
MT0522900000000,5,22900,"Fort Smith, AR-OK MSA",2025,2,102271,98711,3560,3.5
MT0526300000000,5,26300,"Hot Springs, AR MSA",2025,2,43631,42004,1627,3.7
MT0527860000000,5,27860,"Jonesboro, AR MSA",2025,2,66983,64708,2275,3.4
MT0530780000000,5,30780,"Little Rock-North Little Rock-Conway, AR MSA",2025,2,384221,371356,12865,3.3
MT0612540000000,6,12540,"Bakersfield-Delano, CA MSA",2025,2,412378,377276,35102,8.5
MT0617020000000,6,17020,"Chico, CA MSA",2025,2,92208,86855,5353,5.8
MT0620940000000,6,20940,"El Centro, CA MSA",2025,2,73362,59757,13605,18.5
MT0623420000000,6,23420,"Fresno, CA MSA",2025,2,544302,501836,42466,7.8
MT0625260000000,6,25260,"Hanford-Corcoran, CA MSA",2025,2,58964,53801,5163,8.8
MT0631080000000,6,31080,"Los Angeles-Long Beach-Anaheim, CA MSA",2025,2,6725462,6358527,366935,5.5
MT0632900000000,6,32900,"Merced, CA MSA",2025,2,122467,110634,11833,9.7
MT0633700000000,6,33700,"Modesto, CA MSA",2025,2,258061,240389,17672,6.8
MT0634900000000,6,34900,"Napa, CA MSA",2025,2,76212,73220,2992,3.9
MT0637100000000,6,37100,"Oxnard-Thousand Oaks-Ventura, CA MSA",2025,2,420882,401261,19621,4.7
MT0639820000000,6,39820,"Redding, CA MSA",2025,2,80268,76058,4210,5.2
MT0640140000000,6,40140,"Riverside-San Bernardino-Ontario, CA MSA",2025,2,2221190,2104812,116378,5.2
MT0640900000000,6,40900,"Sacramento-Roseville-Folsom, CA MSA",2025,2,1188240,1132396,55844,4.7
MT0641500000000,6,41500,"Salinas, CA MSA",2025,2,225784,209737,16047,7.1
MT0641740000000,6,41740,"San Diego-Chula Vista-Carlsbad, CA MSA",2025,2,1657790,1584885,72905,4.4
MT0641860000000,6,41860,"San Francisco-Oakland-Fremont, CA MSA",2025,2,2502212,2395677,106535,4.3
MT0641940000000,6,41940,"San Jose-Sunnyvale-Santa Clara, CA MSA",2025,2,1059117,1014394,44723,4.2
MT0642020000000,6,42020,"San Luis Obispo-Paso Robles, CA MSA",2025,2,132877,127408,5469,4.1
MT0642100000000,6,42100,"Santa Cruz-Watsonville, CA MSA",2025,2,137138,128995,8143,5.9
MT0642200000000,6,42200,"Santa Maria-Santa Barbara, CA MSA",2025,2,222981,213137,9844,4.4
MT0642220000000,6,42220,"Santa Rosa-Petaluma, CA MSA",2025,2,247581,237236,10345,4.2
MT0644700000000,6,44700,"Stockton-Lodi, CA MSA",2025,2,372522,348680,23842,6.4
MT0646700000000,6,46700,"Vallejo, CA MSA",2025,2,216901,205938,10963,5.1
MT0647300000000,6,47300,"Visalia, CA MSA",2025,2,222903,200113,22790,10.2
MT0649700000000,6,49700,"Yuba City, CA MSA",2025,2,82358,76071,6287,7.6
MT0814500000000,8,14500,"Boulder, CO MSA",2025,2,194047,185124,8923,4.6
MT0817820000000,8,17820,"Colorado Springs, CO MSA",2025,2,399213,380229,18984,4.8
MT0819740000000,8,19740,"Denver-Aurora-Centennial, CO MSA",2025,2,1784413,1700857,83556,4.7
MT0822660000000,8,22660,"Fort Collins-Loveland, CO MSA",2025,2,208365,198932,9433,4.5
MT0824300000000,8,24300,"Grand Junction, CO MSA",2025,2,80746,76840,3906,4.8
MT0824540000000,8,24540,"Greeley, CO MSA",2025,2,178668,169780,8888,5
MT0839380000000,8,39380,"Pueblo, CO MSA",2025,2,73948,69275,4673,6.3
MT0914860000000,9,14860,"Bridgeport-Stamford-Danbury, CT MSA",2025,2,519754,502881,16873,3.2
MT0925540000000,9,25540,"Hartford-West Hartford-East Hartford, CT MSA",2025,2,615766,594858,20908,3.4
MT0935300000000,9,35300,"New Haven, CT MSA",2025,2,318401,307702,10699,3.4
MT0935980000000,9,35980,"Norwich-New London-Willimantic, CT MSA",2025,2,144464,139716,4748,3.3
MT0947930000000,9,47930,"Waterbury-Shelton, CT MSA",2025,2,242601,233230,9371,3.9
MT1020100000000,10,20100,"Dover, DE MSA",2025,2,85157,81760,3397,4
MT1147900000000,11,47900,"Washington-Arlington-Alexandria, DC-VA-MD-WV MSA",2025,2,3567834,3456479,111355,3.1
MT1215980000000,12,15980,"Cape Coral-Fort Myers, FL MSA",2025,2,375156,360848,14308,3.8
MT1218880000000,12,18880,"Crestview-Fort Walton Beach-Destin, FL MSA",2025,2,144773,140037,4736,3.3
MT1219660000000,12,19660,"Deltona-Daytona Beach-Ormond Beach, FL MSA",2025,2,324146,310879,13267,4.1
MT1223540000000,12,23540,"Gainesville, FL MSA",2025,2,170986,164211,6775,4
MT1226140000000,12,26140,"Homosassa Springs, FL MSA",2025,2,54105,51226,2879,5.3
MT1227260000000,12,27260,"Jacksonville, FL MSA",2025,2,861885,830697,31188,3.6
MT1229460000000,12,29460,"Lakeland-Winter Haven, FL MSA",2025,2,360229,344440,15789,4.4
MT1233100000000,12,33100,"Miami-Fort Lauderdale-West Palm Beach, FL MSA",2025,2,3309673,3209037,100636,3
MT1234940000000,12,34940,"Naples-Marco Island, FL MSA",2025,2,184884,178099,6785,3.7
MT1235840000000,12,35840,"North Port-Bradenton-Sarasota, FL MSA",2025,2,400187,384808,15379,3.8
MT1236100000000,12,36100,"Ocala, FL MSA",2025,2,160163,153184,6979,4.4
MT1236740000000,12,36740,"Orlando-Kissimmee-Sanford, FL MSA",2025,2,1547483,1494328,53155,3.4
MT1237340000000,12,37340,"Palm Bay-Melbourne-Titusville, FL MSA",2025,2,307508,296105,11403,3.7
MT1237460000000,12,37460,"Panama City-Panama City Beach, FL MSA",2025,2,102764,99152,3612,3.5
MT1237860000000,12,37860,"Pensacola-Ferry Pass-Brent, FL MSA",2025,2,241380,232344,9036,3.7
MT1238940000000,12,38940,"Port St. Lucie, FL MSA",2025,2,241728,232034,9694,4
MT1239460000000,12,39460,"Punta Gorda, FL MSA",2025,2,77497,73964,3533,4.6
MT1242680000000,12,42680,"Sebastian-Vero Beach-West Vero Corridor, FL MSA",2025,2,67576,64606,2970,4.4
MT1242700000000,12,42700,"Sebring, FL MSA",2025,2,36838,34919,1919,5.2
MT1245220000000,12,45220,"Tallahassee, FL MSA",2025,2,210067,202384,7683,3.7
MT1245300000000,12,45300,"Tampa-St. Petersburg-Clearwater, FL MSA",2025,2,1707954,1645194,62760,3.7
MT1248680000000,12,48680,"Wildwood-The Villages, FL MSA",2025,2,34572,32474,2098,6.1
MT1310500000000,13,10500,"Albany, GA MSA",2025,2,62034,59442,2592,4.2
MT1312020000000,13,12020,"Athens-Clarke County, GA MSA",2025,2,109379,105818,3561,3.3
MT1312060000000,13,12060,"Atlanta-Sandy Springs-Roswell, GA MSA",2025,2,3296325,3181392,114933,3.5
MT1312260000000,13,12260,"Augusta-Richmond County, GA-SC MSA",2025,2,267372,255493,11879,4.4
MT1315260000000,13,15260,"Brunswick-St. Simons, GA MSA",2025,2,55840,54113,1727,3.1
MT1317980000000,13,17980,"Columbus, GA-AL MSA",2025,2,128738,123444,5294,4.1
MT1319140000000,13,19140,"Dalton, GA MSA",2025,2,67822,65224,2598,3.8
MT1323580000000,13,23580,"Gainesville, GA MSA",2025,2,109175,106083,3092,2.8
MT1325980000000,13,25980,"Hinesville, GA MSA",2025,2,31221,29990,1231,3.9
MT1331420000000,13,31420,"Macon-Bibb County, GA MSA",2025,2,96956,92868,4088,4.2
MT1340660000000,13,40660,"Rome, GA MSA",2025,2,48077,46412,1665,3.5
MT1342340000000,13,42340,"Savannah, GA MSA",2025,2,209564,203200,6364,3
MT1346660000000,13,46660,"Valdosta, GA MSA",2025,2,61525,59082,2443,4
MT1347580000000,13,47580,"Warner Robins, GA MSA",2025,2,90120,87272,2848,3.2
MT1527980000000,15,27980,"Kahului-Wailuku, HI MSA",2025,2,81465,78494,2971,3.6
MT1546520000000,15,46520,"Urban Honolulu, HI MSA",2025,2,474088,460800,13288,2.8
MT1614260000000,16,14260,"Boise City, ID MSA",2025,2,454219,438484,15735,3.5
MT1617660000000,16,17660,"Coeur d'Alene, ID MSA",2025,2,91725,87654,4071,4.4
MT1626820000000,16,26820,"Idaho Falls, ID MSA",2025,2,85433,82757,2676,3.1
MT1630300000000,16,30300,"Lewiston, ID-WA MSA",2025,2,31058,29974,1084,3.5
MT1638540000000,16,38540,"Pocatello, ID MSA",2025,2,41355,39711,1644,4
MT1646300000000,16,46300,"Twin Falls, ID MSA",2025,2,60534,58416,2118,3.5
MT1714010000000,17,14010,"Bloomington, IL MSA",2025,2,95457,91986,3471,3.6
MT1716580000000,17,16580,"Champaign-Urbana, IL MSA",2025,2,124991,120377,4614,3.7
MT1716980000000,17,16980,"Chicago-Naperville-Elgin, IL-IN MSA",2025,2,5040827,4789308,251519,5
MT1719340000000,17,19340,"Davenport-Moline-Rock Island, IA-IL MSA",2025,2,189427,180599,8828,4.7
MT1719500000000,17,19500,"Decatur, IL MSA",2025,2,44214,41787,2427,5.5
MT1728100000000,17,28100,"Kankakee, IL MSA",2025,2,50962,48365,2597,5.1
MT1737900000000,17,37900,"Peoria, IL MSA",2025,2,177488,169360,8128,4.6
MT1740420000000,17,40420,"Rockford, IL MSA",2025,2,160270,152187,8083,5
MT1744100000000,17,44100,"Springfield, IL MSA",2025,2,103985,99864,4121,4
MT1814020000000,18,14020,"Bloomington, IN MSA",2025,2,86239,82960,3279,3.8
MT1818020000000,18,18020,"Columbus, IN MSA",2025,2,40082,38439,1643,4.1
MT1821140000000,18,21140,"Elkhart-Goshen, IN MSA",2025,2,98607,94073,4534,4.6
MT1821780000000,18,21780,"Evansville, IN MSA",2025,2,136971,131614,5357,3.9
MT1823060000000,18,23060,"Fort Wayne, IN MSA",2025,2,234358,225109,9249,3.9
MT1826900000000,18,26900,"Indianapolis-Carmel-Greenwood, IN MSA",2025,2,1153544,1108666,44878,3.9
MT1829020000000,18,29020,"Kokomo, IN MSA",2025,2,36927,34467,2460,6.7
MT1829200000000,18,29200,"Lafayette-West Lafayette, IN MSA",2025,2,120971,116291,4680,3.9
MT1833140000000,18,33140,"Michigan City-La Porte, IN MSA",2025,2,52162,49653,2509,4.8
MT1834620000000,18,34620,"Muncie, IN MSA",2025,2,53605,51124,2481,4.6
MT1843780000000,18,43780,"South Bend-Mishawaka, IN-MI MSA",2025,2,157112,149502,7610,4.8
MT1845460000000,18,45460,"Terre Haute, IN MSA",2025,2,78441,74952,3489,4.4
MT1911180000000,19,11180,"Ames, IA MSA",2025,2,70446,68584,1862,2.6
MT1916300000000,19,16300,"Cedar Rapids, IA MSA",2025,2,146501,141414,5087,3.5
MT1919780000000,19,19780,"Des Moines-West Des Moines, IA MSA",2025,2,414803,401218,13585,3.3
MT1920220000000,19,20220,"Dubuque, IA MSA",2025,2,53746,51951,1795,3.3
MT1926980000000,19,26980,"Iowa City, IA MSA",2025,2,101266,98700,2566,2.5
MT1943580000000,19,43580,"Sioux City, IA-NE-SD MSA",2025,2,76413,74015,2398,3.1
MT1947940000000,19,47940,"Waterloo-Cedar Falls, IA MSA",2025,2,88499,85028,3471,3.9
MT2029940000000,20,29940,"Lawrence, KS MSA",2025,2,72040,69573,2467,3.4
MT2031740000000,20,31740,"Manhattan, KS MSA",2025,2,65072,62744,2328,3.6
MT2045820000000,20,45820,"Topeka, KS MSA",2025,2,119625,115016,4609,3.9
MT2048620000000,20,48620,"Wichita, KS MSA",2025,2,338920,324764,14156,4.2
MT2114540000000,21,14540,"Bowling Green, KY MSA",2025,2,94481,89862,4619,4.9
MT2121060000000,21,21060,"Elizabethtown, KY MSA",2025,2,56138,53047,3091,5.5
MT2130460000000,21,30460,"Lexington-Fayette, KY MSA",2025,2,280975,268772,12203,4.3
MT2131140000000,21,31140,"Louisville/Jefferson County, KY-IN MSA",2025,2,706656,673354,33302,4.7
MT2136980000000,21,36980,"Owensboro, KY MSA",2025,2,53053,50372,2681,5.1
MT2137140000000,21,37140,"Paducah, KY-IL MSA",2025,2,46475,44096,2379,5.1
MT2210780000000,22,10780,"Alexandria, LA MSA",2025,2,64166,61499,2667,4.2
MT2212940000000,22,12940,"Baton Rouge, LA MSA",2025,2,428036,410116,17920,4.2
MT2225220000000,22,25220,"Hammond, LA MSA",2025,2,61017,57976,3041,5
MT2226380000000,22,26380,"Houma-Bayou Cane-Thibodaux, LA MSA",2025,2,87734,84268,3466,4
MT2229180000000,22,29180,"Lafayette, LA MSA",2025,2,197863,190170,7693,3.9
MT2229340000000,22,29340,"Lake Charles, LA MSA",2025,2,97995,93347,4648,4.7
MT2233740000000,22,33740,"Monroe, LA MSA",2025,2,95417,90551,4866,5.1
MT2235380000000,22,35380,"New Orleans-Metairie, LA MSA",2025,2,467049,446345,20704,4.4
MT2243340000000,22,43340,"Shreveport-Bossier City, LA MSA",2025,2,167717,160217,7500,4.5
MT2243640000000,22,43640,"Slidell-Mandeville-Covington, LA MSA",2025,2,129426,124276,5150,4
MT2312620000000,23,12620,"Bangor, ME MSA",2025,2,76423,73557,2866,3.8
MT2330340000000,23,30340,"Lewiston-Auburn, ME MSA",2025,2,55609,53645,1964,3.5
MT2338860000000,23,38860,"Portland-South Portland, ME MSA",2025,2,317241,307992,9249,2.9
MT2412580000000,24,12580,"Baltimore-Columbia-Towson, MD MSA",2025,2,1496408,1450589,45819,3.1
MT2425180000000,24,25180,"Hagerstown-Martinsburg, MD-WV MSA",2025,2,143491,138876,4615,3.2
MT2430500000000,24,30500,"Lexington Park, MD MSA",2025,2,109660,106771,2889,2.6
MT2441540000000,24,41540,"Salisbury, MD MSA",2025,2,64376,62201,2175,3.4
MT2511200000000,25,11200,"Amherst Town-Northampton, MA MSA",2025,2,86670,83197,3473,4
MT2512700000000,25,12700,"Barnstable Town, MA MSA",2025,2,120906,114851,6055,5
MT2514460000000,25,14460,"Boston-Cambridge-Newton, MA-NH MSA",2025,2,2856345,2742489,113856,4
MT2538340000000,25,38340,"Pittsfield, MA MSA",2025,2,64532,61807,2725,4.2
MT2544140000000,25,44140,"Springfield, MA MSA",2025,2,227421,215404,12017,5.3
MT2549340000000,25,49340,"Worcester, MA MSA",2025,2,471508,450552,20956,4.4
MT2611460000000,26,11460,"Ann Arbor, MI MSA",2025,2,211088,201914,9174,4.3
MT2612980000000,26,12980,"Battle Creek, MI MSA",2025,2,65057,61202,3855,5.9
MT2613020000000,26,13020,"Bay City, MI MSA",2025,2,51159,47950,3209,6.3
MT2619820000000,26,19820,"Detroit-Warren-Dearborn, MI MSA",2025,2,2186145,2072886,113259,5.2
MT2622420000000,26,22420,"Flint, MI MSA",2025,2,192212,179610,12602,6.6
MT2624340000000,26,24340,"Grand Rapids-Wyoming-Kentwood, MI MSA",2025,2,635085,606364,28721,4.5
MT2627100000000,26,27100,"Jackson, MI MSA",2025,2,75834,71578,4256,5.6
MT2628020000000,26,28020,"Kalamazoo-Portage, MI MSA",2025,2,142376,135591,6785,4.8
MT2629620000000,26,29620,"Lansing-East Lansing, MI MSA",2025,2,259421,246861,12560,4.8
MT2633220000000,26,33220,"Midland, MI MSA",2025,2,43787,41560,2227,5.1
MT2633780000000,26,33780,"Monroe, MI MSA",2025,2,80398,75410,4988,6.2
MT2634740000000,26,34740,"Muskegon-Norton Shores, MI MSA",2025,2,86604,81400,5204,6
MT2635660000000,26,35660,"Niles, MI MSA",2025,2,78211,73748,4463,5.7
MT2640980000000,26,40980,"Saginaw, MI MSA",2025,2,86213,80338,5875,6.8
MT2645900000000,26,45900,"Traverse City, MI MSA",2025,2,83951,79951,4000,4.8
MT2720260000000,27,20260,"Duluth, MN-WI MSA",2025,2,140499,135479,5020,3.6
MT2731860000000,27,31860,"Mankato, MN MSA",2025,2,60411,58868,1543,2.6
MT2733460000000,27,33460,"Minneapolis-St. Paul-Bloomington, MN-WI MSA",2025,2,2079086,2019437,59649,2.9
MT2740340000000,27,40340,"Rochester, MN MSA",2025,2,130907,127642,3265,2.5
MT2741060000000,27,41060,"St. Cloud, MN MSA",2025,2,111471,107903,3568,3.2
MT2825060000000,28,25060,"Gulfport-Biloxi, MS MSA",2025,2,190848,184267,6581,3.4
MT2825620000000,28,25620,"Hattiesburg, MS MSA",2025,2,71028,68507,2521,3.5
MT2827140000000,28,27140,"Jackson, MS MSA",2025,2,288118,278414,9704,3.4
MT2916020000000,29,16020,"Cape Girardeau, MO-IL MSA",2025,2,49472,47777,1695,3.4
MT2917860000000,29,17860,"Columbia, MO MSA",2025,2,113821,110226,3595,3.2
MT2927620000000,29,27620,"Jefferson City, MO MSA",2025,2,77527,75167,2360,3
MT2927900000000,29,27900,"Joplin, MO-KS MSA",2025,2,98841,95286,3555,3.6
MT2928140000000,29,28140,"Kansas City, MO-KS MSA",2025,2,1205898,1160429,45469,3.8
MT2941140000000,29,41140,"St. Joseph, MO-KS MSA",2025,2,55170,53117,2053,3.7
MT2941180000000,29,41180,"St. Louis, MO-IL MSA",2025,2,1486156,1431066,55090,3.7
MT2944180000000,29,44180,"Springfield, MO MSA",2025,2,246038,237769,8269,3.4
MT3013740000000,30,13740,"Billings, MT MSA",2025,2,99216,96499,2717,2.7
MT3014580000000,30,14580,"Bozeman, MT MSA",2025,2,77786,76139,1647,2.1
MT3024500000000,30,24500,"Great Falls, MT MSA",2025,2,39637,38564,1073,2.7
MT3025740000000,30,25740,"Helena, MT MSA",2025,2,47822,46628,1194,2.5
MT3033540000000,30,33540,"Missoula, MT MSA",2025,2,74544,72550,1994,2.7
MT3124260000000,31,24260,"Grand Island, NE MSA",2025,2,43155,41846,1309,3
MT3130700000000,31,30700,"Lincoln, NE MSA",2025,2,196516,191123,5393,2.7
MT3136540000000,31,36540,"Omaha, NE-IA MSA",2025,2,531719,515165,16554,3.1
MT3216180000000,32,16180,"Carson City, NV MSA",2025,2,29644,28293,1351,4.6
MT3229820000000,32,29820,"Las Vegas-Henderson-North Las Vegas, NV MSA",2025,2,1231319,1157570,73749,6
MT3239900000000,32,39900,"Reno, NV MSA",2025,2,303618,289265,14353,4.7
MT3331700000000,33,31700,"Manchester-Nashua, NH MSA",2025,2,243284,235325,7959,3.3
MT3412100000000,34,12100,"Atlantic City-Hammonton, NJ MSA",2025,2,183543,172092,11451,6.2
MT3445940000000,34,45940,"Trenton-Princeton, NJ MSA",2025,2,199298,190360,8938,4.5
MT3447220000000,34,47220,"Vineland, NJ MSA",2025,2,66315,61696,4619,7
MT3510740000000,35,10740,"Albuquerque, NM MSA",2025,2,468021,449095,18926,4
MT3522140000000,35,22140,"Farmington, NM MSA",2025,2,50045,47652,2393,4.8
MT3529740000000,35,29740,"Las Cruces, NM MSA",2025,2,102864,97665,5199,5.1
MT3542140000000,35,42140,"Santa Fe, NM MSA",2025,2,74539,71628,2911,3.9
MT3610580000000,36,10580,"Albany-Schenectady-Troy, NY MSA",2025,2,456257,441205,15052,3.3
MT3613780000000,36,13780,"Binghamton, NY MSA",2025,2,106015,101878,4137,3.9
MT3615380000000,36,15380,"Buffalo-Cheektowaga, NY MSA",2025,2,556944,534704,22240,4
MT3621300000000,36,21300,"Elmira, NY MSA",2025,2,35043,33695,1348,3.8
MT3624020000000,36,24020,"Glens Falls, NY MSA",2025,2,59331,57281,2050,3.5
MT3627060000000,36,27060,"Ithaca, NY MSA",2025,2,48355,46784,1571,3.2
MT3628740000000,36,28740,"Kingston, NY MSA",2025,2,87305,84271,3034,3.5
MT3628880000000,36,28880,"Kiryas Joel-Poughkeepsie-Newburgh, NY MSA",2025,2,339750,327837,11913,3.5
MT3635620000000,36,35620,"New York-Newark-Jersey City, NY-NJ MSA",2025,2,10223777,9765873,457904,4.5
MT3640380000000,36,40380,"Rochester, NY MSA",2025,2,512426,493917,18509,3.6
MT3645060000000,36,45060,"Syracuse, NY MSA",2025,2,312350,301243,11107,3.6
MT3646540000000,36,46540,"Utica-Rome, NY MSA",2025,2,126323,121530,4793,3.8
MT3648060000000,36,48060,"Watertown-Fort Drum, NY MSA",2025,2,45014,43070,1944,4.3
MT3711700000000,37,11700,"Asheville, NC MSA",2025,2,213340,203638,9702,4.5
MT3715500000000,37,15500,"Burlington, NC MSA",2025,2,86119,83106,3013,3.5
MT3716740000000,37,16740,"Charlotte-Concord-Gastonia, NC-SC MSA",2025,2,1485664,1432101,53563,3.6
MT3720500000000,37,20500,"Durham-Chapel Hill, NC MSA",2025,2,324113,313966,10147,3.1
MT3722180000000,37,22180,"Fayetteville, NC MSA",2025,2,153094,146290,6804,4.4
MT3724140000000,37,24140,"Goldsboro, NC MSA",2025,2,51409,49584,1825,3.5
MT3724660000000,37,24660,"Greensboro-High Point, NC MSA",2025,2,371056,356557,14499,3.9
MT3724780000000,37,24780,"Greenville, NC MSA",2025,2,83291,80033,3258,3.9
MT3725860000000,37,25860,"Hickory-Lenoir-Morganton, NC MSA",2025,2,170173,164031,6142,3.6
MT3727340000000,37,27340,"Jacksonville, NC MSA",2025,2,74049,71350,2699,3.6
MT3738240000000,37,38240,"Pinehurst-Southern Pines, NC MSA",2025,2,44772,43293,1479,3.3
MT3739580000000,37,39580,"Raleigh-Cary, NC MSA",2025,2,850376,824549,25827,3
MT3740580000000,37,40580,"Rocky Mount, NC MSA",2025,2,63011,60053,2958,4.7
MT3748900000000,37,48900,"Wilmington, NC MSA",2025,2,223853,216110,7743,3.5
MT3749180000000,37,49180,"Winston-Salem, NC MSA",2025,2,325088,313490,11598,3.6
MT3813900000000,38,13900,"Bismarck, ND MSA",2025,2,73998,72246,1752,2.4
MT3822020000000,38,22020,"Fargo, ND-MN MSA",2025,2,154503,150743,3760,2.4
MT3824220000000,38,24220,"Grand Forks, ND-MN MSA",2025,2,57594,56146,1448,2.5
MT3833500000000,38,33500,"Minot, ND MSA",2025,2,40219,39186,1033,2.6
MT3910420000000,39,10420,"Akron, OH MSA",2025,2,361812,344532,17280,4.8
MT3915940000000,39,15940,"Canton-Massillon, OH MSA",2025,2,196469,187032,9437,4.8
MT3917140000000,39,17140,"Cincinnati, OH-KY-IN MSA",2025,2,1181598,1128900,52698,4.5
MT3917410000000,39,17410,"Cleveland, OH MSA",2025,2,1106788,1062478,44310,4
MT3918140000000,39,18140,"Columbus, OH MSA",2025,2,1163838,1113792,50046,4.3
MT3919430000000,39,19430,"Dayton-Kettering-Beavercreek, OH MSA",2025,2,397109,378415,18694,4.7
MT3930620000000,39,30620,"Lima, OH MSA",2025,2,47878,45629,2249,4.7
MT3931900000000,39,31900,"Mansfield, OH MSA",2025,2,53862,51046,2816,5.2
MT3941780000000,39,41780,"Sandusky, OH MSA",2025,2,59219,56021,3198,5.4
MT3944220000000,39,44220,"Springfield, OH MSA",2025,2,62348,59083,3265,5.2
MT3945780000000,39,45780,"Toledo, OH MSA",2025,2,298955,282703,16252,5.4
MT3948260000000,39,48260,"Weirton-Steubenville, WV-OH MSA",2025,2,50636,47767,2869,5.7
MT3949660000000,39,49660,"Youngstown-Warren, OH MSA",2025,2,194835,184240,10595,5.4
MT4021420000000,40,21420,"Enid, OK MSA",2025,2,28262,27369,893,3.2
MT4030020000000,40,30020,"Lawton, OK MSA",2025,2,52459,50603,1856,3.5
MT4036420000000,40,36420,"Oklahoma City, OK MSA",2025,2,777653,753581,24072,3.1
MT4046140000000,40,46140,"Tulsa, OK MSA",2025,2,527680,510754,16926,3.2
MT4110540000000,41,10540,"Albany, OR MSA",2025,2,62387,59361,3026,4.9
MT4113460000000,41,13460,"Bend, OR MSA",2025,2,134895,129023,5872,4.4
MT4118700000000,41,18700,"Corvallis, OR MSA",2025,2,49440,47470,1970,4
MT4121660000000,41,21660,"Eugene-Springfield, OR MSA",2025,2,189285,180681,8604,4.5
MT4124420000000,41,24420,"Grants Pass, OR MSA",2025,2,35009,32857,2152,6.1
MT4132780000000,41,32780,"Medford, OR MSA",2025,2,105989,100545,5444,5.1
MT4138900000000,41,38900,"Portland-Vancouver-Hillsboro, OR-WA MSA",2025,2,1382457,1321776,60681,4.4
MT4141420000000,41,41420,"Salem, OR MSA",2025,2,225915,216035,9880,4.4
MT4210900000000,42,10900,"Allentown-Bethlehem-Easton, PA-NJ MSA",2025,2,451492,433573,17919,4
MT4211020000000,42,11020,"Altoona, PA MSA",2025,2,57699,55567,2132,3.7
MT4216540000000,42,16540,"Chambersburg, PA MSA",2025,2,77082,74558,2524,3.3
MT4221500000000,42,21500,"Erie, PA MSA",2025,2,126110,121014,5096,4
MT4223900000000,42,23900,"Gettysburg, PA MSA",2025,2,51282,49622,1660,3.2
MT4225420000000,42,25420,"Harrisburg-Carlisle, PA MSA",2025,2,313886,303216,10670,3.4
MT4227780000000,42,27780,"Johnstown, PA MSA",2025,2,56064,53605,2459,4.4
MT4229540000000,42,29540,"Lancaster, PA MSA",2025,2,290083,281306,8777,3
MT4230140000000,42,30140,"Lebanon, PA MSA",2025,2,73623,71194,2429,3.3
MT4237980000000,42,37980,"Philadelphia-Camden-Wilmington, PA-NJ-DE-MD MSA",2025,2,3281822,3152899,128923,3.9
MT4238300000000,42,38300,"Pittsburgh, PA MSA",2025,2,1228463,1182161,46302,3.8
MT4239740000000,42,39740,"Reading, PA MSA",2025,2,218538,210233,8305,3.8
MT4242540000000,42,42540,"Scranton--Wilkes-Barre, PA MSA",2025,2,278334,266453,11881,4.3
MT4244300000000,42,44300,"State College, PA MSA",2025,2,75977,73745,2232,2.9
MT4248700000000,42,48700,"Williamsport, PA MSA",2025,2,52840,50689,2151,4.1
MT4249620000000,42,49620,"York-Hanover, PA MSA",2025,2,238222,229679,8543,3.6
MT4439300000000,44,39300,"Providence-Warwick, RI-MA MSA",2025,2,904410,860901,43509,4.8
MT4516700000000,45,16700,"Charleston-North Charleston, SC MSA",2025,2,449485,433309,16176,3.6
MT4517900000000,45,17900,"Columbia, SC MSA",2025,2,423521,405989,17532,4.1
MT4522500000000,45,22500,"Florence, SC MSA",2025,2,92845,88661,4184,4.5
MT4524860000000,45,24860,"Greenville-Anderson-Greer, SC MSA",2025,2,482592,463999,18593,3.9
MT4525940000000,45,25940,"Hilton Head Island-Bluffton-Port Royal, SC MSA",2025,2,99601,95738,3863,3.9
MT4534820000000,45,34820,"Myrtle Beach-Conway-North Myrtle Beach, SC MSA",2025,2,172929,164491,8438,4.9
MT4543900000000,45,43900,"Spartanburg, SC MSA",2025,2,179170,171383,7787,4.3
MT4544940000000,45,44940,"Sumter, SC MSA",2025,2,42013,39767,2246,5.3
MT4639660000000,46,39660,"Rapid City, SD MSA",2025,2,81437,79984,1453,1.8
MT4643620000000,46,43620,"Sioux Falls, SD-MN MSA",2025,2,176253,173166,3087,1.8
MT4716860000000,47,16860,"Chattanooga, TN-GA MSA",2025,2,292252,282383,9869,3.4
MT4717300000000,47,17300,"Clarksville, TN-KY MSA",2025,2,141034,134979,6055,4.3
MT4717420000000,47,17420,"Cleveland, TN MSA",2025,2,56318,54100,2218,3.9
MT4727180000000,47,27180,"Jackson, TN MSA",2025,2,79042,75822,3220,4.1
MT4727740000000,47,27740,"Johnson City, TN MSA",2025,2,97450,93763,3687,3.8
MT4728700000000,47,28700,"Kingsport-Bristol, TN-VA MSA",2025,2,133630,128640,4990,3.7
MT4728940000000,47,28940,"Knoxville, TN MSA",2025,2,456877,441740,15137,3.3
MT4732820000000,47,32820,"Memphis, TN-MS-AR MSA",2025,2,627221,599128,28093,4.5
MT4734100000000,47,34100,"Morristown, TN MSA",2025,2,54304,52312,1992,3.7
MT4734980000000,47,34980,"Nashville-Davidson--Murfreesboro--Franklin, TN MSA",2025,2,1168419,1132367,36052,3.1
MT4810180000000,48,10180,"Abilene, TX MSA",2025,2,87842,84869,2973,3.4
MT4811100000000,48,11100,"Amarillo, TX MSA",2025,2,139736,135457,4279,3.1
MT4812420000000,48,12420,"Austin-Round Rock-San Marcos, TX MSA",2025,2,1519782,1467024,52758,3.5
MT4813140000000,48,13140,"Beaumont-Port Arthur, TX MSA",2025,2,185156,175422,9734,5.3
MT4815180000000,48,15180,"Brownsville-Harlingen, TX MSA",2025,2,192014,182090,9924,5.2
MT4817780000000,48,17780,"College Station-Bryan, TX MSA",2025,2,154323,148885,5438,3.5
MT4818580000000,48,18580,"Corpus Christi, TX MSA",2025,2,211758,202672,9086,4.3
MT4819100000000,48,19100,"Dallas-Fort Worth-Arlington, TX MSA",2025,2,4529031,4354024,175007,3.9
MT4820580000000,48,20580,"Eagle Pass, TX MSA",2025,2,24411,22523,1888,7.7
MT4821340000000,48,21340,"El Paso, TX MSA",2025,2,419951,402590,17361,4.1
MT4826420000000,48,26420,"Houston-Pasadena-The Woodlands, TX MSA",2025,2,3875072,3707309,167763,4.3
MT4828660000000,48,28660,"Killeen-Temple, TX MSA",2025,2,203297,194193,9104,4.5
MT4829700000000,48,29700,"Laredo, TX MSA",2025,2,120419,115364,5055,4.2
MT4830980000000,48,30980,"Longview, TX MSA",2025,2,129785,123582,6203,4.8
MT4831180000000,48,31180,"Lubbock, TX MSA",2025,2,186682,180066,6616,3.5
MT4832580000000,48,32580,"McAllen-Edinburg-Mission, TX MSA",2025,2,399628,376095,23533,5.9
MT4833260000000,48,33260,"Midland, TX MSA",2025,2,105031,101916,3115,3
MT4836220000000,48,36220,"Odessa, TX MSA",2025,2,87373,84219,3154,3.6
MT4841660000000,48,41660,"San Angelo, TX MSA",2025,2,63051,60991,2060,3.3
MT4841700000000,48,41700,"San Antonio-New Braunfels, TX MSA",2025,2,1354834,1303621,51213,3.8
MT4843300000000,48,43300,"Sherman-Denison, TX MSA",2025,2,71997,69272,2725,3.8
MT4845500000000,48,45500,"Texarkana, TX-AR MSA",2025,2,62615,60045,2570,4.1
MT4846340000000,48,46340,"Tyler, TX MSA",2025,2,119449,114927,4522,3.8
MT4847020000000,48,47020,"Victoria, TX MSA",2025,2,45389,43550,1839,4.1
MT4847380000000,48,47380,"Waco, TX MSA",2025,2,148584,142914,5670,3.8
MT4848660000000,48,48660,"Wichita Falls, TX MSA",2025,2,67212,64687,2525,3.8
MT4930860000000,49,30860,"Logan, UT-ID MSA",2025,2,80881,78640,2241,2.8
MT4936260000000,49,36260,"Ogden, UT MSA",2025,2,354780,344217,10563,3
MT4939340000000,49,39340,"Provo-Orem-Lehi, UT MSA",2025,2,372251,360295,11956,3.2
MT4941100000000,49,41100,"St. George, UT MSA",2025,2,95363,92329,3034,3.2
MT4941620000000,49,41620,"Salt Lake City-Murray, UT MSA",2025,2,740395,716616,23779,3.2
MT5015540000000,50,15540,"Burlington-South Burlington, VT MSA",2025,2,132042,129079,2963,2.2
MT5113980000000,51,13980,"Blacksburg-Christiansburg-Radford, VA MSA",2025,2,92721,89541,3180,3.4
MT5116820000000,51,16820,"Charlottesville, VA MSA",2025,2,121512,118267,3245,2.7
MT5125500000000,51,25500,"Harrisonburg, VA MSA",2025,2,71804,69667,2137,3
MT5131340000000,51,31340,"Lynchburg, VA MSA",2025,2,127113,122800,4313,3.4
MT5140060000000,51,40060,"Richmond, VA MSA",2025,2,729451,707127,22324,3.1
MT5140220000000,51,40220,"Roanoke, VA MSA",2025,2,159065,154261,4804,3
MT5144420000000,51,44420,"Staunton-Stuarts Draft, VA MSA",2025,2,65218,63467,1751,2.7
MT5147260000000,51,47260,"Virginia Beach-Chesapeake-Norfolk, VA-NC MSA",2025,2,883667,855367,28300,3.2
MT5149020000000,51,49020,"Winchester, VA-WV MSA",2025,2,77803,75606,2197,2.8
MT5313380000000,53,13380,"Bellingham, WA MSA",2025,2,110876,105953,4923,4.4
MT5314740000000,53,14740,"Bremerton-Silverdale-Port Orchard, WA MSA",2025,2,120559,115220,5339,4.4
MT5328420000000,53,28420,"Kennewick-Richland, WA MSA",2025,2,148070,141037,7033,4.7
MT5331020000000,53,31020,"Longview-Kelso, WA MSA",2025,2,46967,44528,2439,5.2
MT5334580000000,53,34580,"Mount Vernon-Anacortes, WA MSA",2025,2,58791,56006,2785,4.7
MT5336500000000,53,36500,"Olympia-Lacey-Tumwater, WA MSA",2025,2,143216,136792,6424,4.5
MT5342660000000,53,42660,"Seattle-Tacoma-Bellevue, WA MSA",2025,2,2355077,2258847,96230,4.1
MT5344060000000,53,44060,"Spokane-Spokane Valley, WA MSA",2025,2,276430,263994,12436,4.5
MT5347460000000,53,47460,"Walla Walla, WA MSA",2025,2,28752,27604,1148,4
MT5348300000000,53,48300,"Wenatchee-East Wenatchee, WA MSA",2025,2,61232,58399,2833,4.6
MT5349420000000,53,49420,"Yakima, WA MSA",2025,2,122908,115794,7114,5.8
MT5413220000000,54,13220,"Beckley, WV MSA",2025,2,45740,44026,1714,3.7
MT5416620000000,54,16620,"Charleston, WV MSA",2025,2,89714,86269,3445,3.8
MT5426580000000,54,26580,"Huntington-Ashland, WV-KY-OH MSA",2025,2,157524,149671,7853,5
MT5434060000000,54,34060,"Morgantown, WV MSA",2025,2,70805,68483,2322,3.3
MT5437620000000,54,37620,"Parkersburg-Vienna, WV MSA",2025,2,38927,37375,1552,4
MT5448540000000,54,48540,"Wheeling, WV-OH MSA",2025,2,59548,56820,2728,4.6
MT5511540000000,55,11540,"Appleton, WI MSA",2025,2,137851,134187,3664,2.7
MT5520740000000,55,20740,"Eau Claire, WI MSA",2025,2,96971,93975,2996,3.1
MT5522540000000,55,22540,"Fond du Lac, WI MSA",2025,2,55294,53623,1671,3
MT5524580000000,55,24580,"Green Bay, WI MSA",2025,2,181207,176175,5032,2.8
MT5527500000000,55,27500,"Janesville-Beloit, WI MSA",2025,2,87733,84764,2969,3.4
MT5528450000000,55,28450,"Kenosha, WI MSA",2025,2,96082,92769,3313,3.4
MT5529100000000,55,29100,"La Crosse-Onalaska, WI-MN MSA",2025,2,91441,88943,2498,2.7
MT5531540000000,55,31540,"Madison, WI MSA",2025,2,411294,401090,10204,2.5
MT5533340000000,55,33340,"Milwaukee-Waukesha, WI MSA",2025,2,822473,794018,28455,3.5
MT5536780000000,55,36780,"Oshkosh-Neenah, WI MSA",2025,2,93121,90479,2642,2.8
MT5539540000000,55,39540,"Racine-Mount Pleasant, WI MSA",2025,2,101340,97536,3804,3.8
MT5543100000000,55,43100,"Sheboygan, WI MSA",2025,2,64216,62522,1694,2.6
MT5548140000000,55,48140,"Wausau, WI MSA",2025,2,74997,72974,2023,2.7
MT5616220000000,56,16220,"Casper, WY MSA",2025,2,42292,40824,1468,3.5
MT5616940000000,56,16940,"Cheyenne, WY MSA",2025,2,49180,47433,1747,3.6
MT7210380000000,72,10380,"Aguadilla, PR MSA",2025,2,91265,84871,6394,7
MT7211640000000,72,11640,"Arecibo, PR MSA",2025,2,68341,64691,3650,5.3
MT7225020000000,72,25020,"Guayama, PR MSA",2025,2,19151,17404,1747,9.1
MT7232420000000,72,32420,"Mayaguez, PR MSA",2025,2,68018,62917,5101,7.5
MT7238660000000,72,38660,"Ponce, PR MSA",2025,2,90215,82560,7655,8.5
MT7241980000000,72,41980,"San Juan-Bayamon-Caguas, PR MSA",2025,2,824032,787071,36961,4.5
MT0111500000000,1,11500,"Anniston-Oxford, AL MSA",2025,3,50194,48401,1793,3.6
MT0112220000000,1,12220,"Auburn-Opelika, AL MSA",2025,3,97776,94779,2997,3.1
MT0113820000000,1,13820,"Birmingham, AL MSA",2025,3,575492,557606,17886,3.1
MT0119300000000,1,19300,"Daphne-Fairhope-Foley, AL MSA",2025,3,118671,115240,3431,2.9
MT0119460000000,1,19460,"Decatur, AL MSA",2025,3,77456,75306,2150,2.8
MT0120020000000,1,20020,"Dothan, AL MSA",2025,3,68455,66179,2276,3.3
MT0122520000000,1,22520,"Florence-Muscle Shoals, AL MSA",2025,3,70377,67946,2431,3.5
MT0123460000000,1,23460,"Gadsden, AL MSA",2025,3,42657,41159,1498,3.5
MT0126620000000,1,26620,"Huntsville, AL MSA",2025,3,281936,274058,7878,2.8
MT0133660000000,1,33660,"Mobile, AL MSA",2025,3,189472,181897,7575,4
MT0133860000000,1,33860,"Montgomery, AL MSA",2025,3,181113,175122,5991,3.3
MT0146220000000,1,46220,"Tuscaloosa, AL MSA",2025,3,127854,123394,4460,3.5
MT0211260000000,2,11260,"Anchorage, AK MSA",2025,3,203184,194837,8347,4.1
MT0221820000000,2,21820,"Fairbanks-College, AK MSA",2025,3,46332,44520,1812,3.9
MT0422380000000,4,22380,"Flagstaff, AZ MSA",2025,3,76998,73734,3264,4.2
MT0429420000000,4,29420,"Lake Havasu City-Kingman, AZ MSA",2025,3,88332,84170,4162,4.7
MT0438060000000,4,38060,"Phoenix-Mesa-Chandler, AZ MSA",2025,3,2734980,2639187,95793,3.5
MT0439150000000,4,39150,"Prescott Valley-Prescott, AZ MSA",2025,3,107324,103263,4061,3.8
MT0443420000000,4,43420,"Sierra Vista-Douglas, AZ MSA",2025,3,48026,45792,2234,4.7
MT0446060000000,4,46060,"Tucson, AZ MSA",2025,3,496285,476661,19624,4
MT0449740000000,4,49740,"Yuma, AZ MSA",2025,3,100499,87242,13257,13.2
MT0522220000000,5,22220,"Fayetteville-Springdale-Rogers, AR MSA",2025,3,312332,303378,8954,2.9
MT0522900000000,5,22900,"Fort Smith, AR-OK MSA",2025,3,102308,98717,3591,3.5
MT0526300000000,5,26300,"Hot Springs, AR MSA",2025,3,43576,41936,1640,3.8
MT0527860000000,5,27860,"Jonesboro, AR MSA",2025,3,67062,64738,2324,3.5
MT0530780000000,5,30780,"Little Rock-North Little Rock-Conway, AR MSA",2025,3,384604,371588,13016,3.4
MT0612540000000,6,12540,"Bakersfield-Delano, CA MSA",2025,3,413530,378529,35001,8.5
MT0617020000000,6,17020,"Chico, CA MSA",2025,3,92526,87235,5291,5.7
MT0620940000000,6,20940,"El Centro, CA MSA",2025,3,73468,59889,13579,18.5
MT0623420000000,6,23420,"Fresno, CA MSA",2025,3,546379,503902,42477,7.8
MT0625260000000,6,25260,"Hanford-Corcoran, CA MSA",2025,3,59144,54002,5142,8.7
MT0631080000000,6,31080,"Los Angeles-Long Beach-Anaheim, CA MSA",2025,3,6706656,6346596,360060,5.4
MT0632900000000,6,32900,"Merced, CA MSA",2025,3,123010,111174,11836,9.6
MT0633700000000,6,33700,"Modesto, CA MSA",2025,3,258931,241301,17630,6.8
MT0634900000000,6,34900,"Napa, CA MSA",2025,3,76599,73594,3005,3.9
MT0637100000000,6,37100,"Oxnard-Thousand Oaks-Ventura, CA MSA",2025,3,422094,402512,19582,4.6
MT0639820000000,6,39820,"Redding, CA MSA",2025,3,80576,76390,4186,5.2
MT0640140000000,6,40140,"Riverside-San Bernardino-Ontario, CA MSA",2025,3,2224012,2108229,115783,5.2
MT0640900000000,6,40900,"Sacramento-Roseville-Folsom, CA MSA",2025,3,1191225,1135875,55350,4.6
MT0641500000000,6,41500,"Salinas, CA MSA",2025,3,227195,211071,16124,7.1
MT0641740000000,6,41740,"San Diego-Chula Vista-Carlsbad, CA MSA",2025,3,1662256,1589881,72375,4.4
MT0641860000000,6,41860,"San Francisco-Oakland-Fremont, CA MSA",2025,3,2505797,2400156,105641,4.2
MT0641940000000,6,41940,"San Jose-Sunnyvale-Santa Clara, CA MSA",2025,3,1060810,1016596,44214,4.2
MT0642020000000,6,42020,"San Luis Obispo-Paso Robles, CA MSA",2025,3,133185,127748,5437,4.1
MT0642100000000,6,42100,"Santa Cruz-Watsonville, CA MSA",2025,3,137501,129386,8115,5.9
MT0642200000000,6,42200,"Santa Maria-Santa Barbara, CA MSA",2025,3,223566,213759,9807,4.4
MT0642220000000,6,42220,"Santa Rosa-Petaluma, CA MSA",2025,3,248232,237994,10238,4.1
MT0644700000000,6,44700,"Stockton-Lodi, CA MSA",2025,3,373213,349499,23714,6.4
MT0646700000000,6,46700,"Vallejo, CA MSA",2025,3,217332,206471,10861,5
MT0647300000000,6,47300,"Visalia, CA MSA",2025,3,223586,200771,22815,10.2
MT0649700000000,6,49700,"Yuba City, CA MSA",2025,3,82603,76378,6225,7.5
MT0814500000000,8,14500,"Boulder, CO MSA",2025,3,194039,185134,8905,4.6
MT0817820000000,8,17820,"Colorado Springs, CO MSA",2025,3,399190,380262,18928,4.7
MT0819740000000,8,19740,"Denver-Aurora-Centennial, CO MSA",2025,3,1780364,1697592,82772,4.6
MT0822660000000,8,22660,"Fort Collins-Loveland, CO MSA",2025,3,208215,198765,9450,4.5
MT0824300000000,8,24300,"Grand Junction, CO MSA",2025,3,80684,76796,3888,4.8
MT0824540000000,8,24540,"Greeley, CO MSA",2025,3,178890,170053,8837,4.9
MT0839380000000,8,39380,"Pueblo, CO MSA",2025,3,73793,69191,4602,6.2
MT0914860000000,9,14860,"Bridgeport-Stamford-Danbury, CT MSA",2025,3,519839,502207,17632,3.4
MT0925540000000,9,25540,"Hartford-West Hartford-East Hartford, CT MSA",2025,3,615582,593742,21840,3.5
MT0935300000000,9,35300,"New Haven, CT MSA",2025,3,318295,307102,11193,3.5
MT0935980000000,9,35980,"Norwich-New London-Willimantic, CT MSA",2025,3,144505,139563,4942,3.4
MT0947930000000,9,47930,"Waterbury-Shelton, CT MSA",2025,3,242546,232836,9710,4
MT1020100000000,10,20100,"Dover, DE MSA",2025,3,85206,81725,3481,4.1
MT1147900000000,11,47900,"Washington-Arlington-Alexandria, DC-VA-MD-WV MSA",2025,3,3563705,3449034,114671,3.2
MT1215980000000,12,15980,"Cape Coral-Fort Myers, FL MSA",2025,3,374683,360190,14493,3.9
MT1218880000000,12,18880,"Crestview-Fort Walton Beach-Destin, FL MSA",2025,3,144629,139843,4786,3.3
MT1219660000000,12,19660,"Deltona-Daytona Beach-Ormond Beach, FL MSA",2025,3,324247,310892,13355,4.1
MT1223540000000,12,23540,"Gainesville, FL MSA",2025,3,171514,164602,6912,4
MT1226140000000,12,26140,"Homosassa Springs, FL MSA",2025,3,54045,51156,2889,5.3
MT1227260000000,12,27260,"Jacksonville, FL MSA",2025,3,862521,830955,31566,3.7
MT1229460000000,12,29460,"Lakeland-Winter Haven, FL MSA",2025,3,360155,344161,15994,4.4
MT1233100000000,12,33100,"Miami-Fort Lauderdale-West Palm Beach, FL MSA",2025,3,3307774,3205774,102000,3.1
MT1234940000000,12,34940,"Naples-Marco Island, FL MSA",2025,3,184498,177573,6925,3.8
MT1235840000000,12,35840,"North Port-Bradenton-Sarasota, FL MSA",2025,3,400478,384995,15483,3.9
MT1236100000000,12,36100,"Ocala, FL MSA",2025,3,160239,153226,7013,4.4
MT1236740000000,12,36740,"Orlando-Kissimmee-Sanford, FL MSA",2025,3,1550280,1496373,53907,3.5
MT1237340000000,12,37340,"Palm Bay-Melbourne-Titusville, FL MSA",2025,3,307829,296276,11553,3.8
MT1237460000000,12,37460,"Panama City-Panama City Beach, FL MSA",2025,3,102702,99050,3652,3.6
MT1237860000000,12,37860,"Pensacola-Ferry Pass-Brent, FL MSA",2025,3,241691,232520,9171,3.8
MT1238940000000,12,38940,"Port St. Lucie, FL MSA",2025,3,241295,231500,9795,4.1
MT1239460000000,12,39460,"Punta Gorda, FL MSA",2025,3,77525,73981,3544,4.6
MT1242680000000,12,42680,"Sebastian-Vero Beach-West Vero Corridor, FL MSA",2025,3,67467,64464,3003,4.5
MT1242700000000,12,42700,"Sebring, FL MSA",2025,3,36776,34839,1937,5.3
MT1245220000000,12,45220,"Tallahassee, FL MSA",2025,3,210461,202637,7824,3.7
MT1245300000000,12,45300,"Tampa-St. Petersburg-Clearwater, FL MSA",2025,3,1708733,1645717,63016,3.7
MT1248680000000,12,48680,"Wildwood-The Villages, FL MSA",2025,3,34551,32448,2103,6.1
MT1310500000000,13,10500,"Albany, GA MSA",2025,3,62018,59408,2610,4.2
MT1312020000000,13,12020,"Athens-Clarke County, GA MSA",2025,3,109525,105946,3579,3.3
MT1312060000000,13,12060,"Atlanta-Sandy Springs-Roswell, GA MSA",2025,3,3293935,3178370,115565,3.5
MT1312260000000,13,12260,"Augusta-Richmond County, GA-SC MSA",2025,3,267169,255444,11725,4.4
MT1315260000000,13,15260,"Brunswick-St. Simons, GA MSA",2025,3,55769,54026,1743,3.1
MT1317980000000,13,17980,"Columbus, GA-AL MSA",2025,3,128703,123365,5338,4.1
MT1319140000000,13,19140,"Dalton, GA MSA",2025,3,67607,65042,2565,3.8
MT1323580000000,13,23580,"Gainesville, GA MSA",2025,3,109228,106098,3130,2.9
MT1325980000000,13,25980,"Hinesville, GA MSA",2025,3,31142,29901,1241,4
MT1331420000000,13,31420,"Macon-Bibb County, GA MSA",2025,3,96874,92793,4081,4.2
MT1340660000000,13,40660,"Rome, GA MSA",2025,3,48036,46354,1682,3.5
MT1342340000000,13,42340,"Savannah, GA MSA",2025,3,209220,202817,6403,3.1
MT1346660000000,13,46660,"Valdosta, GA MSA",2025,3,61327,58877,2450,4
MT1347580000000,13,47580,"Warner Robins, GA MSA",2025,3,89994,87109,2885,3.2
MT1527980000000,15,27980,"Kahului-Wailuku, HI MSA",2025,3,81527,78700,2827,3.5
MT1546520000000,15,46520,"Urban Honolulu, HI MSA",2025,3,475342,462423,12919,2.7
MT1614260000000,16,14260,"Boise City, ID MSA",2025,3,454462,438848,15614,3.4
MT1617660000000,16,17660,"Coeur d'Alene, ID MSA",2025,3,91907,87888,4019,4.4
MT1626820000000,16,26820,"Idaho Falls, ID MSA",2025,3,85611,82922,2689,3.1
MT1630300000000,16,30300,"Lewiston, ID-WA MSA",2025,3,31030,29975,1055,3.4
MT1638540000000,16,38540,"Pocatello, ID MSA",2025,3,41419,39788,1631,3.9
MT1646300000000,16,46300,"Twin Falls, ID MSA",2025,3,60490,58393,2097,3.5
MT1714010000000,17,14010,"Bloomington, IL MSA",2025,3,95076,91719,3357,3.5
MT1716580000000,17,16580,"Champaign-Urbana, IL MSA",2025,3,124800,120344,4456,3.6
MT1716980000000,17,16980,"Chicago-Naperville-Elgin, IL-IN MSA",2025,3,5044476,4790648,253828,5
MT1719340000000,17,19340,"Davenport-Moline-Rock Island, IA-IL MSA",2025,3,188820,180299,8521,4.5
MT1719500000000,17,19500,"Decatur, IL MSA",2025,3,44044,41673,2371,5.4
MT1728100000000,17,28100,"Kankakee, IL MSA",2025,3,50791,48303,2488,4.9
MT1737900000000,17,37900,"Peoria, IL MSA",2025,3,176823,168972,7851,4.4
MT1740420000000,17,40420,"Rockford, IL MSA",2025,3,159865,152152,7713,4.8
MT1744100000000,17,44100,"Springfield, IL MSA",2025,3,103922,99912,4010,3.9
MT1814020000000,18,14020,"Bloomington, IN MSA",2025,3,86324,83231,3093,3.6
MT1818020000000,18,18020,"Columbus, IN MSA",2025,3,40109,38572,1537,3.8
MT1821140000000,18,21140,"Elkhart-Goshen, IN MSA",2025,3,98424,94208,4216,4.3
MT1821780000000,18,21780,"Evansville, IN MSA",2025,3,136865,131841,5024,3.7
MT1823060000000,18,23060,"Fort Wayne, IN MSA",2025,3,234085,225366,8719,3.7
MT1826900000000,18,26900,"Indianapolis-Carmel-Greenwood, IN MSA",2025,3,1152932,1110701,42231,3.7
MT1829020000000,18,29020,"Kokomo, IN MSA",2025,3,36775,34490,2285,6.2
MT1829200000000,18,29200,"Lafayette-West Lafayette, IN MSA",2025,3,120809,116353,4456,3.7
MT1833140000000,18,33140,"Michigan City-La Porte, IN MSA",2025,3,52108,49758,2350,4.5
MT1834620000000,18,34620,"Muncie, IN MSA",2025,3,53614,51279,2335,4.4
MT1843780000000,18,43780,"South Bend-Mishawaka, IN-MI MSA",2025,3,156949,149735,7214,4.6
MT1845460000000,18,45460,"Terre Haute, IN MSA",2025,3,78403,75147,3256,4.2
MT1911180000000,19,11180,"Ames, IA MSA",2025,3,70592,68661,1931,2.7
MT1916300000000,19,16300,"Cedar Rapids, IA MSA",2025,3,146687,141437,5250,3.6
MT1919780000000,19,19780,"Des Moines-West Des Moines, IA MSA",2025,3,414995,401071,13924,3.4
MT1920220000000,19,20220,"Dubuque, IA MSA",2025,3,53801,51963,1838,3.4
MT1926980000000,19,26980,"Iowa City, IA MSA",2025,3,101613,98931,2682,2.6
MT1943580000000,19,43580,"Sioux City, IA-NE-SD MSA",2025,3,76296,73865,2431,3.2
MT1947940000000,19,47940,"Waterloo-Cedar Falls, IA MSA",2025,3,88389,84914,3475,3.9
MT2029940000000,20,29940,"Lawrence, KS MSA",2025,3,72164,69698,2466,3.4
MT2031740000000,20,31740,"Manhattan, KS MSA",2025,3,65116,62769,2347,3.6
MT2045820000000,20,45820,"Topeka, KS MSA",2025,3,119549,114983,4566,3.8
MT2048620000000,20,48620,"Wichita, KS MSA",2025,3,338504,324600,13904,4.1
MT2114540000000,21,14540,"Bowling Green, KY MSA",2025,3,94593,89971,4622,4.9
MT2121060000000,21,21060,"Elizabethtown, KY MSA",2025,3,56171,53089,3082,5.5
MT2130460000000,21,30460,"Lexington-Fayette, KY MSA",2025,3,281561,269330,12231,4.3
MT2131140000000,21,31140,"Louisville/Jefferson County, KY-IN MSA",2025,3,706782,673922,32860,4.6
MT2136980000000,21,36980,"Owensboro, KY MSA",2025,3,53093,50439,2654,5
MT2137140000000,21,37140,"Paducah, KY-IL MSA",2025,3,46446,44099,2347,5.1
MT2210780000000,22,10780,"Alexandria, LA MSA",2025,3,64135,61463,2672,4.2
MT2212940000000,22,12940,"Baton Rouge, LA MSA",2025,3,428499,410518,17981,4.2
MT2225220000000,22,25220,"Hammond, LA MSA",2025,3,61082,58028,3054,5
MT2226380000000,22,26380,"Houma-Bayou Cane-Thibodaux, LA MSA",2025,3,87622,84143,3479,4
MT2229180000000,22,29180,"Lafayette, LA MSA",2025,3,197924,190227,7697,3.9
MT2229340000000,22,29340,"Lake Charles, LA MSA",2025,3,98035,93372,4663,4.8
MT2233740000000,22,33740,"Monroe, LA MSA",2025,3,95342,90496,4846,5.1
MT2235380000000,22,35380,"New Orleans-Metairie, LA MSA",2025,3,466597,445828,20769,4.5
MT2243340000000,22,43340,"Shreveport-Bossier City, LA MSA",2025,3,167727,160194,7533,4.5
MT2243640000000,22,43640,"Slidell-Mandeville-Covington, LA MSA",2025,3,129430,124238,5192,4
MT2312620000000,23,12620,"Bangor, ME MSA",2025,3,76240,73421,2819,3.7
MT2330340000000,23,30340,"Lewiston-Auburn, ME MSA",2025,3,55451,53512,1939,3.5
MT2338860000000,23,38860,"Portland-South Portland, ME MSA",2025,3,316846,307691,9155,2.9
MT2412580000000,24,12580,"Baltimore-Columbia-Towson, MD MSA",2025,3,1494683,1449005,45678,3.1
MT2425180000000,24,25180,"Hagerstown-Martinsburg, MD-WV MSA",2025,3,143170,138596,4574,3.2
MT2430500000000,24,30500,"Lexington Park, MD MSA",2025,3,109300,106408,2892,2.6
MT2441540000000,24,41540,"Salisbury, MD MSA",2025,3,64361,62198,2163,3.4
MT2511200000000,25,11200,"Amherst Town-Northampton, MA MSA",2025,3,86844,83251,3593,4.1
MT2512700000000,25,12700,"Barnstable Town, MA MSA",2025,3,121533,115297,6236,5.1
MT2514460000000,25,14460,"Boston-Cambridge-Newton, MA-NH MSA",2025,3,2858294,2740922,117372,4.1
MT2538340000000,25,38340,"Pittsfield, MA MSA",2025,3,64590,61800,2790,4.3
MT2544140000000,25,44140,"Springfield, MA MSA",2025,3,227759,215459,12300,5.4
MT2549340000000,25,49340,"Worcester, MA MSA",2025,3,471964,450360,21604,4.6
MT2611460000000,26,11460,"Ann Arbor, MI MSA",2025,3,211249,201798,9451,4.5
MT2612980000000,26,12980,"Battle Creek, MI MSA",2025,3,64997,61092,3905,6
MT2613020000000,26,13020,"Bay City, MI MSA",2025,3,51181,47920,3261,6.4
MT2619820000000,26,19820,"Detroit-Warren-Dearborn, MI MSA",2025,3,2188869,2073637,115232,5.3
MT2622420000000,26,22420,"Flint, MI MSA",2025,3,192304,179450,12854,6.7
MT2624340000000,26,24340,"Grand Rapids-Wyoming-Kentwood, MI MSA",2025,3,633693,604721,28972,4.6
MT2627100000000,26,27100,"Jackson, MI MSA",2025,3,75797,71487,4310,5.7
MT2628020000000,26,28020,"Kalamazoo-Portage, MI MSA",2025,3,142329,135449,6880,4.8
MT2629620000000,26,29620,"Lansing-East Lansing, MI MSA",2025,3,259642,246864,12778,4.9
MT2633220000000,26,33220,"Midland, MI MSA",2025,3,43817,41576,2241,5.1
MT2633780000000,26,33780,"Monroe, MI MSA",2025,3,80240,75264,4976,6.2
MT2634740000000,26,34740,"Muskegon-Norton Shores, MI MSA",2025,3,86580,81304,5276,6.1
MT2635660000000,26,35660,"Niles, MI MSA",2025,3,78090,73598,4492,5.8
MT2640980000000,26,40980,"Saginaw, MI MSA",2025,3,86191,80216,5975,6.9
MT2645900000000,26,45900,"Traverse City, MI MSA",2025,3,84089,80087,4002,4.8
MT2720260000000,27,20260,"Duluth, MN-WI MSA",2025,3,140738,135509,5229,3.7
MT2731860000000,27,31860,"Mankato, MN MSA",2025,3,60447,58853,1594,2.6
MT2733460000000,27,33460,"Minneapolis-St. Paul-Bloomington, MN-WI MSA",2025,3,2081536,2020098,61438,3
MT2740340000000,27,40340,"Rochester, MN MSA",2025,3,131638,128261,3377,2.6
MT2741060000000,27,41060,"St. Cloud, MN MSA",2025,3,111543,107861,3682,3.3
MT2825060000000,28,25060,"Gulfport-Biloxi, MS MSA",2025,3,191170,184345,6825,3.6
MT2825620000000,28,25620,"Hattiesburg, MS MSA",2025,3,71229,68624,2605,3.7
MT2827140000000,28,27140,"Jackson, MS MSA",2025,3,289068,279022,10046,3.5
MT2916020000000,29,16020,"Cape Girardeau, MO-IL MSA",2025,3,49569,47833,1736,3.5
MT2917860000000,29,17860,"Columbia, MO MSA",2025,3,114076,110362,3714,3.3
MT2927620000000,29,27620,"Jefferson City, MO MSA",2025,3,77719,75328,2391,3.1
MT2927900000000,29,27900,"Joplin, MO-KS MSA",2025,3,98803,95159,3644,3.7
MT2928140000000,29,28140,"Kansas City, MO-KS MSA",2025,3,1205647,1159448,46199,3.8
MT2941140000000,29,41140,"St. Joseph, MO-KS MSA",2025,3,55296,53231,2065,3.7
MT2941180000000,29,41180,"St. Louis, MO-IL MSA",2025,3,1485647,1430062,55585,3.7
MT2944180000000,29,44180,"Springfield, MO MSA",2025,3,246560,238082,8478,3.4
MT3013740000000,30,13740,"Billings, MT MSA",2025,3,99080,96396,2684,2.7
MT3014580000000,30,14580,"Bozeman, MT MSA",2025,3,77576,75975,1601,2.1
MT3024500000000,30,24500,"Great Falls, MT MSA",2025,3,39630,38595,1035,2.6
MT3025740000000,30,25740,"Helena, MT MSA",2025,3,47844,46677,1167,2.4
MT3033540000000,30,33540,"Missoula, MT MSA",2025,3,74498,72543,1955,2.6
MT3124260000000,31,24260,"Grand Island, NE MSA",2025,3,43288,41879,1409,3.3
MT3130700000000,31,30700,"Lincoln, NE MSA",2025,3,197018,191707,5311,2.7
MT3136540000000,31,36540,"Omaha, NE-IA MSA",2025,3,532327,515930,16397,3.1
MT3216180000000,32,16180,"Carson City, NV MSA",2025,3,29724,28411,1313,4.4
MT3229820000000,32,29820,"Las Vegas-Henderson-North Las Vegas, NV MSA",2025,3,1234474,1161246,73228,5.9
MT3239900000000,32,39900,"Reno, NV MSA",2025,3,304614,290486,14128,4.6
MT3331700000000,33,31700,"Manchester-Nashua, NH MSA",2025,3,243328,235172,8156,3.4
MT3412100000000,34,12100,"Atlantic City-Hammonton, NJ MSA",2025,3,184259,172636,11623,6.3
MT3445940000000,34,45940,"Trenton-Princeton, NJ MSA",2025,3,199483,190428,9055,4.5
MT3447220000000,34,47220,"Vineland, NJ MSA",2025,3,66407,61755,4652,7
MT3510740000000,35,10740,"Albuquerque, NM MSA",2025,3,467941,449154,18787,4
MT3522140000000,35,22140,"Farmington, NM MSA",2025,3,49924,47585,2339,4.7
MT3529740000000,35,29740,"Las Cruces, NM MSA",2025,3,102973,97803,5170,5
MT3542140000000,35,42140,"Santa Fe, NM MSA",2025,3,74570,71715,2855,3.8
MT3610580000000,36,10580,"Albany-Schenectady-Troy, NY MSA",2025,3,457542,442497,15045,3.3
MT3613780000000,36,13780,"Binghamton, NY MSA",2025,3,106317,102191,4126,3.9
MT3615380000000,36,15380,"Buffalo-Cheektowaga, NY MSA",2025,3,558581,536254,22327,4
MT3621300000000,36,21300,"Elmira, NY MSA",2025,3,35153,33805,1348,3.8
MT3624020000000,36,24020,"Glens Falls, NY MSA",2025,3,59341,57302,2039,3.4
MT3627060000000,36,27060,"Ithaca, NY MSA",2025,3,48342,46770,1572,3.3
MT3628740000000,36,28740,"Kingston, NY MSA",2025,3,87460,84415,3045,3.5
MT3628880000000,36,28880,"Kiryas Joel-Poughkeepsie-Newburgh, NY MSA",2025,3,340442,328439,12003,3.5
MT3635620000000,36,35620,"New York-Newark-Jersey City, NY-NJ MSA",2025,3,10229298,9778287,451011,4.4
MT3640380000000,36,40380,"Rochester, NY MSA",2025,3,513897,495320,18577,3.6
MT3645060000000,36,45060,"Syracuse, NY MSA",2025,3,312968,301868,11100,3.5
MT3646540000000,36,46540,"Utica-Rome, NY MSA",2025,3,126477,121711,4766,3.8
MT3648060000000,36,48060,"Watertown-Fort Drum, NY MSA",2025,3,45130,43194,1936,4.3
MT3711700000000,37,11700,"Asheville, NC MSA",2025,3,212839,203545,9294,4.4
MT3715500000000,37,15500,"Burlington, NC MSA",2025,3,86123,83105,3018,3.5
MT3716740000000,37,16740,"Charlotte-Concord-Gastonia, NC-SC MSA",2025,3,1486615,1433026,53589,3.6
MT3720500000000,37,20500,"Durham-Chapel Hill, NC MSA",2025,3,324196,313972,10224,3.2
MT3722180000000,37,22180,"Fayetteville, NC MSA",2025,3,152837,145997,6840,4.5
MT3724140000000,37,24140,"Goldsboro, NC MSA",2025,3,51411,49584,1827,3.6
MT3724660000000,37,24660,"Greensboro-High Point, NC MSA",2025,3,371074,356488,14586,3.9
MT3724780000000,37,24780,"Greenville, NC MSA",2025,3,83238,79965,3273,3.9
MT3725860000000,37,25860,"Hickory-Lenoir-Morganton, NC MSA",2025,3,169977,163871,6106,3.6
MT3727340000000,37,27340,"Jacksonville, NC MSA",2025,3,74023,71311,2712,3.7
MT3738240000000,37,38240,"Pinehurst-Southern Pines, NC MSA",2025,3,44762,43288,1474,3.3
MT3739580000000,37,39580,"Raleigh-Cary, NC MSA",2025,3,850336,824576,25760,3
MT3740580000000,37,40580,"Rocky Mount, NC MSA",2025,3,62979,60019,2960,4.7
MT3748900000000,37,48900,"Wilmington, NC MSA",2025,3,223791,215979,7812,3.5
MT3749180000000,37,49180,"Winston-Salem, NC MSA",2025,3,325027,313400,11627,3.6
MT3813900000000,38,13900,"Bismarck, ND MSA",2025,3,74219,72474,1745,2.4
MT3822020000000,38,22020,"Fargo, ND-MN MSA",2025,3,154622,150819,3803,2.5
MT3824220000000,38,24220,"Grand Forks, ND-MN MSA",2025,3,57741,56271,1470,2.5
MT3833500000000,38,33500,"Minot, ND MSA",2025,3,40274,39255,1019,2.5
MT3910420000000,39,10420,"Akron, OH MSA",2025,3,363921,346125,17796,4.9
MT3915940000000,39,15940,"Canton-Massillon, OH MSA",2025,3,197361,187689,9672,4.9
MT3917140000000,39,17140,"Cincinnati, OH-KY-IN MSA",2025,3,1185153,1131303,53850,4.5
MT3917410000000,39,17410,"Cleveland, OH MSA",2025,3,1106792,1062487,44305,4
MT3918140000000,39,18140,"Columbus, OH MSA",2025,3,1169515,1117966,51549,4.4
MT3919430000000,39,19430,"Dayton-Kettering-Beavercreek, OH MSA",2025,3,398835,379513,19322,4.8
MT3930620000000,39,30620,"Lima, OH MSA",2025,3,48079,45757,2322,4.8
MT3931900000000,39,31900,"Mansfield, OH MSA",2025,3,54072,51174,2898,5.4
MT3941780000000,39,41780,"Sandusky, OH MSA",2025,3,59743,56426,3317,5.6
MT3944220000000,39,44220,"Springfield, OH MSA",2025,3,62486,59143,3343,5.3
MT3945780000000,39,45780,"Toledo, OH MSA",2025,3,300570,284288,16282,5.4
MT3948260000000,39,48260,"Weirton-Steubenville, WV-OH MSA",2025,3,50652,47796,2856,5.6
MT3949660000000,39,49660,"Youngstown-Warren, OH MSA",2025,3,195979,185140,10839,5.5
MT4021420000000,40,21420,"Enid, OK MSA",2025,3,28242,27359,883,3.1
MT4030020000000,40,30020,"Lawton, OK MSA",2025,3,52515,50652,1863,3.5
MT4036420000000,40,36420,"Oklahoma City, OK MSA",2025,3,778877,754909,23968,3.1
MT4046140000000,40,46140,"Tulsa, OK MSA",2025,3,528368,511533,16835,3.2
MT4110540000000,41,10540,"Albany, OR MSA",2025,3,62426,59343,3083,4.9
MT4113460000000,41,13460,"Bend, OR MSA",2025,3,135618,129630,5988,4.4
MT4118700000000,41,18700,"Corvallis, OR MSA",2025,3,49437,47469,1968,4
MT4121660000000,41,21660,"Eugene-Springfield, OR MSA",2025,3,189422,180697,8725,4.6
MT4124420000000,41,24420,"Grants Pass, OR MSA",2025,3,35043,32850,2193,6.3
MT4132780000000,41,32780,"Medford, OR MSA",2025,3,106081,100560,5521,5.2
MT4138900000000,41,38900,"Portland-Vancouver-Hillsboro, OR-WA MSA",2025,3,1381287,1319699,61588,4.5
MT4141420000000,41,41420,"Salem, OR MSA",2025,3,226207,216131,10076,4.5
MT4210900000000,42,10900,"Allentown-Bethlehem-Easton, PA-NJ MSA",2025,3,451517,433438,18079,4
MT4211020000000,42,11020,"Altoona, PA MSA",2025,3,57785,55640,2145,3.7
MT4216540000000,42,16540,"Chambersburg, PA MSA",2025,3,77131,74574,2557,3.3
MT4221500000000,42,21500,"Erie, PA MSA",2025,3,126414,121290,5124,4.1
MT4223900000000,42,23900,"Gettysburg, PA MSA",2025,3,51263,49586,1677,3.3
MT4225420000000,42,25420,"Harrisburg-Carlisle, PA MSA",2025,3,314242,303454,10788,3.4
MT4227780000000,42,27780,"Johnstown, PA MSA",2025,3,56061,53601,2460,4.4
MT4229540000000,42,29540,"Lancaster, PA MSA",2025,3,290393,281483,8910,3.1
MT4230140000000,42,30140,"Lebanon, PA MSA",2025,3,73688,71218,2470,3.4
MT4237980000000,42,37980,"Philadelphia-Camden-Wilmington, PA-NJ-DE-MD MSA",2025,3,3283656,3153108,130548,4
MT4238300000000,42,38300,"Pittsburgh, PA MSA",2025,3,1229102,1182632,46470,3.8
MT4239740000000,42,39740,"Reading, PA MSA",2025,3,218806,210340,8466,3.9
MT4242540000000,42,42540,"Scranton--Wilkes-Barre, PA MSA",2025,3,278461,266494,11967,4.3
MT4244300000000,42,44300,"State College, PA MSA",2025,3,76087,73798,2289,3
MT4248700000000,42,48700,"Williamsport, PA MSA",2025,3,52928,50773,2155,4.1
MT4249620000000,42,49620,"York-Hanover, PA MSA",2025,3,238166,229584,8582,3.6
MT4439300000000,44,39300,"Providence-Warwick, RI-MA MSA",2025,3,902953,858558,44395,4.9
MT4516700000000,45,16700,"Charleston-North Charleston, SC MSA",2025,3,449837,433805,16032,3.6
MT4517900000000,45,17900,"Columbia, SC MSA",2025,3,423846,406475,17371,4.1
MT4522500000000,45,22500,"Florence, SC MSA",2025,3,92971,88831,4140,4.5
MT4524860000000,45,24860,"Greenville-Anderson-Greer, SC MSA",2025,3,482853,464501,18352,3.8
MT4525940000000,45,25940,"Hilton Head Island-Bluffton-Port Royal, SC MSA",2025,3,99604,95764,3840,3.9
MT4534820000000,45,34820,"Myrtle Beach-Conway-North Myrtle Beach, SC MSA",2025,3,173253,164819,8434,4.9
MT4543900000000,45,43900,"Spartanburg, SC MSA",2025,3,179310,171622,7688,4.3
MT4544940000000,45,44940,"Sumter, SC MSA",2025,3,42188,39966,2222,5.3
MT4639660000000,46,39660,"Rapid City, SD MSA",2025,3,81561,80133,1428,1.8
MT4643620000000,46,43620,"Sioux Falls, SD-MN MSA",2025,3,176232,173151,3081,1.7
MT4716860000000,47,16860,"Chattanooga, TN-GA MSA",2025,3,292720,282958,9762,3.3
MT4717300000000,47,17300,"Clarksville, TN-KY MSA",2025,3,141411,135432,5979,4.2
MT4717420000000,47,17420,"Cleveland, TN MSA",2025,3,56447,54291,2156,3.8
MT4727180000000,47,27180,"Jackson, TN MSA",2025,3,79250,76099,3151,4
MT4727740000000,47,27740,"Johnson City, TN MSA",2025,3,97678,94093,3585,3.7
MT4728700000000,47,28700,"Kingsport-Bristol, TN-VA MSA",2025,3,133774,128871,4903,3.7
MT4728940000000,47,28940,"Knoxville, TN MSA",2025,3,457659,442903,14756,3.2
MT4732820000000,47,32820,"Memphis, TN-MS-AR MSA",2025,3,627872,599914,27958,4.5
MT4734100000000,47,34100,"Morristown, TN MSA",2025,3,54426,52481,1945,3.6
MT4734980000000,47,34980,"Nashville-Davidson--Murfreesboro--Franklin, TN MSA",2025,3,1171923,1136650,35273,3
MT4810180000000,48,10180,"Abilene, TX MSA",2025,3,87931,84967,2964,3.4
MT4811100000000,48,11100,"Amarillo, TX MSA",2025,3,139847,135567,4280,3.1
MT4812420000000,48,12420,"Austin-Round Rock-San Marcos, TX MSA",2025,3,1521205,1468842,52363,3.4
MT4813140000000,48,13140,"Beaumont-Port Arthur, TX MSA",2025,3,185108,175477,9631,5.2
MT4815180000000,48,15180,"Brownsville-Harlingen, TX MSA",2025,3,192468,182113,10355,5.4
MT4817780000000,48,17780,"College Station-Bryan, TX MSA",2025,3,154736,149290,5446,3.5
MT4818580000000,48,18580,"Corpus Christi, TX MSA",2025,3,211785,202712,9073,4.3
MT4819100000000,48,19100,"Dallas-Fort Worth-Arlington, TX MSA",2025,3,4533747,4359774,173973,3.8
MT4820580000000,48,20580,"Eagle Pass, TX MSA",2025,3,24505,22534,1971,8
MT4821340000000,48,21340,"El Paso, TX MSA",2025,3,420626,403173,17453,4.1
MT4826420000000,48,26420,"Houston-Pasadena-The Woodlands, TX MSA",2025,3,3876970,3709953,167017,4.3
MT4828660000000,48,28660,"Killeen-Temple, TX MSA",2025,3,203593,194528,9065,4.5
MT4829700000000,48,29700,"Laredo, TX MSA",2025,3,120736,115550,5186,4.3
MT4830980000000,48,30980,"Longview, TX MSA",2025,3,129845,123742,6103,4.7
MT4831180000000,48,31180,"Lubbock, TX MSA",2025,3,186878,180374,6504,3.5
MT4832580000000,48,32580,"McAllen-Edinburg-Mission, TX MSA",2025,3,399787,376172,23615,5.9
MT4833260000000,48,33260,"Midland, TX MSA",2025,3,105289,102171,3118,3
MT4836220000000,48,36220,"Odessa, TX MSA",2025,3,87589,84437,3152,3.6
MT4841660000000,48,41660,"San Angelo, TX MSA",2025,3,63096,61055,2041,3.2
MT4841700000000,48,41700,"San Antonio-New Braunfels, TX MSA",2025,3,1355696,1304605,51091,3.8
MT4843300000000,48,43300,"Sherman-Denison, TX MSA",2025,3,72028,69330,2698,3.7
MT4845500000000,48,45500,"Texarkana, TX-AR MSA",2025,3,62684,60127,2557,4.1
MT4846340000000,48,46340,"Tyler, TX MSA",2025,3,119550,115030,4520,3.8
MT4847020000000,48,47020,"Victoria, TX MSA",2025,3,45436,43615,1821,4
MT4847380000000,48,47380,"Waco, TX MSA",2025,3,148789,143135,5654,3.8
MT4848660000000,48,48660,"Wichita Falls, TX MSA",2025,3,67267,64732,2535,3.8
MT4930860000000,49,30860,"Logan, UT-ID MSA",2025,3,80989,78803,2186,2.7
MT4936260000000,49,36260,"Ogden, UT MSA",2025,3,355234,344740,10494,3
MT4939340000000,49,39340,"Provo-Orem-Lehi, UT MSA",2025,3,372426,360712,11714,3.1
MT4941100000000,49,41100,"St. George, UT MSA",2025,3,95395,92428,2967,3.1
MT4941620000000,49,41620,"Salt Lake City-Murray, UT MSA",2025,3,741404,717819,23585,3.2
MT5015540000000,50,15540,"Burlington-South Burlington, VT MSA",2025,3,131763,128779,2984,2.3
MT5113980000000,51,13980,"Blacksburg-Christiansburg-Radford, VA MSA",2025,3,92373,89057,3316,3.6
MT5116820000000,51,16820,"Charlottesville, VA MSA",2025,3,121445,118079,3366,2.8
MT5125500000000,51,25500,"Harrisonburg, VA MSA",2025,3,71635,69421,2214,3.1
MT5131340000000,51,31340,"Lynchburg, VA MSA",2025,3,126926,122491,4435,3.5
MT5140060000000,51,40060,"Richmond, VA MSA",2025,3,727777,704880,22897,3.1
MT5140220000000,51,40220,"Roanoke, VA MSA",2025,3,158870,153954,4916,3.1
MT5144420000000,51,44420,"Staunton-Stuarts Draft, VA MSA",2025,3,65134,63348,1786,2.7
MT5147260000000,51,47260,"Virginia Beach-Chesapeake-Norfolk, VA-NC MSA",2025,3,881380,852218,29162,3.3
MT5149020000000,51,49020,"Winchester, VA-WV MSA",2025,3,77774,75545,2229,2.9
MT5313380000000,53,13380,"Bellingham, WA MSA",2025,3,109750,105075,4675,4.3
MT5314740000000,53,14740,"Bremerton-Silverdale-Port Orchard, WA MSA",2025,3,119952,114852,5100,4.3
MT5328420000000,53,28420,"Kennewick-Richland, WA MSA",2025,3,147634,140837,6797,4.6
MT5331020000000,53,31020,"Longview-Kelso, WA MSA",2025,3,47021,44647,2374,5
MT5334580000000,53,34580,"Mount Vernon-Anacortes, WA MSA",2025,3,58315,55669,2646,4.5
MT5336500000000,53,36500,"Olympia-Lacey-Tumwater, WA MSA",2025,3,142844,136683,6161,4.3
MT5342660000000,53,42660,"Seattle-Tacoma-Bellevue, WA MSA",2025,3,2358264,2259380,98884,4.2
MT5344060000000,53,44060,"Spokane-Spokane Valley, WA MSA",2025,3,274680,262888,11792,4.3
MT5347460000000,53,47460,"Walla Walla, WA MSA",2025,3,28333,27229,1104,3.9
MT5348300000000,53,48300,"Wenatchee-East Wenatchee, WA MSA",2025,3,60907,58176,2731,4.5
MT5349420000000,53,49420,"Yakima, WA MSA",2025,3,122118,115342,6776,5.5
MT5413220000000,54,13220,"Beckley, WV MSA",2025,3,45691,44037,1654,3.6
MT5416620000000,54,16620,"Charleston, WV MSA",2025,3,89535,86198,3337,3.7
MT5426580000000,54,26580,"Huntington-Ashland, WV-KY-OH MSA",2025,3,157515,149738,7777,4.9
MT5434060000000,54,34060,"Morgantown, WV MSA",2025,3,70718,68441,2277,3.2
MT5437620000000,54,37620,"Parkersburg-Vienna, WV MSA",2025,3,38861,37356,1505,3.9
MT5448540000000,54,48540,"Wheeling, WV-OH MSA",2025,3,59700,57016,2684,4.5
MT5511540000000,55,11540,"Appleton, WI MSA",2025,3,137796,134139,3657,2.7
MT5520740000000,55,20740,"Eau Claire, WI MSA",2025,3,96876,93853,3023,3.1
MT5522540000000,55,22540,"Fond du Lac, WI MSA",2025,3,55278,53631,1647,3
MT5524580000000,55,24580,"Green Bay, WI MSA",2025,3,181222,176199,5023,2.8
MT5527500000000,55,27500,"Janesville-Beloit, WI MSA",2025,3,87692,84688,3004,3.4
MT5528450000000,55,28450,"Kenosha, WI MSA",2025,3,96086,92761,3325,3.5
MT5529100000000,55,29100,"La Crosse-Onalaska, WI-MN MSA",2025,3,91401,88944,2457,2.7
MT5531540000000,55,31540,"Madison, WI MSA",2025,3,410616,400511,10105,2.5
MT5533340000000,55,33340,"Milwaukee-Waukesha, WI MSA",2025,3,820862,792158,28704,3.5
MT5536780000000,55,36780,"Oshkosh-Neenah, WI MSA",2025,3,93001,90356,2645,2.8
MT5539540000000,55,39540,"Racine-Mount Pleasant, WI MSA",2025,3,101183,97346,3837,3.8
MT5543100000000,55,43100,"Sheboygan, WI MSA",2025,3,64223,62529,1694,2.6
MT5548140000000,55,48140,"Wausau, WI MSA",2025,3,74934,72923,2011,2.7
MT5616220000000,56,16220,"Casper, WY MSA",2025,3,42181,40744,1437,3.4
MT5616940000000,56,16940,"Cheyenne, WY MSA",2025,3,49072,47359,1713,3.5
MT7210380000000,72,10380,"Aguadilla, PR MSA",2025,3,91223,84876,6347,7
MT7211640000000,72,11640,"Arecibo, PR MSA",2025,3,68476,64800,3676,5.4
MT7225020000000,72,25020,"Guayama, PR MSA",2025,3,19115,17406,1709,8.9
MT7232420000000,72,32420,"Mayaguez, PR MSA",2025,3,68178,63015,5163,7.6
MT7238660000000,72,38660,"Ponce, PR MSA",2025,3,90220,82628,7592,8.4
MT7241980000000,72,41980,"San Juan-Bayamon-Caguas, PR MSA",2025,3,823732,787153,36579,4.4
MT0111500000000,1,11500,"Anniston-Oxford, AL MSA",2025,4,50349,48539,1810,3.6
MT0112220000000,1,12220,"Auburn-Opelika, AL MSA",2025,4,98110,95102,3008,3.1
MT0113820000000,1,13820,"Birmingham, AL MSA",2025,4,577688,559839,17849,3.1
MT0119300000000,1,19300,"Daphne-Fairhope-Foley, AL MSA",2025,4,118613,115193,3420,2.9
MT0119460000000,1,19460,"Decatur, AL MSA",2025,4,77708,75571,2137,2.8
MT0120020000000,1,20020,"Dothan, AL MSA",2025,4,68663,66408,2255,3.3
MT0122520000000,1,22520,"Florence-Muscle Shoals, AL MSA",2025,4,70749,68308,2441,3.5
MT0123460000000,1,23460,"Gadsden, AL MSA",2025,4,42827,41337,1490,3.5
MT0126620000000,1,26620,"Huntsville, AL MSA",2025,4,283157,275299,7858,2.8
MT0133660000000,1,33660,"Mobile, AL MSA",2025,4,190202,182614,7588,4
MT0133860000000,1,33860,"Montgomery, AL MSA",2025,4,181769,175756,6013,3.3
MT0146220000000,1,46220,"Tuscaloosa, AL MSA",2025,4,128200,123732,4468,3.5
MT0211260000000,2,11260,"Anchorage, AK MSA",2025,4,203761,195422,8339,4.1
MT0221820000000,2,21820,"Fairbanks-College, AK MSA",2025,4,46450,44643,1807,3.9
MT0422380000000,4,22380,"Flagstaff, AZ MSA",2025,4,77007,73754,3253,4.2
MT0429420000000,4,29420,"Lake Havasu City-Kingman, AZ MSA",2025,4,88318,84164,4154,4.7
MT0438060000000,4,38060,"Phoenix-Mesa-Chandler, AZ MSA",2025,4,2735128,2639801,95327,3.5
MT0439150000000,4,39150,"Prescott Valley-Prescott, AZ MSA",2025,4,107062,103002,4060,3.8
MT0443420000000,4,43420,"Sierra Vista-Douglas, AZ MSA",2025,4,48142,45894,2248,4.7
MT0446060000000,4,46060,"Tucson, AZ MSA",2025,4,496285,476674,19611,4
MT0449740000000,4,49740,"Yuma, AZ MSA",2025,4,101130,87631,13499,13.3
MT0522220000000,5,22220,"Fayetteville-Springdale-Rogers, AR MSA",2025,4,313235,304236,8999,2.9
MT0522900000000,5,22900,"Fort Smith, AR-OK MSA",2025,4,102366,98763,3603,3.5
MT0526300000000,5,26300,"Hot Springs, AR MSA",2025,4,43602,41950,1652,3.8
MT0527860000000,5,27860,"Jonesboro, AR MSA",2025,4,67216,64866,2350,3.5
MT0530780000000,5,30780,"Little Rock-North Little Rock-Conway, AR MSA",2025,4,385259,372198,13061,3.4
MT0612540000000,6,12540,"Bakersfield-Delano, CA MSA",2025,4,414181,378971,35210,8.5
MT0617020000000,6,17020,"Chico, CA MSA",2025,4,92816,87507,5309,5.7
MT0620940000000,6,20940,"El Centro, CA MSA",2025,4,73608,60003,13605,18.5
MT0623420000000,6,23420,"Fresno, CA MSA",2025,4,548425,505510,42915,7.8
MT0625260000000,6,25260,"Hanford-Corcoran, CA MSA",2025,4,59277,54085,5192,8.8
MT0631080000000,6,31080,"Los Angeles-Long Beach-Anaheim, CA MSA",2025,4,6709571,6354877,354694,5.3
MT0632900000000,6,32900,"Merced, CA MSA",2025,4,123519,111625,11894,9.6
MT0633700000000,6,33700,"Modesto, CA MSA",2025,4,259777,242094,17683,6.8
MT0634900000000,6,34900,"Napa, CA MSA",2025,4,76899,73860,3039,4
MT0637100000000,6,37100,"Oxnard-Thousand Oaks-Ventura, CA MSA",2025,4,423518,403765,19753,4.7
MT0639820000000,6,39820,"Redding, CA MSA",2025,4,80876,76680,4196,5.2
MT0640140000000,6,40140,"Riverside-San Bernardino-Ontario, CA MSA",2025,4,2229463,2113211,116252,5.2
MT0640900000000,6,40900,"Sacramento-Roseville-Folsom, CA MSA",2025,4,1195433,1139915,55518,4.6
MT0641500000000,6,41500,"Salinas, CA MSA",2025,4,228368,212100,16268,7.1
MT0641740000000,6,41740,"San Diego-Chula Vista-Carlsbad, CA MSA",2025,4,1668139,1595584,72555,4.3
MT0641860000000,6,41860,"San Francisco-Oakland-Fremont, CA MSA",2025,4,2511121,2405465,105656,4.2
MT0641940000000,6,41940,"San Jose-Sunnyvale-Santa Clara, CA MSA",2025,4,1063300,1019141,44159,4.2
MT0642020000000,6,42020,"San Luis Obispo-Paso Robles, CA MSA",2025,4,133415,127949,5466,4.1
MT0642100000000,6,42100,"Santa Cruz-Watsonville, CA MSA",2025,4,137909,129732,8177,5.9
MT0642200000000,6,42200,"Santa Maria-Santa Barbara, CA MSA",2025,4,224098,214223,9875,4.4
MT0642220000000,6,42220,"Santa Rosa-Petaluma, CA MSA",2025,4,249070,238796,10274,4.1
MT0644700000000,6,44700,"Stockton-Lodi, CA MSA",2025,4,373813,350013,23800,6.4
MT0646700000000,6,46700,"Vallejo, CA MSA",2025,4,217783,206899,10884,5
MT0647300000000,6,47300,"Visalia, CA MSA",2025,4,224056,201110,22946,10.2
MT0649700000000,6,49700,"Yuba City, CA MSA",2025,4,82940,76700,6240,7.5
MT0814500000000,8,14500,"Boulder, CO MSA",2025,4,194290,185271,9019,4.6
MT0817820000000,8,17820,"Colorado Springs, CO MSA",2025,4,399575,380500,19075,4.8
MT0819740000000,8,19740,"Denver-Aurora-Centennial, CO MSA",2025,4,1780043,1696916,83127,4.7
MT0822660000000,8,22660,"Fort Collins-Loveland, CO MSA",2025,4,208242,198682,9560,4.6
MT0824300000000,8,24300,"Grand Junction, CO MSA",2025,4,80741,76819,3922,4.9
MT0824540000000,8,24540,"Greeley, CO MSA",2025,4,179167,170284,8883,5
MT0839380000000,8,39380,"Pueblo, CO MSA",2025,4,73761,69158,4603,6.2
MT0914860000000,9,14860,"Bridgeport-Stamford-Danbury, CT MSA",2025,4,520938,502677,18261,3.5
MT0925540000000,9,25540,"Hartford-West Hartford-East Hartford, CT MSA",2025,4,616909,594400,22509,3.6
MT0935300000000,9,35300,"New Haven, CT MSA",2025,4,319063,307472,11591,3.6
MT0935980000000,9,35980,"Norwich-New London-Willimantic, CT MSA",2025,4,144850,139772,5078,3.5
MT0947930000000,9,47930,"Waterbury-Shelton, CT MSA",2025,4,243031,233055,9976,4.1
MT1020100000000,10,20100,"Dover, DE MSA",2025,4,85282,81708,3574,4.2
MT1147900000000,11,47900,"Washington-Arlington-Alexandria, DC-VA-MD-WV MSA",2025,4,3561445,3442148,119297,3.3
MT1215980000000,12,15980,"Cape Coral-Fort Myers, FL MSA",2025,4,374794,359994,14800,3.9
MT1218880000000,12,18880,"Crestview-Fort Walton Beach-Destin, FL MSA",2025,4,144375,139482,4893,3.4
MT1219660000000,12,19660,"Deltona-Daytona Beach-Ormond Beach, FL MSA",2025,4,324413,310832,13581,4.2
MT1223540000000,12,23540,"Gainesville, FL MSA",2025,4,171766,164721,7045,4.1
MT1226140000000,12,26140,"Homosassa Springs, FL MSA",2025,4,54085,51140,2945,5.4
MT1227260000000,12,27260,"Jacksonville, FL MSA",2025,4,863072,830940,32132,3.7
MT1229460000000,12,29460,"Lakeland-Winter Haven, FL MSA",2025,4,360169,343901,16268,4.5
MT1233100000000,12,33100,"Miami-Fort Lauderdale-West Palm Beach, FL MSA",2025,4,3309829,3205942,103887,3.1
MT1234940000000,12,34940,"Naples-Marco Island, FL MSA",2025,4,184302,177175,7127,3.9
MT1235840000000,12,35840,"North Port-Bradenton-Sarasota, FL MSA",2025,4,400745,384985,15760,3.9
MT1236100000000,12,36100,"Ocala, FL MSA",2025,4,160321,153186,7135,4.5
MT1236740000000,12,36740,"Orlando-Kissimmee-Sanford, FL MSA",2025,4,1552649,1497786,54863,3.5
MT1237340000000,12,37340,"Palm Bay-Melbourne-Titusville, FL MSA",2025,4,308151,296333,11818,3.8
MT1237460000000,12,37460,"Panama City-Panama City Beach, FL MSA",2025,4,102612,98879,3733,3.6
MT1237860000000,12,37860,"Pensacola-Ferry Pass-Brent, FL MSA",2025,4,241864,232487,9377,3.9
MT1238940000000,12,38940,"Port St. Lucie, FL MSA",2025,4,241305,231312,9993,4.1
MT1239460000000,12,39460,"Punta Gorda, FL MSA",2025,4,77610,74006,3604,4.6
MT1242680000000,12,42680,"Sebastian-Vero Beach-West Vero Corridor, FL MSA",2025,4,67504,64433,3071,4.5
MT1242700000000,12,42700,"Sebring, FL MSA",2025,4,36798,34834,1964,5.3
MT1245220000000,12,45220,"Tallahassee, FL MSA",2025,4,210545,202593,7952,3.8
MT1245300000000,12,45300,"Tampa-St. Petersburg-Clearwater, FL MSA",2025,4,1709435,1645697,63738,3.7
MT1248680000000,12,48680,"Wildwood-The Villages, FL MSA",2025,4,34598,32437,2161,6.2
MT1310500000000,13,10500,"Albany, GA MSA",2025,4,62007,59388,2619,4.2
MT1312020000000,13,12020,"Athens-Clarke County, GA MSA",2025,4,109555,105992,3563,3.3
MT1312060000000,13,12060,"Atlanta-Sandy Springs-Roswell, GA MSA",2025,4,3292997,3177665,115332,3.5
MT1312260000000,13,12260,"Augusta-Richmond County, GA-SC MSA",2025,4,268063,256450,11613,4.3
MT1315260000000,13,15260,"Brunswick-St. Simons, GA MSA",2025,4,55708,53967,1741,3.1
MT1317980000000,13,17980,"Columbus, GA-AL MSA",2025,4,128757,123418,5339,4.1
MT1319140000000,13,19140,"Dalton, GA MSA",2025,4,67364,64852,2512,3.7
MT1323580000000,13,23580,"Gainesville, GA MSA",2025,4,109261,106128,3133,2.9
MT1325980000000,13,25980,"Hinesville, GA MSA",2025,4,31096,29855,1241,4
MT1331420000000,13,31420,"Macon-Bibb County, GA MSA",2025,4,96843,92786,4057,4.2
MT1340660000000,13,40660,"Rome, GA MSA",2025,4,48070,46370,1700,3.5
MT1342340000000,13,42340,"Savannah, GA MSA",2025,4,208857,202469,6388,3.1
MT1346660000000,13,46660,"Valdosta, GA MSA",2025,4,61099,58660,2439,4
MT1347580000000,13,47580,"Warner Robins, GA MSA",2025,4,89911,87012,2899,3.2
MT1527980000000,15,27980,"Kahului-Wailuku, HI MSA",2025,4,81628,78907,2721,3.3
MT1546520000000,15,46520,"Urban Honolulu, HI MSA",2025,4,476733,464019,12714,2.7
MT1614260000000,16,14260,"Boise City, ID MSA",2025,4,455048,439601,15447,3.4
MT1617660000000,16,17660,"Coeur d'Alene, ID MSA",2025,4,92079,88057,4022,4.4
MT1626820000000,16,26820,"Idaho Falls, ID MSA",2025,4,85733,83077,2656,3.1
MT1630300000000,16,30300,"Lewiston, ID-WA MSA",2025,4,31026,29982,1044,3.4
MT1638540000000,16,38540,"Pocatello, ID MSA",2025,4,41460,39860,1600,3.9
MT1646300000000,16,46300,"Twin Falls, ID MSA",2025,4,60630,58566,2064,3.4
MT1714010000000,17,14010,"Bloomington, IL MSA",2025,4,94988,91730,3258,3.4
MT1716580000000,17,16580,"Champaign-Urbana, IL MSA",2025,4,124979,120642,4337,3.5
MT1716980000000,17,16980,"Chicago-Naperville-Elgin, IL-IN MSA",2025,4,5042371,4787087,255284,5.1
MT1719340000000,17,19340,"Davenport-Moline-Rock Island, IA-IL MSA",2025,4,188750,180353,8397,4.4
MT1719500000000,17,19500,"Decatur, IL MSA",2025,4,44039,41703,2336,5.3
MT1728100000000,17,28100,"Kankakee, IL MSA",2025,4,50773,48350,2423,4.8
MT1737900000000,17,37900,"Peoria, IL MSA",2025,4,176796,169161,7635,4.3
MT1740420000000,17,40420,"Rockford, IL MSA",2025,4,160025,152519,7506,4.7
MT1744100000000,17,44100,"Springfield, IL MSA",2025,4,104076,100150,3926,3.8
MT1814020000000,18,14020,"Bloomington, IN MSA",2025,4,86510,83555,2955,3.4
MT1818020000000,18,18020,"Columbus, IN MSA",2025,4,40160,38695,1465,3.6
MT1821140000000,18,21140,"Elkhart-Goshen, IN MSA",2025,4,98435,94433,4002,4.1
MT1821780000000,18,21780,"Evansville, IN MSA",2025,4,136989,132186,4803,3.5
MT1823060000000,18,23060,"Fort Wayne, IN MSA",2025,4,234148,225839,8309,3.5
MT1826900000000,18,26900,"Indianapolis-Carmel-Greenwood, IN MSA",2025,4,1153902,1113440,40462,3.5
MT1829020000000,18,29020,"Kokomo, IN MSA",2025,4,36827,34580,2247,6.1
MT1829200000000,18,29200,"Lafayette-West Lafayette, IN MSA",2025,4,120747,116446,4301,3.6
MT1833140000000,18,33140,"Michigan City-La Porte, IN MSA",2025,4,52111,49856,2255,4.3
MT1834620000000,18,34620,"Muncie, IN MSA",2025,4,53665,51441,2224,4.1
MT1843780000000,18,43780,"South Bend-Mishawaka, IN-MI MSA",2025,4,156898,149955,6943,4.4
MT1845460000000,18,45460,"Terre Haute, IN MSA",2025,4,78525,75419,3106,4
MT1911180000000,19,11180,"Ames, IA MSA",2025,4,70683,68660,2023,2.9
MT1916300000000,19,16300,"Cedar Rapids, IA MSA",2025,4,147058,141624,5434,3.7
MT1919780000000,19,19780,"Des Moines-West Des Moines, IA MSA",2025,4,415672,401269,14403,3.5
MT1920220000000,19,20220,"Dubuque, IA MSA",2025,4,53844,51961,1883,3.5
MT1926980000000,19,26980,"Iowa City, IA MSA",2025,4,101929,99117,2812,2.8
MT1943580000000,19,43580,"Sioux City, IA-NE-SD MSA",2025,4,76336,73857,2479,3.2
MT1947940000000,19,47940,"Waterloo-Cedar Falls, IA MSA",2025,4,88438,84934,3504,4
MT2029940000000,20,29940,"Lawrence, KS MSA",2025,4,72308,69814,2494,3.4
MT2031740000000,20,31740,"Manhattan, KS MSA",2025,4,65165,62797,2368,3.6
MT2045820000000,20,45820,"Topeka, KS MSA",2025,4,119586,114996,4590,3.8
MT2048620000000,20,48620,"Wichita, KS MSA",2025,4,338597,324696,13901,4.1
MT2114540000000,21,14540,"Bowling Green, KY MSA",2025,4,94520,89963,4557,4.8
MT2121060000000,21,21060,"Elizabethtown, KY MSA",2025,4,56131,53105,3026,5.4
MT2130460000000,21,30460,"Lexington-Fayette, KY MSA",2025,4,281761,269917,11844,4.2
MT2131140000000,21,31140,"Louisville/Jefferson County, KY-IN MSA",2025,4,707260,674313,32947,4.7
MT2136980000000,21,36980,"Owensboro, KY MSA",2025,4,53028,50470,2558,4.8
MT2137140000000,21,37140,"Paducah, KY-IL MSA",2025,4,46429,44131,2298,4.9
MT2210780000000,22,10780,"Alexandria, LA MSA",2025,4,63999,61349,2650,4.1
MT2212940000000,22,12940,"Baton Rouge, LA MSA",2025,4,428330,410465,17865,4.2
MT2225220000000,22,25220,"Hammond, LA MSA",2025,4,61050,58013,3037,5
MT2226380000000,22,26380,"Houma-Bayou Cane-Thibodaux, LA MSA",2025,4,87512,84069,3443,3.9
MT2229180000000,22,29180,"Lafayette, LA MSA",2025,4,197991,190380,7611,3.8
MT2229340000000,22,29340,"Lake Charles, LA MSA",2025,4,97987,93387,4600,4.7
MT2233740000000,22,33740,"Monroe, LA MSA",2025,4,95292,90476,4816,5.1
MT2235380000000,22,35380,"New Orleans-Metairie, LA MSA",2025,4,466240,445447,20793,4.5
MT2243340000000,22,43340,"Shreveport-Bossier City, LA MSA",2025,4,167641,160137,7504,4.5
MT2243640000000,22,43640,"Slidell-Mandeville-Covington, LA MSA",2025,4,129461,124303,5158,4
MT2312620000000,23,12620,"Bangor, ME MSA",2025,4,76050,73271,2779,3.7
MT2330340000000,23,30340,"Lewiston-Auburn, ME MSA",2025,4,55351,53424,1927,3.5
MT2338860000000,23,38860,"Portland-South Portland, ME MSA",2025,4,316320,307294,9026,2.9
MT2412580000000,24,12580,"Baltimore-Columbia-Towson, MD MSA",2025,4,1494277,1447804,46473,3.1
MT2425180000000,24,25180,"Hagerstown-Martinsburg, MD-WV MSA",2025,4,143116,138457,4659,3.3
MT2430500000000,24,30500,"Lexington Park, MD MSA",2025,4,109040,106084,2956,2.7
MT2441540000000,24,41540,"Salisbury, MD MSA",2025,4,64318,62105,2213,3.4
MT2511200000000,25,11200,"Amherst Town-Northampton, MA MSA",2025,4,86988,83247,3741,4.3
MT2512700000000,25,12700,"Barnstable Town, MA MSA",2025,4,122204,115716,6488,5.3
MT2514460000000,25,14460,"Boston-Cambridge-Newton, MA-NH MSA",2025,4,2863090,2741447,121643,4.2
MT2538340000000,25,38340,"Pittsfield, MA MSA",2025,4,64737,61837,2900,4.5
MT2544140000000,25,44140,"Springfield, MA MSA",2025,4,228330,215582,12748,5.6
MT2549340000000,25,49340,"Worcester, MA MSA",2025,4,472843,450388,22455,4.7
MT2611460000000,26,11460,"Ann Arbor, MI MSA",2025,4,210971,201434,9537,4.5
MT2612980000000,26,12980,"Battle Creek, MI MSA",2025,4,64820,60889,3931,6.1
MT2613020000000,26,13020,"Bay City, MI MSA",2025,4,51101,47798,3303,6.5
MT2619820000000,26,19820,"Detroit-Warren-Dearborn, MI MSA",2025,4,2191895,2079126,112769,5.1
MT2622420000000,26,22420,"Flint, MI MSA",2025,4,192003,179010,12993,6.8
MT2624340000000,26,24340,"Grand Rapids-Wyoming-Kentwood, MI MSA",2025,4,631385,602201,29184,4.6
MT2627100000000,26,27100,"Jackson, MI MSA",2025,4,75614,71295,4319,5.7
MT2628020000000,26,28020,"Kalamazoo-Portage, MI MSA",2025,4,142062,135124,6938,4.9
MT2629620000000,26,29620,"Lansing-East Lansing, MI MSA",2025,4,259358,246500,12858,5
MT2633220000000,26,33220,"Midland, MI MSA",2025,4,43776,41521,2255,5.2
MT2633780000000,26,33780,"Monroe, MI MSA",2025,4,79828,74954,4874,6.1
MT2634740000000,26,34740,"Muskegon-Norton Shores, MI MSA",2025,4,86397,81077,5320,6.2
MT2635660000000,26,35660,"Niles, MI MSA",2025,4,77759,73261,4498,5.8
MT2640980000000,26,40980,"Saginaw, MI MSA",2025,4,86018,79992,6026,7
MT2645900000000,26,45900,"Traverse City, MI MSA",2025,4,84023,79993,4030,4.8
MT2720260000000,27,20260,"Duluth, MN-WI MSA",2025,4,140869,135485,5384,3.8
MT2731860000000,27,31860,"Mankato, MN MSA",2025,4,60457,58835,1622,2.7
MT2733460000000,27,33460,"Minneapolis-St. Paul-Bloomington, MN-WI MSA",2025,4,2083362,2020661,62701,3
MT2740340000000,27,40340,"Rochester, MN MSA",2025,4,132313,128856,3457,2.6
MT2741060000000,27,41060,"St. Cloud, MN MSA",2025,4,111634,107880,3754,3.4
MT2825060000000,28,25060,"Gulfport-Biloxi, MS MSA",2025,4,191579,184570,7009,3.7
MT2825620000000,28,25620,"Hattiesburg, MS MSA",2025,4,71361,68711,2650,3.7
MT2827140000000,28,27140,"Jackson, MS MSA",2025,4,289943,279635,10308,3.6
MT2916020000000,29,16020,"Cape Girardeau, MO-IL MSA",2025,4,49655,47878,1777,3.6
MT2917860000000,29,17860,"Columbia, MO MSA",2025,4,114241,110415,3826,3.3
MT2927620000000,29,27620,"Jefferson City, MO MSA",2025,4,77908,75457,2451,3.1
MT2927900000000,29,27900,"Joplin, MO-KS MSA",2025,4,98926,95199,3727,3.8
MT2928140000000,29,28140,"Kansas City, MO-KS MSA",2025,4,1206437,1159266,47171,3.9
MT2941140000000,29,41140,"St. Joseph, MO-KS MSA",2025,4,55429,53313,2116,3.8
MT2941180000000,29,41180,"St. Louis, MO-IL MSA",2025,4,1487120,1430866,56254,3.8
MT2944180000000,29,44180,"Springfield, MO MSA",2025,4,247195,238474,8721,3.5
MT3013740000000,30,13740,"Billings, MT MSA",2025,4,98938,96249,2689,2.7
MT3014580000000,30,14580,"Bozeman, MT MSA",2025,4,77226,75636,1590,2.1
MT3024500000000,30,24500,"Great Falls, MT MSA",2025,4,39611,38575,1036,2.6
MT3025740000000,30,25740,"Helena, MT MSA",2025,4,47900,46731,1169,2.4
MT3033540000000,30,33540,"Missoula, MT MSA",2025,4,74458,72503,1955,2.6
MT3124260000000,31,24260,"Grand Island, NE MSA",2025,4,43379,41931,1448,3.3
MT3130700000000,31,30700,"Lincoln, NE MSA",2025,4,197688,192277,5411,2.7
MT3136540000000,31,36540,"Omaha, NE-IA MSA",2025,4,533545,516927,16618,3.1
MT3216180000000,32,16180,"Carson City, NV MSA",2025,4,29791,28515,1276,4.3
MT3229820000000,32,29820,"Las Vegas-Henderson-North Las Vegas, NV MSA",2025,4,1237358,1165632,71726,5.8
MT3239900000000,32,39900,"Reno, NV MSA",2025,4,305426,291651,13775,4.5
MT3331700000000,33,31700,"Manchester-Nashua, NH MSA",2025,4,243318,235129,8189,3.4
MT3412100000000,34,12100,"Atlantic City-Hammonton, NJ MSA",2025,4,184746,172802,11944,6.5
MT3445940000000,34,45940,"Trenton-Princeton, NJ MSA",2025,4,199698,190432,9266,4.6
MT3447220000000,34,47220,"Vineland, NJ MSA",2025,4,66535,61806,4729,7.1
MT3510740000000,35,10740,"Albuquerque, NM MSA",2025,4,467901,449406,18495,4
MT3522140000000,35,22140,"Farmington, NM MSA",2025,4,49846,47561,2285,4.6
MT3529740000000,35,29740,"Las Cruces, NM MSA",2025,4,103049,97979,5070,4.9
MT3542140000000,35,42140,"Santa Fe, NM MSA",2025,4,74498,71720,2778,3.7
MT3610580000000,36,10580,"Albany-Schenectady-Troy, NY MSA",2025,4,458470,443692,14778,3.2
MT3613780000000,36,13780,"Binghamton, NY MSA",2025,4,106489,102418,4071,3.8
MT3615380000000,36,15380,"Buffalo-Cheektowaga, NY MSA",2025,4,560239,538209,22030,3.9
MT3621300000000,36,21300,"Elmira, NY MSA",2025,4,35273,33945,1328,3.8
MT3624020000000,36,24020,"Glens Falls, NY MSA",2025,4,59392,57377,2015,3.4
MT3627060000000,36,27060,"Ithaca, NY MSA",2025,4,48338,46787,1551,3.2
MT3628740000000,36,28740,"Kingston, NY MSA",2025,4,87499,84496,3003,3.4
MT3628880000000,36,28880,"Kiryas Joel-Poughkeepsie-Newburgh, NY MSA",2025,4,340776,328908,11868,3.5
MT3635620000000,36,35620,"New York-Newark-Jersey City, NY-NJ MSA",2025,4,10240950,9791711,449239,4.4
MT3640380000000,36,40380,"Rochester, NY MSA",2025,4,514998,496671,18327,3.6
MT3645060000000,36,45060,"Syracuse, NY MSA",2025,4,313694,302730,10964,3.5
MT3646540000000,36,46540,"Utica-Rome, NY MSA",2025,4,126582,121891,4691,3.7
MT3648060000000,36,48060,"Watertown-Fort Drum, NY MSA",2025,4,45177,43272,1905,4.2
MT3711700000000,37,11700,"Asheville, NC MSA",2025,4,212551,203474,9077,4.3
MT3715500000000,37,15500,"Burlington, NC MSA",2025,4,86129,83083,3046,3.5
MT3716740000000,37,16740,"Charlotte-Concord-Gastonia, NC-SC MSA",2025,4,1488520,1434390,54130,3.6
MT3720500000000,37,20500,"Durham-Chapel Hill, NC MSA",2025,4,324198,313815,10383,3.2
MT3722180000000,37,22180,"Fayetteville, NC MSA",2025,4,152700,145756,6944,4.5
MT3724140000000,37,24140,"Goldsboro, NC MSA",2025,4,51420,49572,1848,3.6
MT3724660000000,37,24660,"Greensboro-High Point, NC MSA",2025,4,371129,356330,14799,4
MT3724780000000,37,24780,"Greenville, NC MSA",2025,4,83250,79951,3299,4
MT3725860000000,37,25860,"Hickory-Lenoir-Morganton, NC MSA",2025,4,169918,163774,6144,3.6
MT3727340000000,37,27340,"Jacksonville, NC MSA",2025,4,73957,71210,2747,3.7
MT3738240000000,37,38240,"Pinehurst-Southern Pines, NC MSA",2025,4,44786,43306,1480,3.3
MT3739580000000,37,39580,"Raleigh-Cary, NC MSA",2025,4,850397,824407,25990,3.1
MT3740580000000,37,40580,"Rocky Mount, NC MSA",2025,4,63143,60150,2993,4.7
MT3748900000000,37,48900,"Wilmington, NC MSA",2025,4,223683,215702,7981,3.6
MT3749180000000,37,49180,"Winston-Salem, NC MSA",2025,4,325272,313507,11765,3.6
MT3813900000000,38,13900,"Bismarck, ND MSA",2025,4,74399,72669,1730,2.3
MT3822020000000,38,22020,"Fargo, ND-MN MSA",2025,4,154819,150966,3853,2.5
MT3824220000000,38,24220,"Grand Forks, ND-MN MSA",2025,4,57864,56392,1472,2.5
MT3833500000000,38,33500,"Minot, ND MSA",2025,4,40312,39302,1010,2.5
MT3910420000000,39,10420,"Akron, OH MSA",2025,4,365280,346847,18433,5
MT3915940000000,39,15940,"Canton-Massillon, OH MSA",2025,4,197803,187833,9970,5
MT3917140000000,39,17140,"Cincinnati, OH-KY-IN MSA",2025,4,1188099,1133376,54723,4.6
MT3917410000000,39,17410,"Cleveland, OH MSA",2025,4,1107940,1062371,45569,4.1
MT3918140000000,39,18140,"Columbus, OH MSA",2025,4,1173859,1120655,53204,4.5
MT3919430000000,39,19430,"Dayton-Kettering-Beavercreek, OH MSA",2025,4,399665,379632,20033,5
MT3930620000000,39,30620,"Lima, OH MSA",2025,4,48174,45790,2384,4.9
MT3931900000000,39,31900,"Mansfield, OH MSA",2025,4,54144,51154,2990,5.5
MT3941780000000,39,41780,"Sandusky, OH MSA",2025,4,59995,56476,3519,5.9
MT3944220000000,39,44220,"Springfield, OH MSA",2025,4,62437,59013,3424,5.5
MT3945780000000,39,45780,"Toledo, OH MSA",2025,4,301527,284826,16701,5.5
MT3948260000000,39,48260,"Weirton-Steubenville, WV-OH MSA",2025,4,50645,47760,2885,5.7
MT3949660000000,39,49660,"Youngstown-Warren, OH MSA",2025,4,196870,185590,11280,5.7
MT4021420000000,40,21420,"Enid, OK MSA",2025,4,28265,27408,857,3
MT4030020000000,40,30020,"Lawton, OK MSA",2025,4,52563,50733,1830,3.5
MT4036420000000,40,36420,"Oklahoma City, OK MSA",2025,4,780427,757074,23353,3
MT4046140000000,40,46140,"Tulsa, OK MSA",2025,4,529316,512894,16422,3.1
MT4110540000000,41,10540,"Albany, OR MSA",2025,4,62429,59333,3096,5
MT4113460000000,41,13460,"Bend, OR MSA",2025,4,135928,129967,5961,4.4
MT4118700000000,41,18700,"Corvallis, OR MSA",2025,4,49383,47478,1905,3.9
MT4121660000000,41,21660,"Eugene-Springfield, OR MSA",2025,4,189376,180775,8601,4.5
MT4124420000000,41,24420,"Grants Pass, OR MSA",2025,4,35041,32855,2186,6.2
MT4132780000000,41,32780,"Medford, OR MSA",2025,4,106117,100666,5451,5.1
MT4138900000000,41,38900,"Portland-Vancouver-Hillsboro, OR-WA MSA",2025,4,1380185,1319002,61183,4.4
MT4141420000000,41,41420,"Salem, OR MSA",2025,4,226316,216278,10038,4.4
MT4210900000000,42,10900,"Allentown-Bethlehem-Easton, PA-NJ MSA",2025,4,451712,433348,18364,4.1
MT4211020000000,42,11020,"Altoona, PA MSA",2025,4,57771,55598,2173,3.8
MT4216540000000,42,16540,"Chambersburg, PA MSA",2025,4,77267,74654,2613,3.4
MT4221500000000,42,21500,"Erie, PA MSA",2025,4,126519,121340,5179,4.1
MT4223900000000,42,23900,"Gettysburg, PA MSA",2025,4,51298,49591,1707,3.3
MT4225420000000,42,25420,"Harrisburg-Carlisle, PA MSA",2025,4,314270,303343,10927,3.5
MT4227780000000,42,27780,"Johnstown, PA MSA",2025,4,56079,53588,2491,4.4
MT4229540000000,42,29540,"Lancaster, PA MSA",2025,4,290694,281650,9044,3.1
MT4230140000000,42,30140,"Lebanon, PA MSA",2025,4,73700,71189,2511,3.4
MT4237980000000,42,37980,"Philadelphia-Camden-Wilmington, PA-NJ-DE-MD MSA",2025,4,3287375,3154490,132885,4
MT4238300000000,42,38300,"Pittsburgh, PA MSA",2025,4,1230716,1183602,47114,3.8
MT4239740000000,42,39740,"Reading, PA MSA",2025,4,218991,210377,8614,3.9
MT4242540000000,42,42540,"Scranton--Wilkes-Barre, PA MSA",2025,4,278682,266526,12156,4.4
MT4244300000000,42,44300,"State College, PA MSA",2025,4,76106,73792,2314,3
MT4248700000000,42,48700,"Williamsport, PA MSA",2025,4,52963,50776,2187,4.1
MT4249620000000,42,49620,"York-Hanover, PA MSA",2025,4,238316,229558,8758,3.7
MT4439300000000,44,39300,"Providence-Warwick, RI-MA MSA",2025,4,902822,857548,45274,5
MT4516700000000,45,16700,"Charleston-North Charleston, SC MSA",2025,4,450580,434546,16034,3.6
MT4517900000000,45,17900,"Columbia, SC MSA",2025,4,424324,406865,17459,4.1
MT4522500000000,45,22500,"Florence, SC MSA",2025,4,93255,89096,4159,4.5
MT4524860000000,45,24860,"Greenville-Anderson-Greer, SC MSA",2025,4,483440,464899,18541,3.8
MT4525940000000,45,25940,"Hilton Head Island-Bluffton-Port Royal, SC MSA",2025,4,99477,95646,3831,3.9
MT4534820000000,45,34820,"Myrtle Beach-Conway-North Myrtle Beach, SC MSA",2025,4,173970,165437,8533,4.9
MT4543900000000,45,43900,"Spartanburg, SC MSA",2025,4,179602,171819,7783,4.3
MT4544940000000,45,44940,"Sumter, SC MSA",2025,4,42338,40114,2224,5.3
MT4639660000000,46,39660,"Rapid City, SD MSA",2025,4,81698,80274,1424,1.7
MT4643620000000,46,43620,"Sioux Falls, SD-MN MSA",2025,4,176540,173458,3082,1.7
MT4716860000000,47,16860,"Chattanooga, TN-GA MSA",2025,4,293554,283931,9623,3.3
MT4717300000000,47,17300,"Clarksville, TN-KY MSA",2025,4,141818,135977,5841,4.1
MT4717420000000,47,17420,"Cleveland, TN MSA",2025,4,56619,54509,2110,3.7
MT4727180000000,47,27180,"Jackson, TN MSA",2025,4,79501,76420,3081,3.9
MT4727740000000,47,27740,"Johnson City, TN MSA",2025,4,98092,94565,3527,3.6
MT4728700000000,47,28700,"Kingsport-Bristol, TN-VA MSA",2025,4,134133,129247,4886,3.6
MT4728940000000,47,28940,"Knoxville, TN MSA",2025,4,458927,444503,14424,3.1
MT4732820000000,47,32820,"Memphis, TN-MS-AR MSA",2025,4,629485,601840,27645,4.4
MT4734100000000,47,34100,"Morristown, TN MSA",2025,4,54578,52661,1917,3.5
MT4734980000000,47,34980,"Nashville-Davidson--Murfreesboro--Franklin, TN MSA",2025,4,1177114,1142747,34367,2.9
MT4810180000000,48,10180,"Abilene, TX MSA",2025,4,88102,85131,2971,3.4
MT4811100000000,48,11100,"Amarillo, TX MSA",2025,4,140131,135846,4285,3.1
MT4812420000000,48,12420,"Austin-Round Rock-San Marcos, TX MSA",2025,4,1523818,1471539,52279,3.4
MT4813140000000,48,13140,"Beaumont-Port Arthur, TX MSA",2025,4,185391,175816,9575,5.2
MT4815180000000,48,15180,"Brownsville-Harlingen, TX MSA",2025,4,193778,182490,11288,5.8
MT4817780000000,48,17780,"College Station-Bryan, TX MSA",2025,4,155224,149832,5392,3.5
MT4818580000000,48,18580,"Corpus Christi, TX MSA",2025,4,212083,203018,9065,4.3
MT4819100000000,48,19100,"Dallas-Fort Worth-Arlington, TX MSA",2025,4,4544271,4370660,173611,3.8
MT4820580000000,48,20580,"Eagle Pass, TX MSA",2025,4,24670,22578,2092,8.5
MT4821340000000,48,21340,"El Paso, TX MSA",2025,4,421979,404335,17644,4.2
MT4826420000000,48,26420,"Houston-Pasadena-The Woodlands, TX MSA",2025,4,3885252,3718258,166994,4.3
MT4828660000000,48,28660,"Killeen-Temple, TX MSA",2025,4,204063,194975,9088,4.5
MT4829700000000,48,29700,"Laredo, TX MSA",2025,4,121231,115893,5338,4.4
MT4830980000000,48,30980,"Longview, TX MSA",2025,4,130130,124117,6013,4.6
MT4831180000000,48,31180,"Lubbock, TX MSA",2025,4,187366,180907,6459,3.4
MT4832580000000,48,32580,"McAllen-Edinburg-Mission, TX MSA",2025,4,400776,376951,23825,5.9
MT4833260000000,48,33260,"Midland, TX MSA",2025,4,105618,102502,3116,3
MT4836220000000,48,36220,"Odessa, TX MSA",2025,4,87895,84765,3130,3.6
MT4841660000000,48,41660,"San Angelo, TX MSA",2025,4,63228,61210,2018,3.2
MT4841700000000,48,41700,"San Antonio-New Braunfels, TX MSA",2025,4,1359782,1308573,51209,3.8
MT4843300000000,48,43300,"Sherman-Denison, TX MSA",2025,4,72175,69490,2685,3.7
MT4845500000000,48,45500,"Texarkana, TX-AR MSA",2025,4,62817,60268,2549,4.1
MT4846340000000,48,46340,"Tyler, TX MSA",2025,4,119842,115328,4514,3.8
MT4847020000000,48,47020,"Victoria, TX MSA",2025,4,45545,43736,1809,4
MT4847380000000,48,47380,"Waco, TX MSA",2025,4,149250,143593,5657,3.8
MT4848660000000,48,48660,"Wichita Falls, TX MSA",2025,4,67378,64848,2530,3.8
MT4930860000000,49,30860,"Logan, UT-ID MSA",2025,4,80990,78830,2160,2.7
MT4936260000000,49,36260,"Ogden, UT MSA",2025,4,355734,345180,10554,3
MT4939340000000,49,39340,"Provo-Orem-Lehi, UT MSA",2025,4,372288,360660,11628,3.1
MT4941100000000,49,41100,"St. George, UT MSA",2025,4,95345,92389,2956,3.1
MT4941620000000,49,41620,"Salt Lake City-Murray, UT MSA",2025,4,742724,719117,23607,3.2
MT5015540000000,50,15540,"Burlington-South Burlington, VT MSA",2025,4,131572,128566,3006,2.3
MT5113980000000,51,13980,"Blacksburg-Christiansburg-Radford, VA MSA",2025,4,91956,88545,3411,3.7
MT5116820000000,51,16820,"Charlottesville, VA MSA",2025,4,121376,117851,3525,2.9
MT5125500000000,51,25500,"Harrisonburg, VA MSA",2025,4,71363,69066,2297,3.2
MT5131340000000,51,31340,"Lynchburg, VA MSA",2025,4,126805,122199,4606,3.6
MT5140060000000,51,40060,"Richmond, VA MSA",2025,4,727021,703231,23790,3.3
MT5140220000000,51,40220,"Roanoke, VA MSA",2025,4,158667,153537,5130,3.2
MT5144420000000,51,44420,"Staunton-Stuarts Draft, VA MSA",2025,4,65042,63160,1882,2.9
MT5147260000000,51,47260,"Virginia Beach-Chesapeake-Norfolk, VA-NC MSA",2025,4,879792,849381,30411,3.5
MT5149020000000,51,49020,"Winchester, VA-WV MSA",2025,4,77767,75461,2306,3
MT5313380000000,53,13380,"Bellingham, WA MSA",2025,4,109041,104536,4505,4.1
MT5314740000000,53,14740,"Bremerton-Silverdale-Port Orchard, WA MSA",2025,4,119769,114841,4928,4.1
MT5328420000000,53,28420,"Kennewick-Richland, WA MSA",2025,4,147562,140793,6769,4.6
MT5331020000000,53,31020,"Longview-Kelso, WA MSA",2025,4,47234,44901,2333,4.9
MT5334580000000,53,34580,"Mount Vernon-Anacortes, WA MSA",2025,4,57995,55435,2560,4.4
MT5336500000000,53,36500,"Olympia-Lacey-Tumwater, WA MSA",2025,4,142737,136782,5955,4.2
MT5342660000000,53,42660,"Seattle-Tacoma-Bellevue, WA MSA",2025,4,2355836,2254570,101266,4.3
MT5344060000000,53,44060,"Spokane-Spokane Valley, WA MSA",2025,4,273769,262311,11458,4.2
MT5347460000000,53,47460,"Walla Walla, WA MSA",2025,4,27965,26877,1088,3.9
MT5348300000000,53,48300,"Wenatchee-East Wenatchee, WA MSA",2025,4,60664,57971,2693,4.4
MT5349420000000,53,49420,"Yakima, WA MSA",2025,4,121690,115078,6612,5.4
MT5413220000000,54,13220,"Beckley, WV MSA",2025,4,45761,44112,1649,3.6
MT5416620000000,54,16620,"Charleston, WV MSA",2025,4,89589,86318,3271,3.7
MT5426580000000,54,26580,"Huntington-Ashland, WV-KY-OH MSA",2025,4,157560,149894,7666,4.9
MT5434060000000,54,34060,"Morgantown, WV MSA",2025,4,70740,68503,2237,3.2
MT5437620000000,54,37620,"Parkersburg-Vienna, WV MSA",2025,4,38876,37391,1485,3.8
MT5448540000000,54,48540,"Wheeling, WV-OH MSA",2025,4,59797,57065,2732,4.6
MT5511540000000,55,11540,"Appleton, WI MSA",2025,4,137608,133905,3703,2.7
MT5520740000000,55,20740,"Eau Claire, WI MSA",2025,4,96602,93567,3035,3.1
MT5522540000000,55,22540,"Fond du Lac, WI MSA",2025,4,55273,53620,1653,3
MT5524580000000,55,24580,"Green Bay, WI MSA",2025,4,181053,175968,5085,2.8
MT5527500000000,55,27500,"Janesville-Beloit, WI MSA",2025,4,87541,84490,3051,3.5
MT5528450000000,55,28450,"Kenosha, WI MSA",2025,4,96059,92710,3349,3.5
MT5529100000000,55,29100,"La Crosse-Onalaska, WI-MN MSA",2025,4,91332,88859,2473,2.7
MT5531540000000,55,31540,"Madison, WI MSA",2025,4,410325,400086,10239,2.5
MT5533340000000,55,33340,"Milwaukee-Waukesha, WI MSA",2025,4,818549,789636,28913,3.5
MT5536780000000,55,36780,"Oshkosh-Neenah, WI MSA",2025,4,92815,90152,2663,2.9
MT5539540000000,55,39540,"Racine-Mount Pleasant, WI MSA",2025,4,100916,97058,3858,3.8
MT5543100000000,55,43100,"Sheboygan, WI MSA",2025,4,64200,62477,1723,2.7
MT5548140000000,55,48140,"Wausau, WI MSA",2025,4,74911,72877,2034,2.7
MT5616220000000,56,16220,"Casper, WY MSA",2025,4,42004,40626,1378,3.3
MT5616940000000,56,16940,"Cheyenne, WY MSA",2025,4,48920,47267,1653,3.4
MT7210380000000,72,10380,"Aguadilla, PR MSA",2025,4,91223,84896,6327,6.9
MT7211640000000,72,11640,"Arecibo, PR MSA",2025,4,68576,64858,3718,5.4
MT7225020000000,72,25020,"Guayama, PR MSA",2025,4,19095,17407,1688,8.8
MT7232420000000,72,32420,"Mayaguez, PR MSA",2025,4,68367,63032,5335,7.8
MT7238660000000,72,38660,"Ponce, PR MSA",2025,4,90345,82769,7576,8.4
MT7241980000000,72,41980,"San Juan-Bayamon-Caguas, PR MSA",2025,4,823768,787538,36230,4.4
MT0111500000000,1,11500,"Anniston-Oxford, AL MSA",2025,5,50435,48637,1798,3.6
MT0112220000000,1,12220,"Auburn-Opelika, AL MSA",2025,5,98212,95212,3000,3.1
MT0113820000000,1,13820,"Birmingham, AL MSA",2025,5,578628,560975,17653,3.1
MT0119300000000,1,19300,"Daphne-Fairhope-Foley, AL MSA",2025,5,118345,114923,3422,2.9
MT0119460000000,1,19460,"Decatur, AL MSA",2025,5,77802,75684,2118,2.7
MT0120020000000,1,20020,"Dothan, AL MSA",2025,5,68735,66513,2222,3.2
MT0122520000000,1,22520,"Florence-Muscle Shoals, AL MSA",2025,5,70997,68548,2449,3.4
MT0123460000000,1,23460,"Gadsden, AL MSA",2025,5,42956,41475,1481,3.4
MT0126620000000,1,26620,"Huntsville, AL MSA",2025,5,283917,276144,7773,2.7
MT0133660000000,1,33660,"Mobile, AL MSA",2025,5,190619,183081,7538,4
MT0133860000000,1,33860,"Montgomery, AL MSA",2025,5,182039,176069,5970,3.3
MT0146220000000,1,46220,"Tuscaloosa, AL MSA",2025,5,128537,124105,4432,3.4
MT0211260000000,2,11260,"Anchorage, AK MSA",2025,5,203849,195543,8306,4.1
MT0221820000000,2,21820,"Fairbanks-College, AK MSA",2025,5,46464,44662,1802,3.9
MT0422380000000,4,22380,"Flagstaff, AZ MSA",2025,5,76921,73601,3320,4.3
MT0429420000000,4,29420,"Lake Havasu City-Kingman, AZ MSA",2025,5,88305,84047,4258,4.8
MT0438060000000,4,38060,"Phoenix-Mesa-Chandler, AZ MSA",2025,5,2738153,2640232,97921,3.6
MT0439150000000,4,39150,"Prescott Valley-Prescott, AZ MSA",2025,5,106855,102672,4183,3.9
MT0443420000000,4,43420,"Sierra Vista-Douglas, AZ MSA",2025,5,48149,45843,2306,4.8
MT0446060000000,4,46060,"Tucson, AZ MSA",2025,5,496656,476517,20139,4.1
MT0449740000000,4,49740,"Yuma, AZ MSA",2025,5,101060,87408,13652,13.5
MT0522220000000,5,22220,"Fayetteville-Springdale-Rogers, AR MSA",2025,5,313776,304771,9005,2.9
MT0522900000000,5,22900,"Fort Smith, AR-OK MSA",2025,5,102315,98688,3627,3.5
MT0526300000000,5,26300,"Hot Springs, AR MSA",2025,5,43576,41917,1659,3.8
MT0527860000000,5,27860,"Jonesboro, AR MSA",2025,5,67200,64841,2359,3.5
MT0530780000000,5,30780,"Little Rock-North Little Rock-Conway, AR MSA",2025,5,385491,372376,13115,3.4
MT0612540000000,6,12540,"Bakersfield-Delano, CA MSA",2025,5,414841,379229,35612,8.6
MT0617020000000,6,17020,"Chico, CA MSA",2025,5,93128,87767,5361,5.8
MT0620940000000,6,20940,"El Centro, CA MSA",2025,5,73928,60177,13751,18.6
MT0623420000000,6,23420,"Fresno, CA MSA",2025,5,550533,506820,43713,7.9
MT0625260000000,6,25260,"Hanford-Corcoran, CA MSA",2025,5,59341,54061,5280,8.9
MT0631080000000,6,31080,"Los Angeles-Long Beach-Anaheim, CA MSA",2025,5,6708171,6355662,352509,5.3
MT0632900000000,6,32900,"Merced, CA MSA",2025,5,124031,111996,12035,9.7
MT0633700000000,6,33700,"Modesto, CA MSA",2025,5,260457,242625,17832,6.8
MT0634900000000,6,34900,"Napa, CA MSA",2025,5,77134,74059,3075,4
MT0637100000000,6,37100,"Oxnard-Thousand Oaks-Ventura, CA MSA",2025,5,425148,405203,19945,4.7
MT0639820000000,6,39820,"Redding, CA MSA",2025,5,81106,76875,4231,5.2
MT0640140000000,6,40140,"Riverside-San Bernardino-Ontario, CA MSA",2025,5,2234785,2117619,117166,5.2
MT0640900000000,6,40900,"Sacramento-Roseville-Folsom, CA MSA",2025,5,1199137,1143221,55916,4.7
MT0641500000000,6,41500,"Salinas, CA MSA",2025,5,229174,212779,16395,7.2
MT0641740000000,6,41740,"San Diego-Chula Vista-Carlsbad, CA MSA",2025,5,1673793,1600815,72978,4.4
MT0641860000000,6,41860,"San Francisco-Oakland-Fremont, CA MSA",2025,5,2515669,2409612,106057,4.2
MT0641940000000,6,41940,"San Jose-Sunnyvale-Santa Clara, CA MSA",2025,5,1065277,1021013,44264,4.2
MT0642020000000,6,42020,"San Luis Obispo-Paso Robles, CA MSA",2025,5,133618,128109,5509,4.1
MT0642100000000,6,42100,"Santa Cruz-Watsonville, CA MSA",2025,5,138261,130016,8245,6
MT0642200000000,6,42200,"Santa Maria-Santa Barbara, CA MSA",2025,5,224468,214529,9939,4.4
MT0642220000000,6,42220,"Santa Rosa-Petaluma, CA MSA",2025,5,249695,239350,10345,4.1
MT0644700000000,6,44700,"Stockton-Lodi, CA MSA",2025,5,374284,350243,24041,6.4
MT0646700000000,6,46700,"Vallejo, CA MSA",2025,5,218128,207152,10976,5
MT0647300000000,6,47300,"Visalia, CA MSA",2025,5,224633,201431,23202,10.3
MT0649700000000,6,49700,"Yuba City, CA MSA",2025,5,83209,76903,6306,7.6
MT0814500000000,8,14500,"Boulder, CO MSA",2025,5,194285,185209,9076,4.7
MT0817820000000,8,17820,"Colorado Springs, CO MSA",2025,5,399335,380311,19024,4.8
MT0819740000000,8,19740,"Denver-Aurora-Centennial, CO MSA",2025,5,1778665,1695770,82895,4.7
MT0822660000000,8,22660,"Fort Collins-Loveland, CO MSA",2025,5,208022,198479,9543,4.6
MT0824300000000,8,24300,"Grand Junction, CO MSA",2025,5,80720,76790,3930,4.9
MT0824540000000,8,24540,"Greeley, CO MSA",2025,5,179046,170166,8880,5
MT0839380000000,8,39380,"Pueblo, CO MSA",2025,5,73642,69058,4584,6.2
MT0914860000000,9,14860,"Bridgeport-Stamford-Danbury, CT MSA",2025,5,520753,501926,18827,3.6
MT0925540000000,9,25540,"Hartford-West Hartford-East Hartford, CT MSA",2025,5,617135,593937,23198,3.8
MT0935300000000,9,35300,"New Haven, CT MSA",2025,5,319329,307373,11956,3.7
MT0935980000000,9,35980,"Norwich-New London-Willimantic, CT MSA",2025,5,144999,139783,5216,3.6
MT0947930000000,9,47930,"Waterbury-Shelton, CT MSA",2025,5,243010,232801,10209,4.2
MT1020100000000,10,20100,"Dover, DE MSA",2025,5,85237,81580,3657,4.3
MT1147900000000,11,47900,"Washington-Arlington-Alexandria, DC-VA-MD-WV MSA",2025,5,3552880,3429747,123133,3.5
MT1215980000000,12,15980,"Cape Coral-Fort Myers, FL MSA",2025,5,374802,359850,14952,4
MT1218880000000,12,18880,"Crestview-Fort Walton Beach-Destin, FL MSA",2025,5,143830,138875,4955,3.4
MT1219660000000,12,19660,"Deltona-Daytona Beach-Ormond Beach, FL MSA",2025,5,324136,310451,13685,4.2
MT1223540000000,12,23540,"Gainesville, FL MSA",2025,5,171851,164698,7153,4.2
MT1226140000000,12,26140,"Homosassa Springs, FL MSA",2025,5,54005,51041,2964,5.5
MT1227260000000,12,27260,"Jacksonville, FL MSA",2025,5,861544,829084,32460,3.8
MT1229460000000,12,29460,"Lakeland-Winter Haven, FL MSA",2025,5,359931,343484,16447,4.6
MT1233100000000,12,33100,"Miami-Fort Lauderdale-West Palm Beach, FL MSA",2025,5,3307959,3202905,105054,3.2
MT1234940000000,12,34940,"Naples-Marco Island, FL MSA",2025,5,184285,177052,7233,3.9
MT1235840000000,12,35840,"North Port-Bradenton-Sarasota, FL MSA",2025,5,400629,384760,15869,4
MT1236100000000,12,36100,"Ocala, FL MSA",2025,5,160197,152985,7212,4.5
MT1236740000000,12,36740,"Orlando-Kissimmee-Sanford, FL MSA",2025,5,1552781,1497432,55349,3.6
MT1237340000000,12,37340,"Palm Bay-Melbourne-Titusville, FL MSA",2025,5,307873,295916,11957,3.9
MT1237460000000,12,37460,"Panama City-Panama City Beach, FL MSA",2025,5,102293,98522,3771,3.7
MT1237860000000,12,37860,"Pensacola-Ferry Pass-Brent, FL MSA",2025,5,241604,232093,9511,3.9
MT1238940000000,12,38940,"Port St. Lucie, FL MSA",2025,5,241218,231147,10071,4.2
MT1239460000000,12,39460,"Punta Gorda, FL MSA",2025,5,77593,73969,3624,4.7
MT1242680000000,12,42680,"Sebastian-Vero Beach-West Vero Corridor, FL MSA",2025,5,67510,64429,3081,4.6
MT1242700000000,12,42700,"Sebring, FL MSA",2025,5,36837,34862,1975,5.4
MT1245220000000,12,45220,"Tallahassee, FL MSA",2025,5,210435,202372,8063,3.8
MT1245300000000,12,45300,"Tampa-St. Petersburg-Clearwater, FL MSA",2025,5,1708665,1644789,63876,3.7
MT1248680000000,12,48680,"Wildwood-The Villages, FL MSA",2025,5,34613,32434,2179,6.3
MT1310500000000,13,10500,"Albany, GA MSA",2025,5,61866,59268,2598,4.2
MT1312020000000,13,12020,"Athens-Clarke County, GA MSA",2025,5,109446,105943,3503,3.2
MT1312060000000,13,12060,"Atlanta-Sandy Springs-Roswell, GA MSA",2025,5,3290761,3177054,113707,3.5
MT1312260000000,13,12260,"Augusta-Richmond County, GA-SC MSA",2025,5,268090,256695,11395,4.3
MT1315260000000,13,15260,"Brunswick-St. Simons, GA MSA",2025,5,55692,53971,1721,3.1
MT1317980000000,13,17980,"Columbus, GA-AL MSA",2025,5,128705,123406,5299,4.1
MT1319140000000,13,19140,"Dalton, GA MSA",2025,5,67175,64709,2466,3.7
MT1323580000000,13,23580,"Gainesville, GA MSA",2025,5,109108,105996,3112,2.9
MT1325980000000,13,25980,"Hinesville, GA MSA",2025,5,31023,29790,1233,4
MT1331420000000,13,31420,"Macon-Bibb County, GA MSA",2025,5,96687,92685,4002,4.1
MT1340660000000,13,40660,"Rome, GA MSA",2025,5,48103,46403,1700,3.5
MT1342340000000,13,42340,"Savannah, GA MSA",2025,5,208324,202002,6322,3
MT1346660000000,13,46660,"Valdosta, GA MSA",2025,5,60776,58380,2396,3.9
MT1347580000000,13,47580,"Warner Robins, GA MSA",2025,5,89704,86828,2876,3.2
MT1527980000000,15,27980,"Kahului-Wailuku, HI MSA",2025,5,81603,78969,2634,3.2
MT1546520000000,15,46520,"Urban Honolulu, HI MSA",2025,5,476964,464346,12618,2.6
MT1614260000000,16,14260,"Boise City, ID MSA",2025,5,455365,439903,15462,3.4
MT1617660000000,16,17660,"Coeur d'Alene, ID MSA",2025,5,92009,87987,4022,4.4
MT1626820000000,16,26820,"Idaho Falls, ID MSA",2025,5,85747,83099,2648,3.1
MT1630300000000,16,30300,"Lewiston, ID-WA MSA",2025,5,30954,29900,1054,3.4
MT1638540000000,16,38540,"Pocatello, ID MSA",2025,5,41397,39803,1594,3.9
MT1646300000000,16,46300,"Twin Falls, ID MSA",2025,5,60727,58674,2053,3.4
MT1714010000000,17,14010,"Bloomington, IL MSA",2025,5,94769,91551,3218,3.4
MT1716580000000,17,16580,"Champaign-Urbana, IL MSA",2025,5,125170,120872,4298,3.4
MT1716980000000,17,16980,"Chicago-Naperville-Elgin, IL-IN MSA",2025,5,5032438,4778979,253459,5
MT1719340000000,17,19340,"Davenport-Moline-Rock Island, IA-IL MSA",2025,5,188584,180129,8455,4.5
MT1719500000000,17,19500,"Decatur, IL MSA",2025,5,43945,41607,2338,5.3
MT1728100000000,17,28100,"Kankakee, IL MSA",2025,5,50632,48206,2426,4.8
MT1737900000000,17,37900,"Peoria, IL MSA",2025,5,176262,168699,7563,4.3
MT1740420000000,17,40420,"Rockford, IL MSA",2025,5,159675,152244,7431,4.7
MT1744100000000,17,44100,"Springfield, IL MSA",2025,5,103871,99945,3926,3.8
MT1814020000000,18,14020,"Bloomington, IN MSA",2025,5,86349,83489,2860,3.3
MT1818020000000,18,18020,"Columbus, IN MSA",2025,5,40202,38791,1411,3.5
MT1821140000000,18,21140,"Elkhart-Goshen, IN MSA",2025,5,98562,94685,3877,3.9
MT1821780000000,18,21780,"Evansville, IN MSA",2025,5,137163,132519,4644,3.4
MT1823060000000,18,23060,"Fort Wayne, IN MSA",2025,5,234309,226308,8001,3.4
MT1826900000000,18,26900,"Indianapolis-Carmel-Greenwood, IN MSA",2025,5,1154160,1115039,39121,3.4
MT1829020000000,18,29020,"Kokomo, IN MSA",2025,5,36792,34613,2179,5.9
MT1829200000000,18,29200,"Lafayette-West Lafayette, IN MSA",2025,5,120869,116712,4157,3.4
MT1833140000000,18,33140,"Michigan City-La Porte, IN MSA",2025,5,52117,49945,2172,4.2
MT1834620000000,18,34620,"Muncie, IN MSA",2025,5,53720,51562,2158,4
MT1843780000000,18,43780,"South Bend-Mishawaka, IN-MI MSA",2025,5,156879,150100,6779,4.3
MT1845460000000,18,45460,"Terre Haute, IN MSA",2025,5,78712,75719,2993,3.8
MT1911180000000,19,11180,"Ames, IA MSA",2025,5,70751,68635,2116,3
MT1916300000000,19,16300,"Cedar Rapids, IA MSA",2025,5,147400,141831,5569,3.8
MT1919780000000,19,19780,"Des Moines-West Des Moines, IA MSA",2025,5,416454,401600,14854,3.6
MT1920220000000,19,20220,"Dubuque, IA MSA",2025,5,53932,52009,1923,3.6
MT1926980000000,19,26980,"Iowa City, IA MSA",2025,5,102233,99299,2934,2.9
MT1943580000000,19,43580,"Sioux City, IA-NE-SD MSA",2025,5,76415,73879,2536,3.3
MT1947940000000,19,47940,"Waterloo-Cedar Falls, IA MSA",2025,5,88614,85031,3583,4
MT2029940000000,20,29940,"Lawrence, KS MSA",2025,5,72308,69824,2484,3.4
MT2031740000000,20,31740,"Manhattan, KS MSA",2025,5,65069,62716,2353,3.6
MT2045820000000,20,45820,"Topeka, KS MSA",2025,5,119461,114866,4595,3.8
MT2048620000000,20,48620,"Wichita, KS MSA",2025,5,338291,324436,13855,4.1
MT2114540000000,21,14540,"Bowling Green, KY MSA",2025,5,94426,89975,4451,4.7
MT2121060000000,21,21060,"Elizabethtown, KY MSA",2025,5,56120,53187,2933,5.2
MT2130460000000,21,30460,"Lexington-Fayette, KY MSA",2025,5,282133,270620,11513,4.1
MT2131140000000,21,31140,"Louisville/Jefferson County, KY-IN MSA",2025,5,707952,675878,32074,4.5
MT2136980000000,21,36980,"Owensboro, KY MSA",2025,5,52936,50471,2465,4.7
MT2137140000000,21,37140,"Paducah, KY-IL MSA",2025,5,46433,44182,2251,4.8
MT2210780000000,22,10780,"Alexandria, LA MSA",2025,5,63965,61271,2694,4.2
MT2212940000000,22,12940,"Baton Rouge, LA MSA",2025,5,428515,410407,18108,4.2
MT2225220000000,22,25220,"Hammond, LA MSA",2025,5,61103,58016,3087,5.1
MT2226380000000,22,26380,"Houma-Bayou Cane-Thibodaux, LA MSA",2025,5,87531,84038,3493,4
MT2229180000000,22,29180,"Lafayette, LA MSA",2025,5,198170,190478,7692,3.9
MT2229340000000,22,29340,"Lake Charles, LA MSA",2025,5,98105,93474,4631,4.7
MT2233740000000,22,33740,"Monroe, LA MSA",2025,5,95459,90615,4844,5.1
MT2235380000000,22,35380,"New Orleans-Metairie, LA MSA",2025,5,466449,445257,21192,4.5
MT2243340000000,22,43340,"Shreveport-Bossier City, LA MSA",2025,5,167749,160144,7605,4.5
MT2243640000000,22,43640,"Slidell-Mandeville-Covington, LA MSA",2025,5,129651,124410,5241,4
MT2312620000000,23,12620,"Bangor, ME MSA",2025,5,76065,73333,2732,3.6
MT2330340000000,23,30340,"Lewiston-Auburn, ME MSA",2025,5,55366,53438,1928,3.5
MT2338860000000,23,38860,"Portland-South Portland, ME MSA",2025,5,316223,307244,8979,2.8
MT2412580000000,24,12580,"Baltimore-Columbia-Towson, MD MSA",2025,5,1492827,1445204,47623,3.2
MT2425180000000,24,25180,"Hagerstown-Martinsburg, MD-WV MSA",2025,5,143117,138354,4763,3.3
MT2430500000000,24,30500,"Lexington Park, MD MSA",2025,5,108695,105666,3029,2.8
MT2441540000000,24,41540,"Salisbury, MD MSA",2025,5,64353,62065,2288,3.6
MT2511200000000,25,11200,"Amherst Town-Northampton, MA MSA",2025,5,87194,83274,3920,4.5
MT2512700000000,25,12700,"Barnstable Town, MA MSA",2025,5,122483,115788,6695,5.5
MT2514460000000,25,14460,"Boston-Cambridge-Newton, MA-NH MSA",2025,5,2870395,2743042,127353,4.4
MT2538340000000,25,38340,"Pittsfield, MA MSA",2025,5,64877,61855,3022,4.7
MT2544140000000,25,44140,"Springfield, MA MSA",2025,5,229096,215780,13316,5.8
MT2549340000000,25,49340,"Worcester, MA MSA",2025,5,473924,450430,23494,5
MT2611460000000,26,11460,"Ann Arbor, MI MSA",2025,5,210763,201088,9675,4.6
MT2612980000000,26,12980,"Battle Creek, MI MSA",2025,5,64629,60678,3951,6.1
MT2613020000000,26,13020,"Bay City, MI MSA",2025,5,50972,47611,3361,6.6
MT2619820000000,26,19820,"Detroit-Warren-Dearborn, MI MSA",2025,5,2193205,2082756,110449,5
MT2622420000000,26,22420,"Flint, MI MSA",2025,5,191569,178456,13113,6.8
MT2624340000000,26,24340,"Grand Rapids-Wyoming-Kentwood, MI MSA",2025,5,629714,599967,29747,4.7
MT2627100000000,26,27100,"Jackson, MI MSA",2025,5,75441,71088,4353,5.8
MT2628020000000,26,28020,"Kalamazoo-Portage, MI MSA",2025,5,141802,134741,7061,5
MT2629620000000,26,29620,"Lansing-East Lansing, MI MSA",2025,5,258889,245890,12999,5
MT2633220000000,26,33220,"Midland, MI MSA",2025,5,43685,41402,2283,5.2
MT2633780000000,26,33780,"Monroe, MI MSA",2025,5,79407,74633,4774,6
MT2634740000000,26,34740,"Muskegon-Norton Shores, MI MSA",2025,5,86185,80817,5368,6.2
MT2635660000000,26,35660,"Niles, MI MSA",2025,5,77349,72835,4514,5.8
MT2640980000000,26,40980,"Saginaw, MI MSA",2025,5,85769,79697,6072,7.1
MT2645900000000,26,45900,"Traverse City, MI MSA",2025,5,83697,79611,4086,4.9
MT2720260000000,27,20260,"Duluth, MN-WI MSA",2025,5,140838,135321,5517,3.9
MT2731860000000,27,31860,"Mankato, MN MSA",2025,5,60571,58899,1672,2.8
MT2733460000000,27,33460,"Minneapolis-St. Paul-Bloomington, MN-WI MSA",2025,5,2085296,2020693,64603,3.1
MT2740340000000,27,40340,"Rochester, MN MSA",2025,5,132768,129192,3576,2.7
MT2741060000000,27,41060,"St. Cloud, MN MSA",2025,5,111628,107816,3812,3.4
MT2825060000000,28,25060,"Gulfport-Biloxi, MS MSA",2025,5,191443,184409,7034,3.7
MT2825620000000,28,25620,"Hattiesburg, MS MSA",2025,5,71406,68762,2644,3.7
MT2827140000000,28,27140,"Jackson, MS MSA",2025,5,290036,279678,10358,3.6
MT2916020000000,29,16020,"Cape Girardeau, MO-IL MSA",2025,5,49638,47834,1804,3.6
MT2917860000000,29,17860,"Columbia, MO MSA",2025,5,114217,110352,3865,3.4
MT2927620000000,29,27620,"Jefferson City, MO MSA",2025,5,77922,75440,2482,3.2
MT2927900000000,29,27900,"Joplin, MO-KS MSA",2025,5,98902,95140,3762,3.8
MT2928140000000,29,28140,"Kansas City, MO-KS MSA",2025,5,1206480,1159346,47134,3.9
MT2941140000000,29,41140,"St. Joseph, MO-KS MSA",2025,5,55496,53332,2164,3.9
MT2941180000000,29,41180,"St. Louis, MO-IL MSA",2025,5,1488168,1431349,56819,3.8
MT2944180000000,29,44180,"Springfield, MO MSA",2025,5,247670,238820,8850,3.6
MT3013740000000,30,13740,"Billings, MT MSA",2025,5,98870,96124,2746,2.8
MT3014580000000,30,14580,"Bozeman, MT MSA",2025,5,76723,75095,1628,2.1
MT3024500000000,30,24500,"Great Falls, MT MSA",2025,5,39574,38503,1071,2.7
MT3025740000000,30,25740,"Helena, MT MSA",2025,5,47939,46736,1203,2.5
MT3033540000000,30,33540,"Missoula, MT MSA",2025,5,74358,72358,2000,2.7
MT3124260000000,31,24260,"Grand Island, NE MSA",2025,5,43434,41968,1466,3.4
MT3130700000000,31,30700,"Lincoln, NE MSA",2025,5,198531,193016,5515,2.8
MT3136540000000,31,36540,"Omaha, NE-IA MSA",2025,5,535362,518498,16864,3.2
MT3216180000000,32,16180,"Carson City, NV MSA",2025,5,29877,28596,1281,4.3
MT3229820000000,32,29820,"Las Vegas-Henderson-North Las Vegas, NV MSA",2025,5,1240178,1169128,71050,5.7
MT3239900000000,32,39900,"Reno, NV MSA",2025,5,305925,292281,13644,4.5
MT3331700000000,33,31700,"Manchester-Nashua, NH MSA",2025,5,243306,235174,8132,3.3
MT3412100000000,34,12100,"Atlantic City-Hammonton, NJ MSA",2025,5,184316,172238,12078,6.6
MT3445940000000,34,45940,"Trenton-Princeton, NJ MSA",2025,5,199369,190015,9354,4.7
MT3447220000000,34,47220,"Vineland, NJ MSA",2025,5,66423,61670,4753,7.2
MT3510740000000,35,10740,"Albuquerque, NM MSA",2025,5,468105,449554,18551,4
MT3522140000000,35,22140,"Farmington, NM MSA",2025,5,49869,47561,2308,4.6
MT3529740000000,35,29740,"Las Cruces, NM MSA",2025,5,103190,98105,5085,4.9
MT3542140000000,35,42140,"Santa Fe, NM MSA",2025,5,74462,71712,2750,3.7
MT3610580000000,36,10580,"Albany-Schenectady-Troy, NY MSA",2025,5,458674,444224,14450,3.2
MT3613780000000,36,13780,"Binghamton, NY MSA",2025,5,106563,102534,4029,3.8
MT3615380000000,36,15380,"Buffalo-Cheektowaga, NY MSA",2025,5,560903,539342,21561,3.8
MT3621300000000,36,21300,"Elmira, NY MSA",2025,5,35315,34029,1286,3.6
MT3624020000000,36,24020,"Glens Falls, NY MSA",2025,5,59366,57378,1988,3.3
MT3627060000000,36,27060,"Ithaca, NY MSA",2025,5,48277,46755,1522,3.2
MT3628740000000,36,28740,"Kingston, NY MSA",2025,5,87428,84473,2955,3.4
MT3628880000000,36,28880,"Kiryas Joel-Poughkeepsie-Newburgh, NY MSA",2025,5,340948,329263,11685,3.4
MT3635620000000,36,35620,"New York-Newark-Jersey City, NY-NJ MSA",2025,5,10231519,9788403,443116,4.3
MT3640380000000,36,40380,"Rochester, NY MSA",2025,5,515092,497050,18042,3.5
MT3645060000000,36,45060,"Syracuse, NY MSA",2025,5,314164,303373,10791,3.4
MT3646540000000,36,46540,"Utica-Rome, NY MSA",2025,5,126546,121924,4622,3.7
MT3648060000000,36,48060,"Watertown-Fort Drum, NY MSA",2025,5,45105,43225,1880,4.2
MT3711700000000,37,11700,"Asheville, NC MSA",2025,5,211891,203021,8870,4.2
MT3715500000000,37,15500,"Burlington, NC MSA",2025,5,86056,82980,3076,3.6
MT3716740000000,37,16740,"Charlotte-Concord-Gastonia, NC-SC MSA",2025,5,1489069,1434569,54500,3.7
MT3720500000000,37,20500,"Durham-Chapel Hill, NC MSA",2025,5,323910,313407,10503,3.2
MT3722180000000,37,22180,"Fayetteville, NC MSA",2025,5,152337,145294,7043,4.6
MT3724140000000,37,24140,"Goldsboro, NC MSA",2025,5,51306,49446,1860,3.6
MT3724660000000,37,24660,"Greensboro-High Point, NC MSA",2025,5,370779,355838,14941,4
MT3724780000000,37,24780,"Greenville, NC MSA",2025,5,83178,79894,3284,3.9
MT3725860000000,37,25860,"Hickory-Lenoir-Morganton, NC MSA",2025,5,169579,163411,6168,3.6
MT3727340000000,37,27340,"Jacksonville, NC MSA",2025,5,73810,71036,2774,3.8
MT3738240000000,37,38240,"Pinehurst-Southern Pines, NC MSA",2025,5,44749,43258,1491,3.3
MT3739580000000,37,39580,"Raleigh-Cary, NC MSA",2025,5,849897,823705,26192,3.1
MT3740580000000,37,40580,"Rocky Mount, NC MSA",2025,5,63221,60186,3035,4.8
MT3748900000000,37,48900,"Wilmington, NC MSA",2025,5,223256,215128,8128,3.6
MT3749180000000,37,49180,"Winston-Salem, NC MSA",2025,5,325217,313323,11894,3.7
MT3813900000000,38,13900,"Bismarck, ND MSA",2025,5,74368,72656,1712,2.3
MT3822020000000,38,22020,"Fargo, ND-MN MSA",2025,5,154980,151110,3870,2.5
MT3824220000000,38,24220,"Grand Forks, ND-MN MSA",2025,5,57957,56486,1471,2.5
MT3833500000000,38,33500,"Minot, ND MSA",2025,5,40287,39284,1003,2.5
MT3910420000000,39,10420,"Akron, OH MSA",2025,5,365128,346423,18705,5.1
MT3915940000000,39,15940,"Canton-Massillon, OH MSA",2025,5,197717,187633,10084,5.1
MT3917140000000,39,17140,"Cincinnati, OH-KY-IN MSA",2025,5,1189441,1134687,54754,4.6
MT3917410000000,39,17410,"Cleveland, OH MSA",2025,5,1106848,1059912,46936,4.2
MT3918140000000,39,18140,"Columbus, OH MSA",2025,5,1176606,1122842,53764,4.6
MT3919430000000,39,19430,"Dayton-Kettering-Beavercreek, OH MSA",2025,5,399714,379387,20327,5.1
MT3930620000000,39,30620,"Lima, OH MSA",2025,5,48174,45764,2410,5
MT3931900000000,39,31900,"Mansfield, OH MSA",2025,5,54078,51050,3028,5.6
MT3941780000000,39,41780,"Sandusky, OH MSA",2025,5,59827,56249,3578,6
MT3944220000000,39,44220,"Springfield, OH MSA",2025,5,62230,58799,3431,5.5
MT3945780000000,39,45780,"Toledo, OH MSA",2025,5,301689,284836,16853,5.6
MT3948260000000,39,48260,"Weirton-Steubenville, WV-OH MSA",2025,5,50554,47676,2878,5.7
MT3949660000000,39,49660,"Youngstown-Warren, OH MSA",2025,5,196940,185439,11501,5.8
MT4021420000000,40,21420,"Enid, OK MSA",2025,5,28261,27428,833,2.9
MT4030020000000,40,30020,"Lawton, OK MSA",2025,5,52556,50763,1793,3.4
MT4036420000000,40,36420,"Oklahoma City, OK MSA",2025,5,780924,758070,22854,2.9
MT4046140000000,40,46140,"Tulsa, OK MSA",2025,5,529814,513713,16101,3
MT4110540000000,41,10540,"Albany, OR MSA",2025,5,62432,59262,3170,5.1
MT4113460000000,41,13460,"Bend, OR MSA",2025,5,136066,130012,6054,4.4
MT4118700000000,41,18700,"Corvallis, OR MSA",2025,5,49433,47502,1931,3.9
MT4121660000000,41,21660,"Eugene-Springfield, OR MSA",2025,5,189515,180758,8757,4.6
MT4124420000000,41,24420,"Grants Pass, OR MSA",2025,5,35049,32819,2230,6.4
MT4132780000000,41,32780,"Medford, OR MSA",2025,5,106210,100689,5521,5.2
MT4138900000000,41,38900,"Portland-Vancouver-Hillsboro, OR-WA MSA",2025,5,1379287,1317325,61962,4.5
MT4141420000000,41,41420,"Salem, OR MSA",2025,5,226642,216415,10227,4.5
MT4210900000000,42,10900,"Allentown-Bethlehem-Easton, PA-NJ MSA",2025,5,451515,432928,18587,4.1
MT4211020000000,42,11020,"Altoona, PA MSA",2025,5,57559,55374,2185,3.8
MT4216540000000,42,16540,"Chambersburg, PA MSA",2025,5,77136,74481,2655,3.4
MT4221500000000,42,21500,"Erie, PA MSA",2025,5,126340,121123,5217,4.1
MT4223900000000,42,23900,"Gettysburg, PA MSA",2025,5,51186,49460,1726,3.4
MT4225420000000,42,25420,"Harrisburg-Carlisle, PA MSA",2025,5,313454,302435,11019,3.5
MT4227780000000,42,27780,"Johnstown, PA MSA",2025,5,56000,53486,2514,4.5
MT4229540000000,42,29540,"Lancaster, PA MSA",2025,5,290087,280956,9131,3.1
MT4230140000000,42,30140,"Lebanon, PA MSA",2025,5,73531,70980,2551,3.5
MT4237980000000,42,37980,"Philadelphia-Camden-Wilmington, PA-NJ-DE-MD MSA",2025,5,3287167,3152471,134696,4.1
MT4238300000000,42,38300,"Pittsburgh, PA MSA",2025,5,1230023,1182697,47326,3.8
MT4239740000000,42,39740,"Reading, PA MSA",2025,5,218734,210008,8726,4
MT4242540000000,42,42540,"Scranton--Wilkes-Barre, PA MSA",2025,5,278518,266151,12367,4.4
MT4244300000000,42,44300,"State College, PA MSA",2025,5,76151,73823,2328,3.1
MT4248700000000,42,48700,"Williamsport, PA MSA",2025,5,52820,50606,2214,4.2
MT4249620000000,42,49620,"York-Hanover, PA MSA",2025,5,238054,229223,8831,3.7
MT4439300000000,44,39300,"Providence-Warwick, RI-MA MSA",2025,5,903492,857581,45911,5.1
MT4516700000000,45,16700,"Charleston-North Charleston, SC MSA",2025,5,451472,435697,15775,3.5
MT4517900000000,45,17900,"Columbia, SC MSA",2025,5,424749,407527,17222,4.1
MT4522500000000,45,22500,"Florence, SC MSA",2025,5,93503,89363,4140,4.4
MT4524860000000,45,24860,"Greenville-Anderson-Greer, SC MSA",2025,5,483753,465366,18387,3.8
MT4525940000000,45,25940,"Hilton Head Island-Bluffton-Port Royal, SC MSA",2025,5,99194,95411,3783,3.8
MT4534820000000,45,34820,"Myrtle Beach-Conway-North Myrtle Beach, SC MSA",2025,5,174575,166087,8488,4.9
MT4543900000000,45,43900,"Spartanburg, SC MSA",2025,5,179820,172046,7774,4.3
MT4544940000000,45,44940,"Sumter, SC MSA",2025,5,42439,40248,2191,5.2
MT4639660000000,46,39660,"Rapid City, SD MSA",2025,5,81675,80242,1433,1.8
MT4643620000000,46,43620,"Sioux Falls, SD-MN MSA",2025,5,176781,173695,3086,1.7
MT4716860000000,47,16860,"Chattanooga, TN-GA MSA",2025,5,294153,284541,9612,3.3
MT4717300000000,47,17300,"Clarksville, TN-KY MSA",2025,5,142134,136361,5773,4.1
MT4717420000000,47,17420,"Cleveland, TN MSA",2025,5,56799,54692,2107,3.7
MT4727180000000,47,27180,"Jackson, TN MSA",2025,5,79624,76549,3075,3.9
MT4727740000000,47,27740,"Johnson City, TN MSA",2025,5,98310,94805,3505,3.6
MT4728700000000,47,28700,"Kingsport-Bristol, TN-VA MSA",2025,5,134311,129387,4924,3.7
MT4728940000000,47,28940,"Knoxville, TN MSA",2025,5,459978,445583,14395,3.1
MT4732820000000,47,32820,"Memphis, TN-MS-AR MSA",2025,5,630626,603126,27500,4.4
MT4734100000000,47,34100,"Morristown, TN MSA",2025,5,54695,52765,1930,3.5
MT4734980000000,47,34980,"Nashville-Davidson--Murfreesboro--Franklin, TN MSA",2025,5,1180793,1146731,34062,2.9
MT4810180000000,48,10180,"Abilene, TX MSA",2025,5,88160,85150,3010,3.4
MT4811100000000,48,11100,"Amarillo, TX MSA",2025,5,140284,135943,4341,3.1
MT4812420000000,48,12420,"Austin-Round Rock-San Marcos, TX MSA",2025,5,1525143,1472626,52517,3.4
MT4813140000000,48,13140,"Beaumont-Port Arthur, TX MSA",2025,5,185462,175869,9593,5.2
MT4815180000000,48,15180,"Brownsville-Harlingen, TX MSA",2025,5,194854,182679,12175,6.2
MT4817780000000,48,17780,"College Station-Bryan, TX MSA",2025,5,155763,150323,5440,3.5
MT4818580000000,48,18580,"Corpus Christi, TX MSA",2025,5,212316,203149,9167,4.3
MT4819100000000,48,19100,"Dallas-Fort Worth-Arlington, TX MSA",2025,5,4550434,4376001,174433,3.8
MT4820580000000,48,20580,"Eagle Pass, TX MSA",2025,5,24783,22588,2195,8.9
MT4821340000000,48,21340,"El Paso, TX MSA",2025,5,422859,404898,17961,4.2
MT4826420000000,48,26420,"Houston-Pasadena-The Woodlands, TX MSA",2025,5,3890030,3721714,168316,4.3
MT4828660000000,48,28660,"Killeen-Temple, TX MSA",2025,5,204231,195031,9200,4.5
MT4829700000000,48,29700,"Laredo, TX MSA",2025,5,121588,116073,5515,4.5
MT4830980000000,48,30980,"Longview, TX MSA",2025,5,130179,124201,5978,4.6
MT4831180000000,48,31180,"Lubbock, TX MSA",2025,5,187526,181034,6492,3.5
MT4832580000000,48,32580,"McAllen-Edinburg-Mission, TX MSA",2025,5,401621,377303,24318,6.1
MT4833260000000,48,33260,"Midland, TX MSA",2025,5,105801,102644,3157,3
MT4836220000000,48,36220,"Odessa, TX MSA",2025,5,88114,84957,3157,3.6
MT4841660000000,48,41660,"San Angelo, TX MSA",2025,5,63334,61309,2025,3.2
MT4841700000000,48,41700,"San Antonio-New Braunfels, TX MSA",2025,5,1363108,1311293,51815,3.8
MT4843300000000,48,43300,"Sherman-Denison, TX MSA",2025,5,72295,69588,2707,3.7
MT4845500000000,48,45500,"Texarkana, TX-AR MSA",2025,5,62845,60284,2561,4.1
MT4846340000000,48,46340,"Tyler, TX MSA",2025,5,120047,115474,4573,3.8
MT4847020000000,48,47020,"Victoria, TX MSA",2025,5,45547,43722,1825,4
MT4847380000000,48,47380,"Waco, TX MSA",2025,5,149554,143833,5721,3.8
MT4848660000000,48,48660,"Wichita Falls, TX MSA",2025,5,67386,64844,2542,3.8
MT4930860000000,49,30860,"Logan, UT-ID MSA",2025,5,80932,78718,2214,2.7
MT4936260000000,49,36260,"Ogden, UT MSA",2025,5,355285,344550,10735,3
MT4939340000000,49,39340,"Provo-Orem-Lehi, UT MSA",2025,5,372274,360369,11905,3.2
MT4941100000000,49,41100,"St. George, UT MSA",2025,5,95172,92146,3026,3.2
MT4941620000000,49,41620,"Salt Lake City-Murray, UT MSA",2025,5,743159,719204,23955,3.2
MT5015540000000,50,15540,"Burlington-South Burlington, VT MSA",2025,5,131370,128392,2978,2.3
MT5113980000000,51,13980,"Blacksburg-Christiansburg-Radford, VA MSA",2025,5,91637,88181,3456,3.8
MT5116820000000,51,16820,"Charlottesville, VA MSA",2025,5,121170,117548,3622,3
MT5125500000000,51,25500,"Harrisonburg, VA MSA",2025,5,71160,68831,2329,3.3
MT5131340000000,51,31340,"Lynchburg, VA MSA",2025,5,126612,121895,4717,3.7
MT5140060000000,51,40060,"Richmond, VA MSA",2025,5,725688,701283,24405,3.4
MT5140220000000,51,40220,"Roanoke, VA MSA",2025,5,158169,152908,5261,3.3
MT5144420000000,51,44420,"Staunton-Stuarts Draft, VA MSA",2025,5,64933,62992,1941,3
MT5147260000000,51,47260,"Virginia Beach-Chesapeake-Norfolk, VA-NC MSA",2025,5,876755,845501,31254,3.6
MT5149020000000,51,49020,"Winchester, VA-WV MSA",2025,5,77690,75332,2358,3
MT5313380000000,53,13380,"Bellingham, WA MSA",2025,5,108898,104429,4469,4.1
MT5314740000000,53,14740,"Bremerton-Silverdale-Port Orchard, WA MSA",2025,5,119411,114552,4859,4.1
MT5328420000000,53,28420,"Kennewick-Richland, WA MSA",2025,5,147085,140239,6846,4.7
MT5331020000000,53,31020,"Longview-Kelso, WA MSA",2025,5,47005,44680,2325,4.9
MT5334580000000,53,34580,"Mount Vernon-Anacortes, WA MSA",2025,5,57869,55311,2558,4.4
MT5336500000000,53,36500,"Olympia-Lacey-Tumwater, WA MSA",2025,5,142141,136250,5891,4.1
MT5342660000000,53,42660,"Seattle-Tacoma-Bellevue, WA MSA",2025,5,2349965,2247186,102779,4.4
MT5344060000000,53,44060,"Spokane-Spokane Valley, WA MSA",2025,5,272738,261332,11406,4.2
MT5347460000000,53,47460,"Walla Walla, WA MSA",2025,5,27905,26817,1088,3.9
MT5348300000000,53,48300,"Wenatchee-East Wenatchee, WA MSA",2025,5,60392,57693,2699,4.5
MT5349420000000,53,49420,"Yakima, WA MSA",2025,5,121322,114669,6653,5.5
MT5413220000000,54,13220,"Beckley, WV MSA",2025,5,45686,44015,1671,3.7
MT5416620000000,54,16620,"Charleston, WV MSA",2025,5,89621,86383,3238,3.6
MT5426580000000,54,26580,"Huntington-Ashland, WV-KY-OH MSA",2025,5,157593,150033,7560,4.8
MT5434060000000,54,34060,"Morgantown, WV MSA",2025,5,70758,68550,2208,3.1
MT5437620000000,54,37620,"Parkersburg-Vienna, WV MSA",2025,5,38824,37351,1473,3.8
MT5448540000000,54,48540,"Wheeling, WV-OH MSA",2025,5,59636,56882,2754,4.6
MT5511540000000,55,11540,"Appleton, WI MSA",2025,5,137310,133507,3803,2.8
MT5520740000000,55,20740,"Eau Claire, WI MSA",2025,5,96167,93102,3065,3.2
MT5522540000000,55,22540,"Fond du Lac, WI MSA",2025,5,55156,53478,1678,3
MT5524580000000,55,24580,"Green Bay, WI MSA",2025,5,180646,175446,5200,2.9
MT5527500000000,55,27500,"Janesville-Beloit, WI MSA",2025,5,87252,84142,3110,3.6
MT5528450000000,55,28450,"Kenosha, WI MSA",2025,5,95922,92536,3386,3.5
MT5529100000000,55,29100,"La Crosse-Onalaska, WI-MN MSA",2025,5,91211,88671,2540,2.8
MT5531540000000,55,31540,"Madison, WI MSA",2025,5,408919,398340,10579,2.6
MT5533340000000,55,33340,"Milwaukee-Waukesha, WI MSA",2025,5,816106,786885,29221,3.6
MT5536780000000,55,36780,"Oshkosh-Neenah, WI MSA",2025,5,92557,89854,2703,2.9
MT5539540000000,55,39540,"Racine-Mount Pleasant, WI MSA",2025,5,100552,96656,3896,3.9
MT5543100000000,55,43100,"Sheboygan, WI MSA",2025,5,64084,62317,1767,2.8
MT5548140000000,55,48140,"Wausau, WI MSA",2025,5,74761,72676,2085,2.8
MT5616220000000,56,16220,"Casper, WY MSA",2025,5,41840,40479,1361,3.3
MT5616940000000,56,16940,"Cheyenne, WY MSA",2025,5,48814,47179,1635,3.3
MT7210380000000,72,10380,"Aguadilla, PR MSA",2025,5,91151,84941,6210,6.8
MT7211640000000,72,11640,"Arecibo, PR MSA",2025,5,68629,64866,3763,5.5
MT7225020000000,72,25020,"Guayama, PR MSA",2025,5,19096,17444,1652,8.7
MT7232420000000,72,32420,"Mayaguez, PR MSA",2025,5,68489,63019,5470,8
MT7238660000000,72,38660,"Ponce, PR MSA",2025,5,90423,82933,7490,8.3
MT7241980000000,72,41980,"San Juan-Bayamon-Caguas, PR MSA",2025,5,825021,789082,35939,4.4
MT0111500000000,1,11500,"Anniston-Oxford, AL MSA",2025,6,50440,48708,1732,3.4
MT0112220000000,1,12220,"Auburn-Opelika, AL MSA",2025,6,98222,95312,2910,3
MT0113820000000,1,13820,"Birmingham, AL MSA",2025,6,578567,561667,16900,2.9
MT0119300000000,1,19300,"Daphne-Fairhope-Foley, AL MSA",2025,6,117900,114572,3328,2.8
MT0119460000000,1,19460,"Decatur, AL MSA",2025,6,77808,75769,2039,2.6
MT0120020000000,1,20020,"Dothan, AL MSA",2025,6,68712,66589,2123,3.1
MT0122520000000,1,22520,"Florence-Muscle Shoals, AL MSA",2025,6,70996,68610,2386,3.4
MT0123460000000,1,23460,"Gadsden, AL MSA",2025,6,42938,41510,1428,3.3
MT0126620000000,1,26620,"Huntsville, AL MSA",2025,6,284179,276704,7475,2.6
MT0133660000000,1,33660,"Mobile, AL MSA",2025,6,190519,183295,7224,3.8
MT0133860000000,1,33860,"Montgomery, AL MSA",2025,6,181911,176189,5722,3.1
MT0146220000000,1,46220,"Tuscaloosa, AL MSA",2025,6,128679,124417,4262,3.3
MT0211260000000,2,11260,"Anchorage, AK MSA",2025,6,204021,195533,8488,4.2
MT0221820000000,2,21820,"Fairbanks-College, AK MSA",2025,6,46496,44654,1842,4
MT0422380000000,4,22380,"Flagstaff, AZ MSA",2025,6,76881,73545,3336,4.3
MT0429420000000,4,29420,"Lake Havasu City-Kingman, AZ MSA",2025,6,88466,84161,4305,4.9
MT0438060000000,4,38060,"Phoenix-Mesa-Chandler, AZ MSA",2025,6,2743618,2644172,99446,3.6
MT0439150000000,4,39150,"Prescott Valley-Prescott, AZ MSA",2025,6,106842,102612,4230,4
MT0443420000000,4,43420,"Sierra Vista-Douglas, AZ MSA",2025,6,48234,45906,2328,4.8
MT0446060000000,4,46060,"Tucson, AZ MSA",2025,6,497403,477073,20330,4.1
MT0449740000000,4,49740,"Yuma, AZ MSA",2025,6,101295,87429,13866,13.7
MT0522220000000,5,22220,"Fayetteville-Springdale-Rogers, AR MSA",2025,6,314197,305071,9126,2.9
MT0522900000000,5,22900,"Fort Smith, AR-OK MSA",2025,6,102251,98573,3678,3.6
MT0526300000000,5,26300,"Hot Springs, AR MSA",2025,6,43581,41904,1677,3.8
MT0527860000000,5,27860,"Jonesboro, AR MSA",2025,6,67226,64831,2395,3.6
MT0530780000000,5,30780,"Little Rock-North Little Rock-Conway, AR MSA",2025,6,385605,372326,13279,3.4
MT0612540000000,6,12540,"Bakersfield-Delano, CA MSA",2025,6,414884,378700,36184,8.7
MT0617020000000,6,17020,"Chico, CA MSA",2025,6,93368,87884,5484,5.9
MT0620940000000,6,20940,"El Centro, CA MSA",2025,6,74169,60257,13912,18.8
MT0623420000000,6,23420,"Fresno, CA MSA",2025,6,551942,507214,44728,8.1
MT0625260000000,6,25260,"Hanford-Corcoran, CA MSA",2025,6,59358,53977,5381,9.1
MT0631080000000,6,31080,"Los Angeles-Long Beach-Anaheim, CA MSA",2025,6,6707241,6354266,352975,5.3
MT0632900000000,6,32900,"Merced, CA MSA",2025,6,124282,112065,12217,9.8
MT0633700000000,6,33700,"Modesto, CA MSA",2025,6,260976,242874,18102,6.9
MT0634900000000,6,34900,"Napa, CA MSA",2025,6,77276,74138,3138,4.1
MT0637100000000,6,37100,"Oxnard-Thousand Oaks-Ventura, CA MSA",2025,6,426077,405789,20288,4.8
MT0639820000000,6,39820,"Redding, CA MSA",2025,6,81257,76941,4316,5.3
MT0640140000000,6,40140,"Riverside-San Bernardino-Ontario, CA MSA",2025,6,2240006,2120479,119527,5.3
MT0640900000000,6,40900,"Sacramento-Roseville-Folsom, CA MSA",2025,6,1201490,1144251,57239,4.8
MT0641500000000,6,41500,"Salinas, CA MSA",2025,6,229305,212705,16600,7.2
MT0641740000000,6,41740,"San Diego-Chula Vista-Carlsbad, CA MSA",2025,6,1677038,1602790,74248,4.4
MT0641860000000,6,41860,"San Francisco-Oakland-Fremont, CA MSA",2025,6,2516716,2409329,107387,4.3
MT0641940000000,6,41940,"San Jose-Sunnyvale-Santa Clara, CA MSA",2025,6,1065666,1020642,45024,4.2
MT0642020000000,6,42020,"San Luis Obispo-Paso Robles, CA MSA",2025,6,133823,128141,5682,4.2
MT0642100000000,6,42100,"Santa Cruz-Watsonville, CA MSA",2025,6,138358,129968,8390,6.1
MT0642200000000,6,42200,"Santa Maria-Santa Barbara, CA MSA",2025,6,224711,214542,10169,4.5
MT0642220000000,6,42220,"Santa Rosa-Petaluma, CA MSA",2025,6,249995,239438,10557,4.2
MT0644700000000,6,44700,"Stockton-Lodi, CA MSA",2025,6,374622,350101,24521,6.5
MT0646700000000,6,46700,"Vallejo, CA MSA",2025,6,218199,206993,11206,5.1
MT0647300000000,6,47300,"Visalia, CA MSA",2025,6,225041,201534,23507,10.4
MT0649700000000,6,49700,"Yuba City, CA MSA",2025,6,83347,76897,6450,7.7
MT0814500000000,8,14500,"Boulder, CO MSA",2025,6,194115,185238,8877,4.6
MT0817820000000,8,17820,"Colorado Springs, CO MSA",2025,6,399592,380982,18610,4.7
MT0819740000000,8,19740,"Denver-Aurora-Centennial, CO MSA",2025,6,1779419,1698126,81293,4.6
MT0822660000000,8,22660,"Fort Collins-Loveland, CO MSA",2025,6,207751,198438,9313,4.5
MT0824300000000,8,24300,"Grand Junction, CO MSA",2025,6,80556,76709,3847,4.8
MT0824540000000,8,24540,"Greeley, CO MSA",2025,6,178584,169837,8747,4.9
MT0839380000000,8,39380,"Pueblo, CO MSA",2025,6,73501,68997,4504,6.1
MT0914860000000,9,14860,"Bridgeport-Stamford-Danbury, CT MSA",2025,6,519328,500794,18534,3.6
MT0925540000000,9,25540,"Hartford-West Hartford-East Hartford, CT MSA",2025,6,615996,592959,23037,3.7
MT0935300000000,9,35300,"New Haven, CT MSA",2025,6,318839,307006,11833,3.7
MT0935980000000,9,35980,"Norwich-New London-Willimantic, CT MSA",2025,6,144792,139641,5151,3.6
MT0947930000000,9,47930,"Waterbury-Shelton, CT MSA",2025,6,242465,232369,10096,4.2
MT1020100000000,10,20100,"Dover, DE MSA",2025,6,85155,81456,3699,4.3
MT1147900000000,11,47900,"Washington-Arlington-Alexandria, DC-VA-MD-WV MSA",2025,6,3546396,3420085,126311,3.6
MT1215980000000,12,15980,"Cape Coral-Fort Myers, FL MSA",2025,6,375117,359997,15120,4
MT1218880000000,12,18880,"Crestview-Fort Walton Beach-Destin, FL MSA",2025,6,143004,137987,5017,3.5
MT1219660000000,12,19660,"Deltona-Daytona Beach-Ormond Beach, FL MSA",2025,6,323682,309857,13825,4.3
MT1223540000000,12,23540,"Gainesville, FL MSA",2025,6,171804,164588,7216,4.2
MT1226140000000,12,26140,"Homosassa Springs, FL MSA",2025,6,54002,51017,2985,5.5
MT1227260000000,12,27260,"Jacksonville, FL MSA",2025,6,859191,826477,32714,3.8
MT1229460000000,12,29460,"Lakeland-Winter Haven, FL MSA",2025,6,359583,342981,16602,4.6
MT1233100000000,12,33100,"Miami-Fort Lauderdale-West Palm Beach, FL MSA",2025,6,3307802,3203236,104566,3.2
MT1234940000000,12,34940,"Naples-Marco Island, FL MSA",2025,6,184513,177247,7266,3.9
MT1235840000000,12,35840,"North Port-Bradenton-Sarasota, FL MSA",2025,6,400527,384491,16036,4
MT1236100000000,12,36100,"Ocala, FL MSA",2025,6,160055,152737,7318,4.6
MT1236740000000,12,36740,"Orlando-Kissimmee-Sanford, FL MSA",2025,6,1551035,1495442,55593,3.6
MT1237340000000,12,37340,"Palm Bay-Melbourne-Titusville, FL MSA",2025,6,307126,295045,12081,3.9
MT1237460000000,12,37460,"Panama City-Panama City Beach, FL MSA",2025,6,101784,97973,3811,3.7
MT1237860000000,12,37860,"Pensacola-Ferry Pass-Brent, FL MSA",2025,6,241029,231435,9594,4
MT1238940000000,12,38940,"Port St. Lucie, FL MSA",2025,6,241456,231299,10157,4.2
MT1239460000000,12,39460,"Punta Gorda, FL MSA",2025,6,77535,73883,3652,4.7
MT1242680000000,12,42680,"Sebastian-Vero Beach-West Vero Corridor, FL MSA",2025,6,67549,64467,3082,4.6
MT1242700000000,12,42700,"Sebring, FL MSA",2025,6,36881,34907,1974,5.4
MT1245220000000,12,45220,"Tallahassee, FL MSA",2025,6,210216,202094,8122,3.9
MT1245300000000,12,45300,"Tampa-St. Petersburg-Clearwater, FL MSA",2025,6,1706443,1642355,64088,3.8
MT1248680000000,12,48680,"Wildwood-The Villages, FL MSA",2025,6,34658,32442,2216,6.4
MT1310500000000,13,10500,"Albany, GA MSA",2025,6,61755,59187,2568,4.2
MT1312020000000,13,12020,"Athens-Clarke County, GA MSA",2025,6,109436,105971,3465,3.2
MT1312060000000,13,12060,"Atlanta-Sandy Springs-Roswell, GA MSA",2025,6,3292744,3180806,111938,3.4
MT1312260000000,13,12260,"Augusta-Richmond County, GA-SC MSA",2025,6,268325,257072,11253,4.2
MT1315260000000,13,15260,"Brunswick-St. Simons, GA MSA",2025,6,55733,54031,1702,3.1
MT1317980000000,13,17980,"Columbus, GA-AL MSA",2025,6,128828,123622,5206,4
MT1319140000000,13,19140,"Dalton, GA MSA",2025,6,67033,64601,2432,3.6
MT1323580000000,13,23580,"Gainesville, GA MSA",2025,6,109012,105926,3086,2.8
MT1325980000000,13,25980,"Hinesville, GA MSA",2025,6,30992,29769,1223,3.9
MT1331420000000,13,31420,"Macon-Bibb County, GA MSA",2025,6,96661,92718,3943,4.1
MT1340660000000,13,40660,"Rome, GA MSA",2025,6,48229,46543,1686,3.5
MT1342340000000,13,42340,"Savannah, GA MSA",2025,6,208118,201879,6239,3
MT1346660000000,13,46660,"Valdosta, GA MSA",2025,6,60507,58144,2363,3.9
MT1347580000000,13,47580,"Warner Robins, GA MSA",2025,6,89564,86719,2845,3.2
MT1527980000000,15,27980,"Kahului-Wailuku, HI MSA",2025,6,81607,79020,2587,3.2
MT1546520000000,15,46520,"Urban Honolulu, HI MSA",2025,6,477384,464840,12544,2.6
MT1614260000000,16,14260,"Boise City, ID MSA",2025,6,455810,440193,15617,3.4
MT1617660000000,16,17660,"Coeur d'Alene, ID MSA",2025,6,91874,87826,4048,4.4
MT1626820000000,16,26820,"Idaho Falls, ID MSA",2025,6,85713,83049,2664,3.1
MT1630300000000,16,30300,"Lewiston, ID-WA MSA",2025,6,30893,29827,1066,3.5
MT1638540000000,16,38540,"Pocatello, ID MSA",2025,6,41393,39779,1614,3.9
MT1646300000000,16,46300,"Twin Falls, ID MSA",2025,6,60794,58732,2062,3.4
MT1714010000000,17,14010,"Bloomington, IL MSA",2025,6,94714,91579,3135,3.3
MT1716580000000,17,16580,"Champaign-Urbana, IL MSA",2025,6,125110,120898,4212,3.4
MT1716980000000,17,16980,"Chicago-Naperville-Elgin, IL-IN MSA",2025,6,5018250,4774379,243871,4.9
MT1719340000000,17,19340,"Davenport-Moline-Rock Island, IA-IL MSA",2025,6,188744,180240,8504,4.5
MT1719500000000,17,19500,"Decatur, IL MSA",2025,6,43904,41611,2293,5.2
MT1728100000000,17,28100,"Kankakee, IL MSA",2025,6,50522,48131,2391,4.7
MT1737900000000,17,37900,"Peoria, IL MSA",2025,6,175893,168513,7380,4.2
MT1740420000000,17,40420,"Rockford, IL MSA",2025,6,159289,151936,7353,4.6
MT1744100000000,17,44100,"Springfield, IL MSA",2025,6,103678,99828,3850,3.7
MT1814020000000,18,14020,"Bloomington, IN MSA",2025,6,86096,83314,2782,3.2
MT1818020000000,18,18020,"Columbus, IN MSA",2025,6,40145,38772,1373,3.4
MT1821140000000,18,21140,"Elkhart-Goshen, IN MSA",2025,6,98570,94796,3774,3.8
MT1821780000000,18,21780,"Evansville, IN MSA",2025,6,137414,132882,4532,3.3
MT1823060000000,18,23060,"Fort Wayne, IN MSA",2025,6,234651,226870,7781,3.3
MT1826900000000,18,26900,"Indianapolis-Carmel-Greenwood, IN MSA",2025,6,1154576,1116507,38069,3.3
MT1829020000000,18,29020,"Kokomo, IN MSA",2025,6,36907,34706,2201,6
MT1829200000000,18,29200,"Lafayette-West Lafayette, IN MSA",2025,6,121173,117116,4057,3.3
MT1833140000000,18,33140,"Michigan City-La Porte, IN MSA",2025,6,52179,50079,2100,4
MT1834620000000,18,34620,"Muncie, IN MSA",2025,6,53885,51771,2114,3.9
MT1843780000000,18,43780,"South Bend-Mishawaka, IN-MI MSA",2025,6,157067,150415,6652,4.2
MT1845460000000,18,45460,"Terre Haute, IN MSA",2025,6,78923,76012,2911,3.7
MT1911180000000,19,11180,"Ames, IA MSA",2025,6,70796,68659,2137,3
MT1916300000000,19,16300,"Cedar Rapids, IA MSA",2025,6,147524,141885,5639,3.8
MT1919780000000,19,19780,"Des Moines-West Des Moines, IA MSA",2025,6,417334,402146,15188,3.6
MT1920220000000,19,20220,"Dubuque, IA MSA",2025,6,53995,52053,1942,3.6
MT1926980000000,19,26980,"Iowa City, IA MSA",2025,6,102598,99615,2983,2.9
MT1943580000000,19,43580,"Sioux City, IA-NE-SD MSA",2025,6,76534,73963,2571,3.4
MT1947940000000,19,47940,"Waterloo-Cedar Falls, IA MSA",2025,6,88818,85177,3641,4.1
MT2029940000000,20,29940,"Lawrence, KS MSA",2025,6,72351,69836,2515,3.5
MT2031740000000,20,31740,"Manhattan, KS MSA",2025,6,65168,62811,2357,3.6
MT2045820000000,20,45820,"Topeka, KS MSA",2025,6,119571,114953,4618,3.9
MT2048620000000,20,48620,"Wichita, KS MSA",2025,6,338534,324638,13896,4.1
MT2114540000000,21,14540,"Bowling Green, KY MSA",2025,6,94221,89883,4338,4.6
MT2121060000000,21,21060,"Elizabethtown, KY MSA",2025,6,56026,53187,2839,5.1
MT2130460000000,21,30460,"Lexington-Fayette, KY MSA",2025,6,282353,271176,11177,4
MT2131140000000,21,31140,"Louisville/Jefferson County, KY-IN MSA",2025,6,708359,677241,31118,4.4
MT2136980000000,21,36980,"Owensboro, KY MSA",2025,6,52819,50448,2371,4.5
MT2137140000000,21,37140,"Paducah, KY-IL MSA",2025,6,46407,44201,2206,4.8
MT2210780000000,22,10780,"Alexandria, LA MSA",2025,6,63896,61261,2635,4.1
MT2212940000000,22,12940,"Baton Rouge, LA MSA",2025,6,428474,410472,18002,4.2
MT2225220000000,22,25220,"Hammond, LA MSA",2025,6,61155,58066,3089,5.1
MT2226380000000,22,26380,"Houma-Bayou Cane-Thibodaux, LA MSA",2025,6,87557,84102,3455,3.9
MT2229180000000,22,29180,"Lafayette, LA MSA",2025,6,198242,190658,7584,3.8
MT2229340000000,22,29340,"Lake Charles, LA MSA",2025,6,98087,93534,4553,4.6
MT2233740000000,22,33740,"Monroe, LA MSA",2025,6,95558,90789,4769,5
MT2235380000000,22,35380,"New Orleans-Metairie, LA MSA",2025,6,466756,445589,21167,4.5
MT2243340000000,22,43340,"Shreveport-Bossier City, LA MSA",2025,6,167723,160230,7493,4.5
MT2243640000000,22,43640,"Slidell-Mandeville-Covington, LA MSA",2025,6,129824,124593,5231,4
MT2312620000000,23,12620,"Bangor, ME MSA",2025,6,76106,73473,2633,3.5
MT2330340000000,23,30340,"Lewiston-Auburn, ME MSA",2025,6,55440,53577,1863,3.4
MT2338860000000,23,38860,"Portland-South Portland, ME MSA",2025,6,316260,307620,8640,2.7
MT2412580000000,24,12580,"Baltimore-Columbia-Towson, MD MSA",2025,6,1492843,1444310,48533,3.3
MT2425180000000,24,25180,"Hagerstown-Martinsburg, MD-WV MSA",2025,6,143342,138489,4853,3.4
MT2430500000000,24,30500,"Lexington Park, MD MSA",2025,6,108469,105406,3063,2.8
MT2441540000000,24,41540,"Salisbury, MD MSA",2025,6,64466,62126,2340,3.6
MT2511200000000,25,11200,"Amherst Town-Northampton, MA MSA",2025,6,87353,83461,3892,4.5
MT2512700000000,25,12700,"Barnstable Town, MA MSA",2025,6,122205,115522,6683,5.5
MT2514460000000,25,14460,"Boston-Cambridge-Newton, MA-NH MSA",2025,6,2870834,2742712,128122,4.5
MT2538340000000,25,38340,"Pittsfield, MA MSA",2025,6,64782,61768,3014,4.7
MT2544140000000,25,44140,"Springfield, MA MSA",2025,6,229263,215878,13385,5.8
MT2549340000000,25,49340,"Worcester, MA MSA",2025,6,473698,450103,23595,5
MT2611460000000,26,11460,"Ann Arbor, MI MSA",2025,6,210224,200530,9694,4.6
MT2612980000000,26,12980,"Battle Creek, MI MSA",2025,6,64405,60444,3961,6.2
MT2613020000000,26,13020,"Bay City, MI MSA",2025,6,50734,47361,3373,6.6
MT2619820000000,26,19820,"Detroit-Warren-Dearborn, MI MSA",2025,6,2196900,2090918,105982,4.8
MT2622420000000,26,22420,"Flint, MI MSA",2025,6,190842,177704,13138,6.9
MT2624340000000,26,24340,"Grand Rapids-Wyoming-Kentwood, MI MSA",2025,6,627029,597097,29932,4.8
MT2627100000000,26,27100,"Jackson, MI MSA",2025,6,75095,70759,4336,5.8
MT2628020000000,26,28020,"Kalamazoo-Portage, MI MSA",2025,6,141343,134254,7089,5
MT2629620000000,26,29620,"Lansing-East Lansing, MI MSA",2025,6,258096,245047,13049,5.1
MT2633220000000,26,33220,"Midland, MI MSA",2025,6,43400,41119,2281,5.3
MT2633780000000,26,33780,"Monroe, MI MSA",2025,6,78847,74196,4651,5.9
MT2634740000000,26,34740,"Muskegon-Norton Shores, MI MSA",2025,6,85746,80393,5353,6.2
MT2635660000000,26,35660,"Niles, MI MSA",2025,6,76776,72290,4486,5.8
MT2640980000000,26,40980,"Saginaw, MI MSA",2025,6,85329,79291,6038,7.1
MT2645900000000,26,45900,"Traverse City, MI MSA",2025,6,82837,78730,4107,5
MT2720260000000,27,20260,"Duluth, MN-WI MSA",2025,6,140910,135193,5717,4.1
MT2731860000000,27,31860,"Mankato, MN MSA",2025,6,60873,59141,1732,2.8
MT2733460000000,27,33460,"Minneapolis-St. Paul-Bloomington, MN-WI MSA",2025,6,2087387,2021324,66063,3.2
MT2740340000000,27,40340,"Rochester, MN MSA",2025,6,133041,129383,3658,2.7
MT2741060000000,27,41060,"St. Cloud, MN MSA",2025,6,111615,107702,3913,3.5
MT2825060000000,28,25060,"Gulfport-Biloxi, MS MSA",2025,6,190919,184013,6906,3.6
MT2825620000000,28,25620,"Hattiesburg, MS MSA",2025,6,71336,68762,2574,3.6
MT2827140000000,28,27140,"Jackson, MS MSA",2025,6,288978,278847,10131,3.5
MT2916020000000,29,16020,"Cape Girardeau, MO-IL MSA",2025,6,49702,47844,1858,3.7
MT2917860000000,29,17860,"Columbia, MO MSA",2025,6,114234,110244,3990,3.5
MT2927620000000,29,27620,"Jefferson City, MO MSA",2025,6,78020,75477,2543,3.3
MT2927900000000,29,27900,"Joplin, MO-KS MSA",2025,6,98987,95140,3847,3.9
MT2928140000000,29,28140,"Kansas City, MO-KS MSA",2025,6,1208645,1160981,47664,3.9
MT2941140000000,29,41140,"St. Joseph, MO-KS MSA",2025,6,55621,53383,2238,4
MT2941180000000,29,41180,"St. Louis, MO-IL MSA",2025,6,1490065,1432573,57492,3.9
MT2944180000000,29,44180,"Springfield, MO MSA",2025,6,248491,239356,9135,3.7
MT3013740000000,30,13740,"Billings, MT MSA",2025,6,98799,96072,2727,2.8
MT3014580000000,30,14580,"Bozeman, MT MSA",2025,6,76501,74838,1663,2.2
MT3024500000000,30,24500,"Great Falls, MT MSA",2025,6,39489,38407,1082,2.7
MT3025740000000,30,25740,"Helena, MT MSA",2025,6,47961,46758,1203,2.5
MT3033540000000,30,33540,"Missoula, MT MSA",2025,6,74173,72167,2006,2.7
MT3124260000000,31,24260,"Grand Island, NE MSA",2025,6,43527,41990,1537,3.5
MT3130700000000,31,30700,"Lincoln, NE MSA",2025,6,199099,193548,5551,2.8
MT3136540000000,31,36540,"Omaha, NE-IA MSA",2025,6,536723,519701,17022,3.2
MT3216180000000,32,16180,"Carson City, NV MSA",2025,6,29958,28664,1294,4.3
MT3229820000000,32,29820,"Las Vegas-Henderson-North Las Vegas, NV MSA",2025,6,1242405,1171932,70473,5.7
MT3239900000000,32,39900,"Reno, NV MSA",2025,6,306184,292541,13643,4.5
MT3331700000000,33,31700,"Manchester-Nashua, NH MSA",2025,6,243183,235206,7977,3.3
MT3412100000000,34,12100,"Atlantic City-Hammonton, NJ MSA",2025,6,183196,170926,12270,6.7
MT3445940000000,34,45940,"Trenton-Princeton, NJ MSA",2025,6,199186,189618,9568,4.8
MT3447220000000,34,47220,"Vineland, NJ MSA",2025,6,66485,61671,4814,7.2
MT3510740000000,35,10740,"Albuquerque, NM MSA",2025,6,468209,449806,18403,3.9
MT3522140000000,35,22140,"Farmington, NM MSA",2025,6,50191,47917,2274,4.5
MT3529740000000,35,29740,"Las Cruces, NM MSA",2025,6,103354,98306,5048,4.9
MT3542140000000,35,42140,"Santa Fe, NM MSA",2025,6,74468,71763,2705,3.6
MT3610580000000,36,10580,"Albany-Schenectady-Troy, NY MSA",2025,6,458955,444798,14157,3.1
MT3613780000000,36,13780,"Binghamton, NY MSA",2025,6,106612,102613,3999,3.8
MT3615380000000,36,15380,"Buffalo-Cheektowaga, NY MSA",2025,6,561329,540174,21155,3.8
MT3621300000000,36,21300,"Elmira, NY MSA",2025,6,35326,34075,1251,3.5
MT3624020000000,36,24020,"Glens Falls, NY MSA",2025,6,59267,57293,1974,3.3
MT3627060000000,36,27060,"Ithaca, NY MSA",2025,6,48419,46937,1482,3.1
MT3628740000000,36,28740,"Kingston, NY MSA",2025,6,87372,84458,2914,3.3
MT3628880000000,36,28880,"Kiryas Joel-Poughkeepsie-Newburgh, NY MSA",2025,6,340728,329247,11481,3.4
MT3635620000000,36,35620,"New York-Newark-Jersey City, NY-NJ MSA",2025,6,10225989,9783286,442703,4.3
MT3640380000000,36,40380,"Rochester, NY MSA",2025,6,514692,496923,17769,3.5
MT3645060000000,36,45060,"Syracuse, NY MSA",2025,6,314718,304058,10660,3.4
MT3646540000000,36,46540,"Utica-Rome, NY MSA",2025,6,126495,121935,4560,3.6
MT3648060000000,36,48060,"Watertown-Fort Drum, NY MSA",2025,6,44946,43081,1865,4.1
MT3711700000000,37,11700,"Asheville, NC MSA",2025,6,211238,202573,8665,4.1
MT3715500000000,37,15500,"Burlington, NC MSA",2025,6,85982,82867,3115,3.6
MT3716740000000,37,16740,"Charlotte-Concord-Gastonia, NC-SC MSA",2025,6,1490705,1435744,54961,3.7
MT3720500000000,37,20500,"Durham-Chapel Hill, NC MSA",2025,6,323870,313254,10616,3.3
MT3722180000000,37,22180,"Fayetteville, NC MSA",2025,6,152089,144982,7107,4.7
MT3724140000000,37,24140,"Goldsboro, NC MSA",2025,6,51241,49373,1868,3.6
MT3724660000000,37,24660,"Greensboro-High Point, NC MSA",2025,6,370002,354925,15077,4.1
MT3724780000000,37,24780,"Greenville, NC MSA",2025,6,83223,79950,3273,3.9
MT3725860000000,37,25860,"Hickory-Lenoir-Morganton, NC MSA",2025,6,169179,162976,6203,3.7
MT3727340000000,37,27340,"Jacksonville, NC MSA",2025,6,73608,70806,2802,3.8
MT3738240000000,37,38240,"Pinehurst-Southern Pines, NC MSA",2025,6,44748,43247,1501,3.4
MT3739580000000,37,39580,"Raleigh-Cary, NC MSA",2025,6,849843,823444,26399,3.1
MT3740580000000,37,40580,"Rocky Mount, NC MSA",2025,6,63298,60235,3063,4.8
MT3748900000000,37,48900,"Wilmington, NC MSA",2025,6,222863,214630,8233,3.7
MT3749180000000,37,49180,"Winston-Salem, NC MSA",2025,6,325322,313298,12024,3.7
MT3813900000000,38,13900,"Bismarck, ND MSA",2025,6,74321,72629,1692,2.3
MT3822020000000,38,22020,"Fargo, ND-MN MSA",2025,6,155229,151331,3898,2.5
MT3824220000000,38,24220,"Grand Forks, ND-MN MSA",2025,6,58028,56550,1478,2.5
MT3833500000000,38,33500,"Minot, ND MSA",2025,6,40227,39232,995,2.5
MT3910420000000,39,10420,"Akron, OH MSA",2025,6,364819,346135,18684,5.1
MT3915940000000,39,15940,"Canton-Massillon, OH MSA",2025,6,197304,187251,10053,5.1
MT3917140000000,39,17140,"Cincinnati, OH-KY-IN MSA",2025,6,1188956,1134734,54222,4.6
MT3917410000000,39,17410,"Cleveland, OH MSA",2025,6,1106562,1058798,47764,4.3
MT3918140000000,39,18140,"Columbus, OH MSA",2025,6,1177291,1123843,53448,4.5
MT3919430000000,39,19430,"Dayton-Kettering-Beavercreek, OH MSA",2025,6,399243,378944,20299,5.1
MT3930620000000,39,30620,"Lima, OH MSA",2025,6,48094,45688,2406,5
MT3931900000000,39,31900,"Mansfield, OH MSA",2025,6,53924,50911,3013,5.6
MT3941780000000,39,41780,"Sandusky, OH MSA",2025,6,59426,55851,3575,6
MT3944220000000,39,44220,"Springfield, OH MSA",2025,6,61979,58595,3384,5.5
MT3945780000000,39,45780,"Toledo, OH MSA",2025,6,301288,284550,16738,5.6
MT3948260000000,39,48260,"Weirton-Steubenville, WV-OH MSA",2025,6,50501,47633,2868,5.7
MT3949660000000,39,49660,"Youngstown-Warren, OH MSA",2025,6,196493,184991,11502,5.9
MT4021420000000,40,21420,"Enid, OK MSA",2025,6,28236,27424,812,2.9
MT4030020000000,40,30020,"Lawton, OK MSA",2025,6,52566,50794,1772,3.4
MT4036420000000,40,36420,"Oklahoma City, OK MSA",2025,6,781951,759369,22582,2.9
MT4046140000000,40,46140,"Tulsa, OK MSA",2025,6,530694,514675,16019,3
MT4110540000000,41,10540,"Albany, OR MSA",2025,6,62420,59159,3261,5.2
MT4113460000000,41,13460,"Bend, OR MSA",2025,6,135979,129772,6207,4.6
MT4118700000000,41,18700,"Corvallis, OR MSA",2025,6,49511,47521,1990,4
MT4121660000000,41,21660,"Eugene-Springfield, OR MSA",2025,6,189624,180654,8970,4.7
MT4124420000000,41,24420,"Grants Pass, OR MSA",2025,6,35105,32778,2327,6.6
MT4132780000000,41,32780,"Medford, OR MSA",2025,6,106385,100719,5666,5.3
MT4138900000000,41,38900,"Portland-Vancouver-Hillsboro, OR-WA MSA",2025,6,1380134,1317346,62788,4.5
MT4141420000000,41,41420,"Salem, OR MSA",2025,6,227034,216524,10510,4.6
MT4210900000000,42,10900,"Allentown-Bethlehem-Easton, PA-NJ MSA",2025,6,451605,432794,18811,4.2
MT4211020000000,42,11020,"Altoona, PA MSA",2025,6,57294,55099,2195,3.8
MT4216540000000,42,16540,"Chambersburg, PA MSA",2025,6,76883,74211,2672,3.5
MT4221500000000,42,21500,"Erie, PA MSA",2025,6,125957,120752,5205,4.1
MT4223900000000,42,23900,"Gettysburg, PA MSA",2025,6,50980,49245,1735,3.4
MT4225420000000,42,25420,"Harrisburg-Carlisle, PA MSA",2025,6,312464,301328,11136,3.6
MT4227780000000,42,27780,"Johnstown, PA MSA",2025,6,56016,53481,2535,4.5
MT4229540000000,42,29540,"Lancaster, PA MSA",2025,6,288992,279831,9161,3.2
MT4230140000000,42,30140,"Lebanon, PA MSA",2025,6,73274,70703,2571,3.5
MT4237980000000,42,37980,"Philadelphia-Camden-Wilmington, PA-NJ-DE-MD MSA",2025,6,3286969,3150619,136350,4.1
MT4238300000000,42,38300,"Pittsburgh, PA MSA",2025,6,1229502,1181847,47655,3.9
MT4239740000000,42,39740,"Reading, PA MSA",2025,6,218079,209238,8841,4.1
MT4242540000000,42,42540,"Scranton--Wilkes-Barre, PA MSA",2025,6,278353,265741,12612,4.5
MT4244300000000,42,44300,"State College, PA MSA",2025,6,75989,73680,2309,3
MT4248700000000,42,48700,"Williamsport, PA MSA",2025,6,52705,50461,2244,4.3
MT4249620000000,42,49620,"York-Hanover, PA MSA",2025,6,237727,228801,8926,3.8
MT4439300000000,44,39300,"Providence-Warwick, RI-MA MSA",2025,6,903321,857698,45623,5.1
MT4516700000000,45,16700,"Charleston-North Charleston, SC MSA",2025,6,452905,437137,15768,3.5
MT4517900000000,45,17900,"Columbia, SC MSA",2025,6,425509,408313,17196,4
MT4522500000000,45,22500,"Florence, SC MSA",2025,6,93859,89701,4158,4.4
MT4524860000000,45,24860,"Greenville-Anderson-Greer, SC MSA",2025,6,484179,465728,18451,3.8
MT4525940000000,45,25940,"Hilton Head Island-Bluffton-Port Royal, SC MSA",2025,6,98907,95102,3805,3.8
MT4534820000000,45,34820,"Myrtle Beach-Conway-North Myrtle Beach, SC MSA",2025,6,175311,166830,8481,4.8
MT4543900000000,45,43900,"Spartanburg, SC MSA",2025,6,180070,172329,7741,4.3
MT4544940000000,45,44940,"Sumter, SC MSA",2025,6,42524,40357,2167,5.1
MT4639660000000,46,39660,"Rapid City, SD MSA",2025,6,81544,80103,1441,1.8
MT4643620000000,46,43620,"Sioux Falls, SD-MN MSA",2025,6,176998,173922,3076,1.7
MT4716860000000,47,16860,"Chattanooga, TN-GA MSA",2025,6,294300,284678,9622,3.3
MT4717300000000,47,17300,"Clarksville, TN-KY MSA",2025,6,142266,136527,5739,4
MT4717420000000,47,17420,"Cleveland, TN MSA",2025,6,56881,54774,2107,3.7
MT4727180000000,47,27180,"Jackson, TN MSA",2025,6,79493,76412,3081,3.9
MT4727740000000,47,27740,"Johnson City, TN MSA",2025,6,98529,95032,3497,3.5
MT4728700000000,47,28700,"Kingsport-Bristol, TN-VA MSA",2025,6,134337,129398,4939,3.7
MT4728940000000,47,28940,"Knoxville, TN MSA",2025,6,460437,446052,14385,3.1
MT4732820000000,47,32820,"Memphis, TN-MS-AR MSA",2025,6,630605,603464,27141,4.3
MT4734100000000,47,34100,"Morristown, TN MSA",2025,6,54800,52857,1943,3.5
MT4734980000000,47,34980,"Nashville-Davidson--Murfreesboro--Franklin, TN MSA",2025,6,1182517,1148631,33886,2.9
MT4810180000000,48,10180,"Abilene, TX MSA",2025,6,88165,85213,2952,3.3
MT4811100000000,48,11100,"Amarillo, TX MSA",2025,6,140382,136122,4260,3
MT4812420000000,48,12420,"Austin-Round Rock-San Marcos, TX MSA",2025,6,1525215,1473533,51682,3.4
MT4813140000000,48,13140,"Beaumont-Port Arthur, TX MSA",2025,6,185296,175923,9373,5.1
MT4815180000000,48,15180,"Brownsville-Harlingen, TX MSA",2025,6,195605,182835,12770,6.5
MT4817780000000,48,17780,"College Station-Bryan, TX MSA",2025,6,156287,150986,5301,3.4
MT4818580000000,48,18580,"Corpus Christi, TX MSA",2025,6,212211,203200,9011,4.2
MT4819100000000,48,19100,"Dallas-Fort Worth-Arlington, TX MSA",2025,6,4551219,4379552,171667,3.8
MT4820580000000,48,20580,"Eagle Pass, TX MSA",2025,6,24889,22641,2248,9
MT4821340000000,48,21340,"El Paso, TX MSA",2025,6,423110,405340,17770,4.2
MT4826420000000,48,26420,"Houston-Pasadena-The Woodlands, TX MSA",2025,6,3891620,3725716,165904,4.3
MT4828660000000,48,28660,"Killeen-Temple, TX MSA",2025,6,204192,195092,9100,4.5
MT4829700000000,48,29700,"Laredo, TX MSA",2025,6,121742,116254,5488,4.5
MT4830980000000,48,30980,"Longview, TX MSA",2025,6,130006,124227,5779,4.4
MT4831180000000,48,31180,"Lubbock, TX MSA",2025,6,187518,181172,6346,3.4
MT4832580000000,48,32580,"McAllen-Edinburg-Mission, TX MSA",2025,6,401860,377627,24233,6
MT4833260000000,48,33260,"Midland, TX MSA",2025,6,105963,102840,3123,2.9
MT4836220000000,48,36220,"Odessa, TX MSA",2025,6,88213,85118,3095,3.5
MT4841660000000,48,41660,"San Angelo, TX MSA",2025,6,63327,61359,1968,3.1
MT4841700000000,48,41700,"San Antonio-New Braunfels, TX MSA",2025,6,1364794,1313555,51239,3.8
MT4843300000000,48,43300,"Sherman-Denison, TX MSA",2025,6,72334,69668,2666,3.7
MT4845500000000,48,45500,"Texarkana, TX-AR MSA",2025,6,62778,60239,2539,4
MT4846340000000,48,46340,"Tyler, TX MSA",2025,6,120189,115699,4490,3.7
MT4847020000000,48,47020,"Victoria, TX MSA",2025,6,45460,43672,1788,3.9
MT4847380000000,48,47380,"Waco, TX MSA",2025,6,149752,144145,5607,3.7
MT4848660000000,48,48660,"Wichita Falls, TX MSA",2025,6,67327,64844,2483,3.7
MT4930860000000,49,30860,"Logan, UT-ID MSA",2025,6,80741,78474,2267,2.8
MT4936260000000,49,36260,"Ogden, UT MSA",2025,6,354697,343698,10999,3.1
MT4939340000000,49,39340,"Provo-Orem-Lehi, UT MSA",2025,6,372000,359757,12243,3.3
MT4941100000000,49,41100,"St. George, UT MSA",2025,6,95297,92198,3099,3.3
MT4941620000000,49,41620,"Salt Lake City-Murray, UT MSA",2025,6,743912,719461,24451,3.3
MT5015540000000,50,15540,"Burlington-South Burlington, VT MSA",2025,6,131383,128420,2963,2.3
MT5113980000000,51,13980,"Blacksburg-Christiansburg-Radford, VA MSA",2025,6,91637,87943,3694,4
MT5116820000000,51,16820,"Charlottesville, VA MSA",2025,6,120915,117218,3697,3.1
MT5125500000000,51,25500,"Harrisonburg, VA MSA",2025,6,70966,68596,2370,3.3
MT5131340000000,51,31340,"Lynchburg, VA MSA",2025,6,126432,121631,4801,3.8
MT5140060000000,51,40060,"Richmond, VA MSA",2025,6,724802,699803,24999,3.4
MT5140220000000,51,40220,"Roanoke, VA MSA",2025,6,157699,152314,5385,3.4
MT5144420000000,51,44420,"Staunton-Stuarts Draft, VA MSA",2025,6,64791,62792,1999,3.1
MT5147260000000,51,47260,"Virginia Beach-Chesapeake-Norfolk, VA-NC MSA",2025,6,873908,841832,32076,3.7
MT5149020000000,51,49020,"Winchester, VA-WV MSA",2025,6,77524,75118,2406,3.1
MT5313380000000,53,13380,"Bellingham, WA MSA",2025,6,109227,104846,4381,4
MT5314740000000,53,14740,"Bremerton-Silverdale-Port Orchard, WA MSA",2025,6,119511,114816,4695,3.9
MT5328420000000,53,28420,"Kennewick-Richland, WA MSA",2025,6,146223,139413,6810,4.7
MT5331020000000,53,31020,"Longview-Kelso, WA MSA",2025,6,46829,44555,2274,4.9
MT5334580000000,53,34580,"Mount Vernon-Anacortes, WA MSA",2025,6,57939,55415,2524,4.4
MT5336500000000,53,36500,"Olympia-Lacey-Tumwater, WA MSA",2025,6,141972,136255,5717,4
MT5342660000000,53,42660,"Seattle-Tacoma-Bellevue, WA MSA",2025,6,2341874,2239739,102135,4.4
MT5344060000000,53,44060,"Spokane-Spokane Valley, WA MSA",2025,6,272793,261575,11218,4.1
MT5347460000000,53,47460,"Walla Walla, WA MSA",2025,6,28151,27060,1091,3.9
MT5348300000000,53,48300,"Wenatchee-East Wenatchee, WA MSA",2025,6,60095,57402,2693,4.5
MT5349420000000,53,49420,"Yakima, WA MSA",2025,6,120464,113822,6642,5.5
MT5413220000000,54,13220,"Beckley, WV MSA",2025,6,45677,43971,1706,3.7
MT5416620000000,54,16620,"Charleston, WV MSA",2025,6,89698,86440,3258,3.6
MT5426580000000,54,26580,"Huntington-Ashland, WV-KY-OH MSA",2025,6,157662,150230,7432,4.7
MT5434060000000,54,34060,"Morgantown, WV MSA",2025,6,70759,68582,2177,3.1
MT5437620000000,54,37620,"Parkersburg-Vienna, WV MSA",2025,6,38813,37341,1472,3.8
MT5448540000000,54,48540,"Wheeling, WV-OH MSA",2025,6,59488,56722,2766,4.6
MT5511540000000,55,11540,"Appleton, WI MSA",2025,6,136930,133238,3692,2.7
MT5520740000000,55,20740,"Eau Claire, WI MSA",2025,6,95881,92940,2941,3.1
MT5522540000000,55,22540,"Fond du Lac, WI MSA",2025,6,55033,53413,1620,2.9
MT5524580000000,55,24580,"Green Bay, WI MSA",2025,6,180316,175259,5057,2.8
MT5527500000000,55,27500,"Janesville-Beloit, WI MSA",2025,6,86950,83941,3009,3.5
MT5528450000000,55,28450,"Kenosha, WI MSA",2025,6,95806,92518,3288,3.4
MT5529100000000,55,29100,"La Crosse-Onalaska, WI-MN MSA",2025,6,91088,88610,2478,2.7
MT5531540000000,55,31540,"Madison, WI MSA",2025,6,407622,397310,10312,2.5
MT5533340000000,55,33340,"Milwaukee-Waukesha, WI MSA",2025,6,813417,785300,28117,3.5
MT5536780000000,55,36780,"Oshkosh-Neenah, WI MSA",2025,6,92271,89652,2619,2.8
MT5539540000000,55,39540,"Racine-Mount Pleasant, WI MSA",2025,6,100234,96466,3768,3.8
MT5543100000000,55,43100,"Sheboygan, WI MSA",2025,6,63768,62045,1723,2.7
MT5548140000000,55,48140,"Wausau, WI MSA",2025,6,74621,72598,2023,2.7
MT5616220000000,56,16220,"Casper, WY MSA",2025,6,41637,40250,1387,3.3
MT5616940000000,56,16940,"Cheyenne, WY MSA",2025,6,48679,47028,1651,3.4
MT7210380000000,72,10380,"Aguadilla, PR MSA",2025,6,91335,85064,6271,6.9
MT7211640000000,72,11640,"Arecibo, PR MSA",2025,6,68702,64772,3930,5.7
MT7225020000000,72,25020,"Guayama, PR MSA",2025,6,19166,17494,1672,8.7
MT7232420000000,72,32420,"Mayaguez, PR MSA",2025,6,68670,62965,5705,8.3
MT7238660000000,72,38660,"Ponce, PR MSA",2025,6,90641,83059,7582,8.4
MT7241980000000,72,41980,"San Juan-Bayamon-Caguas, PR MSA",2025,6,826561,790472,36089,4.4